#######################################################################################################################################################
# #       #             #     #         #                 #           #         # #         #             #     # #                 #     #         # #
# # ##### ##### # ##### # # # ### ##### ########### ##### ##### # ### # # ##### # # ##### # ### ######### ### # # # ########### ### # ### ##### ### # #
#   #   #     # # #   # # # #     #   #   #   #     #   # #   # # #   # # # #   # #   # # # #   #         #   #   #     # #   # #     # # #   # #     #
####### ##### ### ### # ### ######### ### # # # ##### # # # # ### # ##### # # ### ### # # # # ### ######### ##### ##### # # # # ####### # # # # #######
#           #     #   #   #   #         #   # #   # # #   # #   # #   #   #   # #   # # # #   #   #         # #   # #   # # # #   #     #   # #       #
# # ####### ####### ##### ### # # ########### # # # # ##### ### # ### # ### ### # # # # # ##### ######### # # # ### # ### # # ### ### # ##### ####### #
# # #   #   #       #   # #   # #         #   # # # # #       # # # # # #   #     # # # # #   # #       # # # # #   # # #   #   #   # #       #     # #
# # ### # ### # ##### # # # ### ######### # ### # # # # ##### # # # # # # ######### # # # ### # ### ### ### # # ### # # # ### ##### # ######### ### # #
# #   #   #   #   #   # #   # #   #     # #   # # #   # #   # #   #     # #     #   # # #   # # #   #   #   # # #   # # # # #   #   #       #   #   # #
# ### ### ##### # # ### ##### ### # ### # ### ### # ### # ### # ######### # # # # ### # ### # # # ### ### ### # # ### # # # ### # ######### ### # ### #
#   #   #     # #     #   #   #   #   #     #     # # #   #   # #       # # # # #     #   # # #   #   #   #     # #   #     #   # #     # # #   # #   #
##### # ##### ### ##### # ### # ##### # ########### # ### # ##### ##### # ### # ##### ### # # ##### ### ##### ### # ######### ### # # # # # # ### # # #
#   # # #   #   #   #   #   # # #   # # #           #   # #       #   # #   # #     #     # #       #       # #   #       #   #   # # #   #   # #   # #
# # ### # # ### ##### ##### # # ### # ### ############# # ######### # # ### # ##### ##### # ####### ####### # ### ####### # ### ### # ### ##### ##### #
# # #   # #   #     #   #   #       #   #       #       #     #   # # #   #   # #   #     # #     #         # #   #         #   #   #   # #   # #     #
# # # ### ### ##### ### # ############# ####### # # ######### ### # # ### ##### # ######### # ### # ######### # # # ######### ######### # # # # # #####
# #   #   #   #     #   #         #     #     # # # #   #   #     # #   # #   #   #         #   # # #   #   # # # # #     #   #     #   #   # # # #   #
# ### # ### ### ##### ########### # ##### ### # ### # # # # ##### # ### # # ### ### ########### # # # # # # # # # # # ### # ### ### # ####### # # # # #
#   # #   # # # #     #     #     #         # #   #   # # # #     #   # # #   # #   #       #   # # # # # #   # # #   # # # #   # # # #     # # # # # #
### ### ### # # # ### ##### # ############### ### ##### # # # ####### # # # # # # # # ##### # ### ### # ### ### # ##### # # # ### # # # ##### # # ### #
#   #   #   # # # #   #   #   #   #     #   #   # #     # #   #     # #   # #   # # # # #   # # #     #   # #   #       # #   #   # # #   #   # # #   #
# # # ### ### # # ##### # ### # # # ### # # # # # # ##### ##### ### # ##### ##### ### # # ### # ######### # # ### ####### ##### ### # # # # ### # # ###
# # #   #   #   # #     #   #   # #   #   # # # # #         #   # # #   # # #       # # #     #     #     #   #   #       #     #   # # #     # # #   #
# # ### ### # ### # ####### ##### ### ##### # # # ######### # ### # ### # # ##### # # # ####### ### # ########### # ####### ### # ### ####### # # ### #
# #   #   # # #     #     # #   #   #   # #   # #         # #   #   #   # #     # #       # #   #   #   #       # # #       # # # #   #     #   # #   #
# ### ### # # ### ####### # # ##### # # # ##### ######### ##### # ### ### ##### ######### # # # # ##### # ##### # # # ####### # # ### # ### ##### # ###
#   # #   # #   #         # # #     # # #       #       #       #     #       #     # #   #   # #     #   #   # # #   #   #     #   # # # #     # #   #
# # # # ### ### ####### ### # # ####### # ######### # ################# ##### ##### # # ####### # ##### ##### # ### ### # ##### ### # # # ##### # ### #
# # # # # # # #   # #   #   #   # #     #       #   # #     #     #   # #   #   #   # #       # # #   #       # #   #   # #   # #   #     #     # #   #
### ### # # # ### # # ### ### ### # # ### ##### # ##### # # # # # # # ### # ### # ### ####### # # # # # ####### # ### ### # # ### ######### ### # # # #
#   #   # # #   # #   #   #   #     # # # #   #   #   # # # # # # # #     #     # #       #     # # # # #       #   # #     #     #       #   # # # # #
# ### ### # ### # # ### ### ######### # # # # ### # # # # ### # # # ############# ####### # ####### # ### ######### # # ########### # ### ### # # # # #
#   # #   #   #   # #   # # #   #     #   # # #   # # # #     # #   #     #     # #     #     #     #   #         # # #   #   #   # # # # #   # # # # #
# # # ### ### # ##### ### # # # # ##### ### # # ### # # ####### ### # ### # ### # # ### # ##### ####### # ##### ### # ##### # # ### # # # # # ### # # #
# #         # # #     #   #   #   #     #   # #   # #     #     #   # # #   # # #   #   #   #   #   #   # #   #   # #       # # #   # #     # #   # # #
# ########### # ### ### # ######### ##### ### ##### ####### ######### # ##### # ##### ### ### ### # # ##### # ### # ####### # # # ### # ####### ### ###
#   #         #     # # #   #       #   # # #     #   #   #   #       #       #     # #   #   #   # # #     #   #     #   # # # #   # #   #   # #     #
# ### ############### # # ### ####### # # # ##### # ### # ### # ######### ### ### ### # ### ####### # # # ##### ##### # # # # # ### # ##### # # # ### #
# #   #         # #     #         #   # #   #   #   #   #     # #       #   # #   #   # #   #     # # # #   #   #   # # # # # #     #     # #   #   # #
# # # # ####### # # ############# ##### ### # # ##### ######### ##### # ##### # ### ##### ### # # # # ##### # ### # ### # # # # ######### # ######### #
# # # # #     # # #   #         # #   #   # # # #   #     #     #     #   #   #     #     #   # #   #     # #     #   # # # # # #       #   #         #
### # # # ### # # # ### ####### # # # ### # # # # ####### # ##### ####### # ######### ######### ### ##### # ######### # # ### # ####### ####### ##### #
#   # # #   # # #   #   #     # #   #     #   # #       #   #     #   #     #       #   #       #       # # # #       # #     #   #       #     #     #
# ##### ### # # ##### ##### # # ##### ######### ####### ####### ### # ####### ##### # # ### # ######### # # # # ####### ######### # ##### # ####### ###
#       #   # #       #     # # #   # #     # # #       #     #     #         #   #   # #   # #     # # #   #   #   #     #     #   # #   #   #   #   #
# ####### ### ########### ### # # # ### # # # # # ##### # ### ##### ########### # # ### # ##### ### # # ##### ### # # ### # # ####### # ### # # # ### #
# #       # #     #       #   #   # #   # #   #   #   # # # # #   #   #   #     # # #   #   #     # # # #     #   # #   # # # #           # # # #   # #
# ### # ### ##### ### # ##### ##### # ### ### ##### # # # # # # # ##### # # ##### # # ### # # ##### # # # ##### # # # ### # ### ######### ### # ### ###
#   # # #   #   #   # # #   # #   #   #   # #   #   # #   # #   #       # # #   # # #   # #   #   # # # #   #   # # # #   # #       #   #   # # # #   #
### ### # # # ##### ### # # ### # ### # ### ### # ### ##### ############# # # ### ### # # ##### # # # # ### # ### ### # ### # ####### # ### # # # ### #
# #     # # #     #   #   # #   #   # # #     #   #   #   #             # # #   #   # # #   #   #   #     # #   #     #   #   #       # # # # #   #   #
# ####### # # ### ### ##### # ##### ### # ### ##### ##### # ######### ### # ### ### # # ### # ############# ### ######### ##### ####### # # # ### # ###
# #       # #   #   #     # #     #   # # #       # #     #     #   #     # #     # # #   # #       #       #   # #     # #       #   # # # #   # #   #
# # # ##### ##### ####### # ##### ### # ### ####### # ######### # ######### # ##### # ### ######### # ####### ### # ### # # ####### # # # # # # # ### #
#   #   # #       #       #     # # #   #   #   #   #       #   #     #     #     # # # #     #   # # #     # #       # #   #       # # #   # # #   # #
# ##### # ####### # ####### ##### # ##### ### # # ### ##### # ##### # # ### ##### # # # ##### # # # # # ##### # ####### ##### ####### # # ### ##### # #
#     # #         # # #     #   # #           #   #   #     #   #   # #   #     # # #       # # #   # #       #   #       # #   #       # #   #     # #
##### # ########### # # ### # # # # ################### ####### # ### ### ##### # # ### ##### # ##### ##### ####### ##### # ### ######### # # # ##### #
#   # #         #   #   # # # # # # #   #   #         #   #     # #     # #     # #   # #     #     # #   #       # #       # #       #     # #   #   #
# # # ######### # ### ### # # # # # # # # # ####### # ### # ##### ##### ### ##### ### ### ######### # # # ####### # ####### # ####### # ######### # ###
# #   #       # # #       #   # # # # # # # #   #   #     #     #     #   # # #     #     #       # #   #   #   #   #     # #   #     #   #     # #   #
# ######### # # # ########### # # # # # # # # # # ####### ##### # ### ### # # # # ########### ### # ####### # # # ### ### # # # # ### ##### # ### ### #
# #         # # # #         # # # #   #   # # #   #     # #   # #   # # #   # # #     #       #   #     # # # # # #   # # #   # # # # #     #   # # # #
# ### ####### # # # ####### ### # ######### # ##### # ### ### # ##### # ##### # ### # # # ####### # ### # # # # # # ### # ##### # # # # ####### # # # #
#     #   #   # #   #     #   # #   #     # # #     # #   #   # #     #       # # # # # #       #   # # # #   # # # #   #     # # #   #     # #     # #
####### ### ### ##### ####### # ### # ### # # # # ##### ### ### # ####### ##### # # # # ####### ##### # # ##### ### # ####### ### ######### # ####### #
#     #       #   #   #     # #   #   #   #   # # #     #     #   #     # #   # # # # #   #     #   #   #   #   #   #         #   #         #   #     #
# ### # ######### # # # ### # # ####### ####### ### ######### ##### ### # # # # # # ##### # ####### # ##### # ### ####### ##### ### ######### ### ### #
# #   # #   #     # #   #   # #     #   # #     #   #         #       # #   # #   # #     # #       # #   # # #   #     #   #     # #   #   # #   #   #
# # ### ### # ##### ##### ### ### # # ### # # ### ####### ##### ##### # ### # ### # # ##### ##### # # # # # # # ### ### ### # ### # # # # # # # #######
# # #   #   #     #     #         # # #   # #   # #   #   #     #   # #   # #   # # #   # # #   # # #   #   # # #   # #   # #   #     #   #   #       #
# # # ### # ##### # ########### ##### # ### ### # # # # # # ##### ### ### ### ### # ### # # # # # # ####### # # # ### ### # ##### ########### ####### #
# # #   # #     #   #       #   #   # #     # # #   # # # # #     #   #       #   #     # # # #   # #   #   # # #     # # # #   # #     #   # #     # #
# # ### # ########### ##### ##### # # # ##### # ##### # ### # ##### ### ####### ######### # # ####### # # ### # ##### # # # # # ### ### # # # # ### # #
# #   #   #   #       #   # #     #   #       # #     # #   # #   # #   #     #     #     # #         #   #   #     # # # #   # #   #   # # # # #   # #
# ### # ### # # ####### ### # ############### # # ##### # ### # # # ##### ### ##### ### # # ##### ######### ##### ### # # ##### # ### ##### # ### ### #
# # # # #   #   # #   #   # #   #   #       # #   #     #     # # #     #   # #     #   # #     #     #     #   #       #   #   # # # #     #   # #   #
# # # # # ####### # # # # # # # ### # ##### # ##### # ####### # # ##### ### # # ##### ### ##### # ##### ##### # ######### # # ### # # ### ##### # # # #
#   #   #   #     # #   #   # #   #       #   #     #     #   # #       # # #   #     #   #   # # #   #       #         # # #     #   #   #       # # #
### ####### # ### # ############# ######### ##### ##### # # ### ####### # # ######### # ##### # ### # ################# ### ####### ### # # ####### ###
#   # #   # #   # # #             #       # #   #   #   # #   # #     #   #   #       #       # #   #             #   #   # #     #   # # # # #   #   #
# ### # # # ### # # # ######### ### ##### # # # ##### ### ### # # ### ####### # # ########### # # ### ########### # # ### # # # ##### # ### # # # # # #
# #   # #   #   # # #   #   #   #   #   # #   #     #   # #   #   # #   #     # # #     #   # #   # # # #         # # #   # # #       #       # # # # #
# ### # ##### ##### # # # # # ### ##### # ######### ### ### ####### ### # ##### ### ### # ### ##### # # # ######### # # ### ####### ### ####### # ### #
# #   #     #     # # # # #     #   #   # #       #   #   #       #   #   #     #   # # #     #     # #     #     # #   # #   #   #   #   #     #   # #
# # ####### # ### # ### # ######### # # # # ######### ### ####### # # ##### # ### ### # ### ####### # ##### # ### # ##### # # # # ### ##### ####### # #
#   #       # #   #     # # #       # # # #   #     #   #     #   # #     # #   # #   #   # #     # #     # # # #   #   #   #   #   #       #   #   # #
##### # ####### ######### # # ####### ### # # # ### ### # ### # ### ####### ### # # # ### # # ### # ##### ### # ##### ### ######### ########### # ### #
#     # #   #   #       #   #     #   #   # #   #     # # #   #   #       #   # #   # #   #   # # #   #   #   #     # #   #       # #   #       # #   #
# ####### # # ### ##### ### ##### # # # ### ##### ##### # ####### # ##### ### # ### ### ####### # ### # ### ### ### # # ##### ##### # # # ### ### ### #
# #       # #     #   #   # #   # # # #   # #   #         #   #   #   # #     #     #   #     # #     #   #   #   #   # #     #     # # # # #   #   # #
# # ####### # ##### # # ### # # # # ##### # # # ### ####### # # ##### # ####### ##### ### ### # ##### ### ### # # ##### # ### # ##### # # # ### ### # #
#         # # #     # # #   # # #   #     # # #   # #   #   #   #         #   #     # #   #         #   #   # # # #   #   # # # #     #   #   #     # #
########### # # ##### # # ### # ### # ##### # ### # ### # ####### ######### # ### ### # # ######### ### ### # # # # # ##### # # ######### ### ##### # #
#           # # #   # #     # #   # # # #   # #   #     #     # # #   #     #   # #   # #   #     #   # #   # # #   #     #   #         #     #   #   #
# ########### # ### # ### ### # ### # # # ### # ##### ####### # # # # # ####### # # ### ### ##### # ### # # # # ######### # ########### ####### # #####
# #   # #   # #     #   # #   #     # # # #   # #   # #       #   # #   #       # # # # # #     #   #   # # # #   #     # #   #       #   #     #     #
# # # # # # # ##### ### # # ######### # # # ### # # ### ####### ### ##### ##### # # # # # ##### ##### ### # # ##### ### # ### ### ##### # # ######### #
# # # #   # # #   # # # # # # #       # # #   # # #   # #   #   # #   #   #   # # # # # #     #   #     # # #       # # #         #   # # #         # #
# # # ##### # ### # # # ### # # ####### # ### # # ### # # ### ### ### # ### # # ### # # # # ##### # ##### ########### # ########### # # # ##### ##### #
# # #     #       #   #       # #   #     #   # #   # # # #   #     # # #   # #     #     # #     #   #   #             #           # # # #     #   # #
# # ##### ########### ##### ### # ### ##### ### ### # # # # ### ### # # # ### ####### ####### ### ### # ### ############# ########### # # # ##### # # #
# # #   #       #   # #   # #   # #   #       # #   #   # # #   #   # # #   #     #   #       #   #   #   # #           #     #     # # #   #     # # #
# # ### ####### # # # # # ### ### # ### ####### # ####### # ##### # # ##### ##### ##### ####### ### ##### # ### ####### ##### # ##### # ##### ##### # #
# #   #       # # #   # # #   #   #   # #   #   #   #     #       # #     # #   # #     #   #   #   # #   #   #   #   # #   # #       #   # #     #   #
# ### ##### ### # ##### # # ### ### ### # # # ##### # # ########### ### ### ### # # ##### # # ### ### # # ### ### # ### # # # # ######### # ##### ### #
#   #   #   #   # #   # #   # #     #   # # #       # # #   #     # # #   # #   # #   #   # # #       # #   #     # #   # #   # #               #   # #
# # ### # # # ### # # # ##### # ##### ##### ########### # # # # ### # ### # # # # ### # ### # # ####### ### ####### # ### ##### # ################# # #
# #   #   # #   #   # #     # # #   #     #           #   # # #       #   # # # #   # #   #   # # #     #           # #   #     # # #               # #
# ### ##### ### ##### ##### # # # ####### # ######### ##### # ######### # # # # ### # ##### ### # # ######### ####### # ##### ### # # ####### ####### #
#   #     #   #   #   #   # # # #       # #       # #     #       #   # # #   # #   #     # #   # #   #     # #       #     #   #   #   #     #   #   #
### ### # # ### # # ### # # # # ##### ### ####### # ##### ####### # # # ####### # ### ### # # ### ### # ### ### ########### ### # ##### ####### # #####
# # # # # # #   # # # # #   # #       #   #       #     #   #   # # #   #       #   # #   # #   #   # #   #     #         # #   # #   # #     # #     #
# # # # ### # ##### # # ##### ####### # ### ####### # ##### ### # # ##### ######### ### ### ### # ### ### ########### ### # # ##### # # # ### # ##### #
#   # #     #     # # # #   #       # #   # #   #   #     #   # # #     # #   #   #   # #   #   # #     #           # #     #     # #   # # #     #   #
# ### ########### # # # # # ##### # # ### # # # # ####### ### # # ##### # # # # # ### # ##### ### # ############### # ########### # ### # # ####### # #
#     #         #     #   #   #   # # #   #   # #   #   # #   # # #   #   # # # #     #       #   #   #           # #       #   # #   # #       #   # #
##### ####### # ######### ### # ##### # ####### ### # ### # ### # ### ##### # # ####### ####### ##### # ##### ##### ####### # ### # # # ##### ### ### #
#   # #       # #   #   #   # # #     # #     # #   # #   # #               # # #     # #     # #     #   #   #   #         #   # # # #   #   #   #   #
### # # ####### # # # # ##### # # ##### # ### # # ### # # # # ############### # ##### # # ### # # ##### ### ### # ########### # # ### ### # ### ##### #
#   #   #     #   # # #     # # #     #   # #   # #   # # # #   #   #       # #     #   #   # # #       #   #   # #   #       # #   #   # # # #     # #
# # ####### # ##### # ##### # # ##### ##### ##### ### # # # ### # # # ##### # ##### # ##### # # ######### ### ### # # # ####### ### ### ### # ##### # #
# # #       # #     #   # #   #   #   #         #     # # #   # # #   #   # # # #   #       # #     #     #   # #   #   #         #   #         #   # #
# ### ### ##### ####### # ##### # # ### ####### ##### # ##### ### ##### # # # # # ########### ### ### ### # ### ######### ####### ### ######### # ### #
#   #   #     # #       # #     #     #       #     # #       #   #   # #   #   # #     #         #   #   #           #   # #       #         # # # # #
# # ### ##### # # ####### # ######### ############# # ######### ### ### ####### # # ##### ######### ############# ##### ### # ############### ### # # #
# #   # #   #   #   #     # # #   #           #     #     #   #   #   # #   #   # # #   # #         #       #   # #     # #   #             #     # # #
# ### # # # ####### # ##### # # # ########### # ######### ### # # ### # ### # ### # # # # # ##### ### ##### # # # # ##### # ### ####### ### ####### # #
# # #     #   #   # #   #   # # #       #       #     #   #   # # #   # #   # #   #   #   #   #   #   #   #   # # #     # # # # # #     #   #       # #
# # ########### # # # # # ### # ####### ### ##### ### # ### # # # # ### # ### # ### ######### ##### ### # ##### # ##### # # # # # # ##### ##### # ### #
# #   #     #   # # # #   #   #       #   # #   # # #   #   # # # # #   # #   # #   #   #   # #     #   # # #   # #   # #     #   #     # #   # #   # #
# ### # ### # ### # # ####### ####### ### ### # # # ##### ### # # # # ### # ### # ### # ### # # ##### ### # # ### # # # ######### ##### # # # # ### # #
#   # #   # #   # # # #     #       # # #     # #   #     #   # # #   #       # #     #   # # #   #     #   #     # # #     #     # #   # # # # #   # #
### # ### # ### # # # # ### # ##### # # ####### ### ### # ##### # # ### ####### ######### # # ### # ### # ######### # ##### # ##### # ### # # ### # # #
# # #   # #     #   #   #     #   # #     #       #   # #   #   # # #     #     #     #   # #     #   # # #         # #   #   #     # #   # #     # # #
# # # # # ############# ####### # ####### # ######### ##### # ### # ##### # ##### ##### ### ######### # # # ### ##### # # ######### # # ### # ##### # #
# #   # # # #     #     #       #         #         #     # # #   #     # # #         #         # #   # # # #   #   #   #   #       # # #   # #   # # #
# ##### # # # ### # ##### ######################### ##### # # # ####### # # ##### ### ######### # # ### ### # ### # ####### # ####### # # ##### # ### #
#     # # #   #   # #   #       #           #     #   #   #   #   # #   # #     # # #   #     # #     #     #     # #     #   #       # # #   # #   # #
# # ### # ##### # # # ######### ####### ##### ### # ### ### ##### # # ### ##### # # # ### ### # ########### ####### ### # ### # ####### # # # # ### # #
# #   # # #   # # #   #       #     #   #     # # # #   #     #   # #   #   #   #   # #   # #   #         #     # #   # #   # # #         # #   # #   #
# ### # # # # # # # ### # ######### # ### ##### # # # ### ##### ### ### # ### ### ### # ### ##### ####### ##### # ### # # ### # ########### ##### #####
# # # # # # # # # # #   # #           #   #         # #     #   #     # # #   # # #   # #         #     #   #       # # #     #       #     #         #
# # # # # # # # ### # ### # ########### ### ####### # # ##### ### ### # # # ### # # ### # ########### # ### ####### # ############### # ####### ### # #
#   #   #   # # #   # #   #   #     #   # # #   #   # # #   #   #   # # # # #   # #     # # #         #   #   #     #               #   #     #   # # #
### ######### # # ### # ##### ### # # ### # # # ### # # # # ### ##### # ### # # # ####### # # # ############# ############# ##### # ####### # ### # # #
#   #       # #     # #     # #   # #   #   # #   # # # # #     #     # #   # # #     #   #   #     #         #   #   #   #     # #   #     # #   # # #
# ####### # # ####### ##### # # ### ### ##### ### ### ### ####### ##### # ### # ##### # ### ####### # ######### # # # # # ####### ### ### ### ##### # #
#         # #             #     #     #         #         #               #   #         #         #             #   #   #         #       #         # #
#######################################################################################################################################################
