###################################################################################################################################
#       #     #   #           #             #                 #   #               #           #         #             #     #     #
####### # # # # # # ######### ##### ####### # ############### # # ######### ##### # ####### ### # ####### ##### ##### # ### # ### #
#       # # #   #   #       #   #   #       #         #         #           #   # #       #   # #   #   #   #   # #   #   # #   # #
# ####### # ########### ### ### # ### ##### ##### ### # ##################### # # # ##### ### # ### # # # ### ### # ####### # ### #
# #     # #   #         #     #   #   #   #     #   # # #   # #       #   #   #   # #   #   #   #   # #   #   #   #       # # #   #
# # ### ### # ### ### ####### ##### ### # ##### ##### ### # # # ### ### # # ######### # ####### # ### ##### ### ######### # # # # #
# #   #   # #   #   # #   #     # #   # #     #       #   # # #   #     # # #         # #     # #   #   #   #     #       #   # # #
# ### ### ##### # # ### # ##### # ### # ##### ##### ### ### # ### ####### # ##### # ### # ### ##### ### # ####### # ######### # ###
#   # #     #   # #     #     #   #   # #     #   # #   #   #   #       #   #   # # #     #           # # #       #   #     # #   #
### # ##### # ######### ##### ##### ### # ### # # # # ### ### ### ######### # # ### ############### ### # # ##### ### # ### ##### #
# # #     #   #       # #   # #       # # #   # # # #   # #       #       #   # #   #   #   #     # #   # # #   # # # # # # #   # #
# # # ### ##### ##### # # ### # ####### # ##### # ##### # ### ##### ##### ##### # ### # # # ##### # # ### # # ### # # # # # # # # #
#   #   #           # # #   #       #   #       #       #   #   #   # #   #   # # #   #   # #   #   # #   # # #   # #   # #   # # #
# ####### ########### # ### ######### ##################### ### # ### # ### # # # # ####### # # ##### # ### # # ### ##### ##### # #
#       #   #   #     #     #     #   # #         #     #   #   # #   # #   # # # # # #     # #       # #   # #         #     #   #
####### ### # # # ### ####### ### # ### # # ##### ### # # ### ### # ### # ### # # # # # ### # ######### # # # ### ####### # ##### #
#     #   #   # # #   #       # #   #     # #   #   # # #   #   #   #   #   # #   # # #   # #   #       # # #   # #       #       #
# ####### ####### ### # ####### ##### ##### # # ### # # ### ### ### # ##### # ##### # ### ##### # ####### # ### # # ###############
#         #     #   # #     #       #   # # # # #   # #   # # # # # #       #     # # #   #   # #     #   #   #   #   #         # #
# ######### ### # # ####### ### ### ### # # # ### ####### # # # # # ############# # # # ### # # ##### ####### ### ### # ##### # # #
# #       # #   # #       #   #   #       # #     #       # # #   #   #       # # # # #     #   #   # #     #   # #   #   #   # # #
# ### ### # # ##### ### # ### ### ######### # ####### ### # # ### ### # ##### # # # # ####### ### ### # ### ### # # ##### # ### # #
#     # #   #     #   # #   # #   #         #         #   # #       # # #   #   # # #   #   #     #   # # # #   # # # #   # #   # #
####### ######### # ### ### # ##### ####### ########### ### # ####### # # # ##### # # ### # ####### ### # # # ##### # # ### # ### #
#   #     #     # # #   #   #     #       # #   #         # # #   #   #   # #     #   #   #         #     # # #     #   #   #   # #
### # # ### ### # ### ########### ### ### # # # ########### # # ### ####### # ### ### # ########### # ##### # # ##### ### ##### # #
#   # #     # # #   #           #   # #   # # # #         # #   #   #       # #     # # #     # #   # # #   #     #     #   # # # #
# ### ####### # ### # ####### ##### ### ##### # # ####### # ### # ### ##### # ####### # # ### # # ### # # ####### ##### ### # # # #
# #   #       #     #       #       #   #     #         # #   # # #   #   # # #       # # # # #     #   #       # #   # #   # # # #
# # ### ##### ####### ##### ######### ### ############### ### # # # ### ### # # ####### # # # ### ### ######### # # # ### ### # # #
# #   # #   #     #   #   #     #             #         #   # # # #   #   # #   #     #   # #   # #   #         # # #   #   # #   #
# ### # # # ##### # ### # ##### ### ########### ####### # # # ### ### ### # ##### ### ##### ### # # ### ######### # ### ### # ### #
#   # # # #       #   # #   # #   # #         # #       # # # #   #   #   #       #   #     # # # # #   #   #   #   # # #   # #   #
### # # ##### ######### ### # ### ### ####### # ### ##### ### # ### ### # ######### ##### # # # ### # ### # # # ##### # # ### # ###
#   # #     #           #   #   #   #   #   # #   #   #   #   #     #   #     #   #       #   #     # #   # # #     # # # #     # #
# ### ##### ############# ##### ### ### # ### ### ### # ### ######### ####### ### ########### ####### # ### # # ### # # # ### ### #
# #   #     #   #       #     #         #   #     # # # #   #       # #               #     # #     #   #   # #   #   # #   #   # #
# # ### ##### ### # ######### # ########### ####### # # # ### ### # # ############### ### # # # # # ##### ### ### ##### # # ### # #
# # #     #   #   #         # # #   # #     #   #       #     #   # #   #         #   #   # # # # # #     # #   #     # # #   #   #
# # ##### # ### ####### ##### ### # # # # ### # # ##### ####### ### # # # ####### ### # ### # ### # # ##### ### ##### # # ### ### #
# #   #   #   #     #   #   # #   # #   #   # #   #   #   #   # #   # #     #   #   #   #   #   # # #     #   #     # # #   # # # #
# ### # ### # ### ### ### # # # ### ##### # # ##### # ##### # # ### ##### ### # ### ####### ### # ####### # # ### ### # ##### # # #
#   #   #   #     #   #   #   #   #     # # #     # # #     # #   #     # #   #     #     #   # #     #   # #     #   #       # # #
# # ##### ######### # # ######### ##### ### ### ### # # ##### ### ##### ### ####### # ### ##### # ### # ####### ### ########### # #
# #     #     #     # #     #     #   #   # #   #   #   #   # #   #   #     #   #   # # #       #   # # #     #   #       #     # #
# ##### ##### # ########### # ####### ### # # ### ####### # # # ##### ####### # # ### # ############# # # ### ### ### ##### # ### #
# #   #   #   # #         #   #       # # #     #   #   # #   #   #     #     # #   #   #           # # # # #   #   #       #     #
# # # ### # ### # ##### # ##### # ### # # # ##### # # ### ####### # # ### ### ##### ### # ######### # # # # ### ### ###############
#   #   # # # #   #     # #     # #     # # #   # # #     #       # # #   #   #   #   # # #       #   #   #   # #       #     #   #
##### ### # # ##### ### ### ##### ##### # # # # ### # ##### ####### # # ### ### # # ### # ### ### ### ##### # # ######### ### # # #
#   # #   #   #   #   # #   #   #     # # # # #     #   #     #     # #   #   # #   #   #   # #     #       # #         # # #   # #
# # ### ##### # # ### ### ##### ##### # # ### ######### ##### # # ####### ### # ##### ##### # ##### ######### ######### # # ##### #
# # #   #       #   # #   #         # # #     #       #   #   # #       #   # #   #   #     #   # #   #   #   #   #     #       # #
# # # ### ########### # ### # ####### ######### ### # ### # ##### ### ##### # ### # ### ####### # ### # # # ##### # ####### ##### #
# #   #       #       # #   # #     #         #   # # #   # #   #   # #     #     #     #       #   # # # # #     #         #     #
# ##### ####### ####### ##### # ### ######### ### # ### ### # # ### # # ################# ### ### # # # ### # ### ########### ### #
#       #     # #     # #   # #   #   #         # #   # #   # #   # #               #       # # # #   #   # #   # #     #     # # #
# ####### ### # # ### # # # # # ### # # ######### ### # ### # ### ################# ####### # # # ##### # # ### # # ### # ##### # #
#     # # #     # #   #   # # # #   # #     #       # #   # #   #     #     #     # #   #   # # # #     # #     # # #   # #       #
##### # # # ##### # ####### # # # ### ##### # ####### ### # ### ##### ### ### # ### # # ##### # # ####### ####### ### # # ####### #
#   #   # # #     # #   #   #   # #     #   # # #     #   #         #   # #   #   # # # #     # # #         #   # #   # #       # #
# # # ### # # ##### # # # ### ### # ##### # # # # ### # ############### # # ##### # # # # ##### # # ####### # # # # ### ####### ###
# #   #   # #     # # #   #   #   #   #   # #   # #   # #   #           # # #   #     #   #       #   #   # # #   # #   #     #   #
# ##### ##### ##### # ##### ### ##### # ####### # ##### # # # ########### # ### ################# ### # # ### ##### # ### ### ### #
#   # #       #     # #   # #   #   # # #       #     #   # # #   #   #   #   #   #       #     #     # #   #   #   #     #   #   #
### # ######### ##### # ### # ### # # # # ########### ##### # # # # # # # ### # # # ##### # ### ##### # ### ### # ##### ####### # #
#   #         #     # # #   # # # #   #   #   #       # #   # # #   #   #       # #   # #     # #     # # #       # #   #       # #
# ########### ##### # # # ### # # ########### # ##### # # ### ### ################### # ####### ####### # ######### # ### ####### #
#                 #   #   # # # #   #   #     #   # #   # # #   # #   #   #         # # #     #     #   #   #   #   # # # #   # # #
################# ##### ### # # ### # # # # ##### # ### # # # # ### # # # # ####### # # # ### ##### # ### # # # # ### # # # # # # #
#   #           #   # # #   # #   # # #   #   #   #   # # # # #     #   # # # #   # # # #   #       # #   # # # # #   # #   # #   #
# # # # ### ####### # # # ### # ### ######### # ##### # # # # ########### # # # # # # # ### ####### # ### ### # # # ### ##### ### #
# #   #   # #       #     #   #     #         # #   #   # #   #       # #   #   # # #   #   #     # #   #   # # #         # #   # #
# ##### # ### ############# ### ##### ####### # # # ##### # ### ##### # ######### # ### # ### ##### ### ### # # ######### # ### # #
# #   # # #   #         #   # # #     #     # #   #       # #   #   # # #         #   # # #       #   #   # # #         # #   # # #
### # ### # ### ####### # ### # ##### # ### ############### ### # # # # # ### ### # ### # ##### # ### ### # # ######### # # ### ###
#   #     #   #   #     #   # #     # #   #     #         #     # # # #     # #   #   # #     # #   #   #   # # #     # # #   #   #
# ####### ### ### ##### ### # ##### # # ##### # # ### ########### # # ##### # ### ### # ##### ##### ### ### # # # ### # # ### ### #
# #     #   #   #     #   # # #     #   #   # # # # #       #     # #     # #   # # # #   # #     #   #   # # # #   # # #       # #
# ##### ### ### ### # ### # # # ##### ### # # # # # ##### # # ### # ##### # ### # # # ### # ##### # # # ### # # ### # # ####### # #
#     # #     #   # # # # # # #     # # # #   # #   #   # # #   # #     # # #   #   #   #   #   # # #   #   # #   # # #   #   # # #
# ### # # ####### ### # # # # ##### # # # ##### ### ### # ### ### ### ### # # ##### # ##### ### # ### ### ### # ### # ### # # ### #
#   # #   #     #     #   # # #     # # #   #     #     # #   #   #   #   # # #     # #   # #   #   # #   # # #     #   # # #     #
### # ##### # ######### ### # # ##### # ### ##### # ##### # ### ####### ##### # ##### # # # # ##### # # ### # ### ### ### # ##### #
#   #       # #     #   #   #     #     # # #   # # #   # #   #         #   # #   # #   #   # #     # # #   #   #   #   # #   # # #
# ########### # # # # ### # ##### ##### # # # # # ### # # ### ########### # # ### # ######### # # ##### # ##### ### ### # ### # # #
# #   #     #   # # # #   #     #   #     #   # #     # # #   #   #       #   # #   #         # # #   # # #     #     #   #   #   #
# # # ##### ##### # # ### ##### ### ##### ##### ####### # # ### ### ##### ##### ### # ####### # ### # # # # # ##### ##### # #######
#   #   #   #     # #   # #     #   #   #   # #   #       #   #     #     #       # #   #     #   # # #   # # #   # #   # #       #
####### # ### # ####### ### ##### ### # ### # ### ########### # ##### ##### # ##### # ### ### ### # # # ### # # # ### # # ####### #
#   #   # #   # #     #   #   # #     # # # #   # #         # #     # # #   #     # # #   # # # #   #   #   # # #     # #       # #
# # # ### # ### # ### ### ### # ####### # # ### # # ####### # ##### # # # ####### # # # ### # # ######### ##### ####### # ##### # #
# # #     #   # # #     #     # #       #     # # # #     #   #     # # #       # # # # # #   #         #         #     # #   #   #
# ####### ### ### # # ######### # ########### # # # # ######### ##### # ### ##### # ### # # ### ####### ########### ####### # #####
#         # # #   # # #       #   #         #   #   #           #   # #     #     #   # #   #   #     #       #   #         #     #
# ######### # # ### ### ##### # ####### ### ####### ### ######### # # # ##### ### ### # # ### ### # ##### ##### # ##### ######### #
# #       # #     #   #   #   #         # # #     #   #       #   # # #     # #   #   # #     #   #       #     # #   #       #   #
# # ##### # ######### ### # ############# # # ### ### ####### ##### # ##### # ##### ### ####### ########### ##### # # ##### ### # #
#   #   #   #       #   # #       #       #   # # # # #     #       #     # # #   #   #       # #   #   #   #   #   # #   # #   # #
##### # ### # ##### # # # ##### ### ##### ##### # # # # ### ####### ##### ### # # ### ####### # # # # # # ### # ##### # # # # ### #
#     # #   #     #   # #   # # #   #   #       # # # #   #   #     #   # #   # #             # # #   # #     # # #   # #   #   # #
# ##### # ####### ######### # # # ##### ####### # # # ### ### # ####### # # # # ############### # ##### ####### # # ### ####### ###
# #     # #     #     #     # #   #     #   # #   #   #   #   #         # # # #   #   #       # #   # # #   #   # #   #   #   #   #
### ### # ### # ##### # ##### ##### # # # # # ##### ##### # ########### # # ##### # # ##### # # ### # # # # # ### ### ##### # # # #
#   # # #     # #   #   #   #   #   # #   # #     #     # #     #   #   # #       # #   #   # #     #   # #   #     #   #   # # # #
# ### # ####### # ####### ### # # ### ##### ### # ##### ####### # # # ### ####### # ### # ####### ####### ##### ### ### # ### ### #
#   # #       # #     #       #   #   #   #     # #   #   #   #   #     #   #   # # # # #   #   # #   #   # #   #   # #   # #     #
# # # # ##### # ### # # ########### ### ######### # ##### # # ########### # # # ### # # ### # # # # # # ### # ### # # ##### ##### #
# # #   #   # # #   # # #   #   #   #         #   #     #   # #   #     # #   # #     #   # # #   # #   #       # #     # #   #   #
# # ##### # ### # ##### # ### # # ##### ### ### ### # ####### # # # ### ####### # ####### # # ##### ############# ##### # # # # ###
# # #   # # #   #       #     # # #   # # #     # # # #         # # #   #     # # # #     # #   # # #             #       # #   # #
### # # # # # ### ############# # # # # # ####### # # # ######### # # ### ### # # # # ##### ### # # ### ############### ### ##### #
#   # #   #   #             #   #   # #     #       #   #       #   # #   #   # #   # #   #     # #   #       #   #   # #   #     #
# ### ##################### # ####### ##### ##### ####### ##### ##### ### # ### ### # ### # ##### ### ####### # # # # ### ####### #
#   # #     #   #     #   # #       #   #       #       # # #   #     #   #   #     # #   # #       # #     #   # # #   # #       #
# # # # ### # # # ### # ### # ### # ### ####### ######### # # ####### # ##### # ##### # ### # ##### # # ### # ### # ### # # ##### #
# #   #   #   #   #   #     #   # # # #       #     #     # # #     #   # #   #   #   #     # #     # #   # #   # #   # #   #   # #
# ####### ######### ### ####### # # # ####### ##### # ##### # # ### ##### # ####### ### ##### # ### # ### # ### # ### # ##### # # #
# #       # #     #   # #       # # # #   #   #   # # #   #   #   # #       #       #   #     # #   #   # #   # #     #     # # # #
# # ### ### # # # ### # ######### # # # # # ### ### # # ### ##### # ####### # ####### ######### # ##### # ### ### ######### # # # #
# #   # #   # # #   # # #         #   # #   #       # #   #   #   #       #   # #   # #         #     #     #   #     #     # # # #
# ##### # # # # ##### # # ##### ####### ##### ####### ### ### # ######### ##### # # # # # ##################### ##### # ##### # # #
#       # #   #       #   #   # #       #   # #     #   #   #   #   #     #   #   # # # # #     #             # #     #       #   #
######### ################# ### # ######### # ### # ### # # ##### # # ####### # ### # ### # ### # ########### # # #################
# #   #   #     #         #     # #         #   # #   # # #   #   # #       #     #     # # #     #         #   # #     #   #     #
# # # # ##### # # # ##### ####### # ### ####### # ### # # # ### # ######### ##### ##### # # ####### ############# ### # # # # ### #
#   # #   #   # # #     #     #   # # # #   #   # # #   # #     # #       #     # #   #   #   #   #             #     # # #     # #
# ### ### # ### ####### ##### # ### # # # # # ### # ##### ####### # # ######### ### # ####### # # # ########### ####### ######### #
#   #       #           #       #     #   #       #             #   #               #         # #             #                   #
###################################################################################################################################
