#################################################################################
# #           # #                     #             #           #               #
# ##### ##### # # ############# # ##### ####### ### ##### ##### # ############# #
#       #   # #   #           # #       #     #   #     #   # # # #     #   #   #
######### # # # ### ######### ####### ### ##### # ##### ### # # # # ### # # # # #
#         # # #   # #     # #       #     #   # #   # # #     #   # # #   # # # #
# ######### # ##### ### # # ####### ### ### # ##### # # ######### # # ##### # # #
#         # # #     #   #   #   #   #   #   #       # #         # # #     # # # #
######### # # # ##### ##### # # # ### ### ########### ######### # # # ### # # # #
#         # #   #     #   # # #   #     # #   #   #           # # # # #   # # # #
##### ##### ##### ### # # ### ##### ##### # # # # # ##### ### # # # ### ### # # #
#   #   #       #   # # # #   #   #   #   # #   # # #   #   # # # #   #   #   # #
# # ##### ##### ### # # # # ##### ### # ### ##### # # # ### ### # ### # # ##### #
# #     # #   # # # #   #   #   #     # # # # #   #   #   #     #   # # #     # #
# ##### # # # # # # ######### # ####### # # # # # ####### ########### # # ##### #
#   # #   # #     #     #   # #   #     #   # # # #     #   #         # #       #
# # # ### ############# # # # ### # ##### ### # ### ### ### ### ####### #########
# # #     #           #   # #   # # #   # #   #   # #     #     # #   #         #
# # ### ### ##### ### ##### # # # # # ### # # ### # # ########### # # ######### #
# #   #   # #   # #     #   # # # # #     # # #   # #   #       #   #           #
##### # ### # ### ####### ##### # # # ####### # ### ### # # ##### ###############
#     # #   #   #         #     # # # #       #   # # #   #   #   #   #         #
# ##### # ##### ########### ##### # # # ### ##### # # ####### # ### # # ####### #
#   #   # #   #     #       # #   # #   #   #   #           # #     # # #       #
# # # ### # # # ### ####### # # ### ### ##### # ##### ##### # ####### # # ##### #
# # # #   # # #   #         # # # #   # #     #   #   #   # #   #     # # # #   #
### # # ### # ### ########### # # # # ### ####### # ### # ##### # ##### # # # ###
#   # #     #     #     #       #   #       #   # # #   #       #     # # # #   #
# ################# # ### ####### ########### # # # # ####### ####### # # # ### #
#           #       #     #         #     #   #   # #       # #     # # # #     #
# ######### # ##################### # ### # ### ########### ### ### # # # ##### #
# #   #     # #                 # # # #   # # # #   #     #   #   #   # #     # #
# # # # ### # # ############### # # # ##### # # # # # ### ### ### ########### ###
#   # # #   #   #   #     #   # #   # #     #   # #   # #   # #   #         #   #
##### # ######### # # # # ### # # ### # ### ##### ##### ### # # ### ####### ### #
#     #   #     # #   # # #   # #   # #   # #     #       # # # #   # #       # #
# ####### # ### # ##### # # # # ### # ### ### ######### # # # # ### # # ##### # #
# #     #   #   # #   # #   # # # #   # #     #       # # # # # #   # # #   #   #
# # ### ##### # # ### # ####### # ### # ######### ### # ### # # # ### # # # #####
#   # #   # # # # #   #         # #   #           #     #   # # # #     # #     #
##### ### # # ### # # ########### # ### ### ####### ##### ### # # ####### ##### #
# #     # # #   # # #   #   #     # #   #   #   #   #   # # #   #         #     #
# # # ### # ### # # # ### # # ### # ##### ### # ##### # # # # ####### ##### ### #
#   #   #     # # # # #   # # #   #       #   #       # # # # #     #     # # # #
# ##### ##### # # # ### ### # # # # ##### # ########### # # # # ### ####### # # #
# #   #     # # # #     # # # # # # #   # # #   #     #   # #   # #         #   #
# # # ##### # # # # ##### # # # ### # # ### # # # # ####### ##### ########### ###
#   #     # # # # #       #   # #   # #     # #   #             # #         # # #
######### # # # # ####### ##### # ### ######### ########### ### # # ### ### # # #
#   #   # #   # # #   #   #   #   # #     #   # #       #   # # # #   #   # #   #
# # # # # ##### # # # # ### # # ### ##### # # # # ### # # ### # # ### ### ##### #
# #   # # #     # # # # # # # #     #   # # # # #   # # # #         # # #   #   #
# ##### ### ##### # # # # # # ##### ### # # # # ##### # # ########### # ### # ###
#   #       #     # #     # # #       # #   # # #     # #   #       # #   # #   #
# # ####### # ##### ####### # ####### # ##### # # ##### ### # ##### # # # # ### #
# #   # #   # # #   #       # #   #     #     # # #   #   #   # #   #   # #   # #
# ### # # ### # # ### ####### # # ##### # ##### # # # ### ##### # ####### ### # #
# #   # #   # #     #       #   #     # # #   #   # #   #   #   #       # # # # #
# # ### ### # ############# ######### # # # # ##### ### ### # # ### # ### # # # #
# # # #     #       #       #   #     # #   # # #   # #     # #   # # #   # # # #
### # # ########### # ####### ### ##### ##### # # ### ####### # # # # # ### # # #
#   #         #   #   #       #   # #   #     #   #   #     # # # # # # #   #   #
# ########### # ####### ####### ### # ### ##### ### ### ### # # # # ### # # #####
#         # # #         #       #   #   #   #   #         # # # # #     # #   # #
# ####### # # ### # ##### ######### ### ### # ########### # # # ######### ### # #
# #     # # #   # #   #   #   #     #     # # #         # #   #           #   # #
### ### # # ### # ### # ### # # # ### ##### # ### ##### ### ####### ####### ### #
#   # #   #   # # #   # #   #   #     #     # #   #   #   # #       #     #     #
# ### ##### # # ### # # ########### ### ##### # ##### ### # # ####### # ####### #
# #   #     # #     # #   #   #   # #   #   #   #       # # #     #   #       # #
# # # # # ########### ### # # # # ### ### ######### # ### # ##### ##### ### ### #
# # #   #               # # #   #   # #             # #   #     #     #   #   # #
# ################# ##### # ####### # # ##### ####### # ####### ##### ### ### # #
# #   #           #   #   # # #     # #     #   #     #     # #   #   # #   #   #
# # # # ######### ### # ### # # ##### ##### ### # ######### # # ### ### ### #####
#   # #   #   #   #   #     # # #     # #   #   #     #     #   #   #     #     #
# ### ### # # # ############# # # ##### # ### ####### # ##### ### ### ### ##### #
# # #   #   # # #   #         # # #     #   #       # # #       #   # # #     # #
# # # ####### # # # # ### ##### # # # ##### ####### ### ########### # # ##### # #
#   #         #   #     #         # #             #                 #       #   #
#################################################################################
