###################################################
#       #               #         #         #   # #
####### # ####### # ##### # ##### ### ##### # # # #
#       #     #   # #     #   #   #   #   #   # # #
# ########### # ### # ####### # ### ##### ##### # #
# #         # # #   #   #     #     #     #     # #
# # ####### # # ####### # ########### # # # ##### #
# # #     # # #     #   # #     # #   # # # #     #
# ### ### # # ##### # ### # ### # # ### ### # ### #
#   # #     # #     #   #     # # #   #   # # #   #
### # ####### # ####### ####### # # ##### # # # ###
# # #         #         #   #   #   #     #   #   #
# # # ##################### # ####### ########### #
#   #       #             # # #     #         #   #
# ######### ### ##### ### # # # ### # ####### # ###
#       #     #     # #     # # #   # #       # # #
####### ##### ####### ####### # # ##### ##### # # #
#     #   #           #       # #       #   # # # #
# ####### ########### # ####### ######### # # # # #
#         #     # #   # #       #         #   #   #
# ######### ### # # ### ##### ################### #
# #       # #   #     #     # #   #     #   #     #
# ### ### # # ##### ####### # # # # ### # # # #####
#     # #   #     # #       #   #   #   # #   #   #
####### ######### # # ############### # # ####### #
#   #     #     # # # #       #     # # # #       #
### # # ### ### # ### # ##### # ### # ### ##### # #
#   # #     # # #   # # #   # #   # #   # #     # #
# ### ####### # ### # # ### # # ### # # # # # #####
# #   #       #     #       #   #   # #     # #   #
# # ### ##### ####### ##### ##### ### ######### # #
# #   # #   #     # # #   #     # # # #       # # #
# ### # # # ##### # # # # ####### # # # ##### # # #
#   # # # #       #   # #   #     #   # #   #   # #
# # # # ##### ######### ### # ######### # # ##### #
# # # #     #           #   #   #     # # #   # # #
# ### ##### ############# ##### # ### # ### # # # #
# #   #     #           #     #     #   #   # # # #
# # ### ####### ####### ##### # ##### ### ### # # #
# # #     #     #     #     # # #   #     # #   # #
# # ##### # ##### ### # ##### ### # ####### ### # #
# #   #   # #   # # #   #   # #   # #       #   # #
# ### # ### # ### # ##### # # # ### ##### ### ### #
#   #   #   #   #   # #   #   #   #     #   # #   #
# # ##### ##### ### # # ######### ##### ### # # # #
# # #     #   #       #     #     #   #   #   # # #
# ### ### # # ####### ##### # ##### # ### ##### # #
#   #   #   #     #   #   #   #   # #   # #     # #
# # ### ######### ##### # ##### ### # ### # ##### #
# #             #       #           #       #     #
###################################################
