###########################################################################################
#       #     #         #       #                 #     #                 #       #       #
####### # ##### ##### # # ####### ### ### ####### # ### # # ############# # # ### # ##### #
#       #         #   #   #       #   #   #     # #   # # # #     #     # # # # # # #   # #
# ################# ##### # ####### ####### ### # ### # # ### ### ### # # # # # # # # ### #
# #               # #   # # #     # #   #   #   #     # #   #   #   # # # # # # #   # #   #
# # # ########### # # ### # ### # # # # # ### ######### # # ### ### # ### # # # ##### # ###
# # #   #   #     # #     #     # #   #     # #   #     # #   # # # #     # # #           #
# ### # # # ##### # ############# ########### # ### ##### ### # # # # ####### # ###########
#   # #   #     #   #   #       #       #     #       #     # # # # # #       #     #     #
### # ######### ##### # # # ########### # ########### ####### # # # # ##### ######### ### #
# # #   #   #   #     #   # #       #   # #       #           #   # #   #   #         # # #
# # ### # # # ### ######### # ### ### ### # ##### ##### ####### ### ### # # # ######### # #
#   #     # # #   #   #   # # # #     # # #     #   #   #       #   #   # # # #         # #
# ######### # # ### # # # # # # ####### # ##### ### ##### ####### ### ### # # # ### ##### #
#       #   # #   # #   # #   #         #   #   # #       #   # # # #   # # # #   #     # #
####### ### # ### # ##### ##### ### ### # # # ### ######### # # # # ### # ### ### ##### # #
#     #   # #     # #       # #   # #   # # # #     #     # #   # #   # #       # #   # # #
# ####### ####### ### ##### # ### # # ### ### # # # # ### # ##### # ### ####### # # # # # #
#         #     # #   # #   #     # #   #     # # # # #     #   # #   #       # # # # # # #
# ######### ### # # ### # ####### # ############# # # ####### # # # # ####### # ### # # # #
# #       # #   #   #   #       # #   #       #   # #   #     # # # #     #   # #   #   # #
# ### ### # # ####### # ####### # ### # # ### # ### ### # ##### # # ##### # ### # ####### #
#     # #   #     # # # #       # #   # # #     # # #   # # #     # #   # # #   # #       #
####### ######### # # # # ######### ### # ####### # # # # # # ##### ### # # # ### # ##### #
#   #     #     # #   # #   #     #     #       # # # # # #   #   #   # #   #   # # #   # #
# # # # ### ### # ### # ### # ### ##### ####### # # # # # ##### # ### # ####### # # ### # #
# # # #     # # #   # #   # # # # #   #     #   #     # #       # #   #           # #   # #
# ### ####### # ### # ### # # # # # # ##### # ######### ######### # ##### ######### # ### #
# #   #       #     #   #     # #   # #     #         #   #     # #     # #         #   # #
# # ### ##### ####### ######### ##### ######### ##### ### # ##### ##### # # ########### # #
# #   # #   #     #   #   #         #         #     #   #   #     #     # # #           # #
# ### # # # ##### # ### # ### ############### ####### # ### # ##### ####### ##### # ##### #
#   # # # #       #   # #   # #             # #     # #   # # #   #       #     # # #   # #
# # # # ##### ######### ### # # ####### # ### # ### # ### # # # # ####### ##### ### # # # #
# # # #     #           #   #   # #     # #   # # # # # # # #   # #     #     #   #   #   #
# ### ##### ############# ##### # # ####### ### # # # # # # ##### # ######### ### # #######
# #   #     #   #       #     #   #         #   #   #   # # #   # #               # #     #
# # ### ##### ### # ######### # ##### ######### # ####### # ### # # ############### ### # #
# # #     #   #   #         # # #   #   #       #       # #     # #   #   #     #       # #
# # ##### # ### ####### ##### ### # ### ### # ### ##### # ##### # ### # # # ### ######### #
# #   #   #   #     #   #   # #   # #     # #   # #   #   #   # # # #   # #   #   #     # #
# ### # ### # ### ### ### # # # ### ##### ##### # # # ##### # ### # ##### ### ### # ##### #
#   #   #   #     #   #   #   #   #     #     # # # # #     # #   #         #   # #     # #
# # ##### ######### # # ######### ##### ##### # ### # # ##### # # ############# # ##### # #
# #     #     #     # #     #     #   #   # # # #   #   #   # # # #     #       #     #   #
# ##### ##### # ########### # ####### ### # # # # ####### # # # # # ### # ######### # # ###
#     #   #   # #         #   #     #   # #     #   #   # #   # # # # # # #   #   # # # # #
##### ### # ### # ##### # ##### # # # # # # ##### # # ### ##### ### # # # # ### # ### # # #
#     #   # # #   #     # #     # #   # # # #   # # #     #       #   #     #   # #   # # #
# ##### ### # ##### ### ### ##### ##### # # # # ### # ##### ##### ### ####### ### # ### # #
# #   #   #   #   #   # #   #   #     # # # # #     #   #   #       # #   #   # # #   # # #
# # # # ##### # # ### ### ##### ##### # # ### ######### ### # ### ### ### # ### # # # # # #
#   # # #       #   # #   #       # # # #     #       #   # # # # #       # # #   # # #   #
##### ### ########### # ### ##### # # ######### ### # ### ### # # # ####### # # ##### ### #
#     #       #       # #       #   #         #   # # #   #   #   #   #     # #       # # #
# ##### ####### ####### ##### # ### ######### ### # ### ### ##### # ### ##### ######### # #
#       #     # #     # #   # # #   # #         # #   # #   #   # # #   # #   #     #     #
# ####### ### # # ### # # # ### # ### # ######### ### # ### # # ### # ### # # # # # # #####
#     # # #     # #   #   # #   #     #     #       # #   # # # #   #   #   #   # # # #   #
##### # # # ##### # ####### # ####### ##### # ####### ### # # # # ##### ##### ### ### ### #
#   #   # # #     # #   #   # #     #   #   # # #     #   #   #     #   #   # # #   # #   #
# # # ### # # ##### # # # ### # # ### ### # # # # ### # ############# ### # # # ### # # ###
# #   #   # #     # # #   #   # #   # #   # #   # #   # #   #       #     # # #   #   #   #
# ##### ##### ##### # ##### ### ### # # ####### # ##### # # # ##### # ##### # # # ##### # #
#   # #       #     # #     # #   # # # #       #     #   # #     # # #     #   # #   # # #
### # ######### ##### # # ### ### # # # # ########### ##### ##### # ### ######### # # ### #
#   #         #     # # # #     # #   #   #   #       # #   #     #   # # #     #   # #   #
# ########### ##### # ### # ##### ########### # ##### # # ### ####### # # # # # ##### # ###
#                 #   #   # #   #   #         #   # # # # #   #     #   # # # # # #   #   #
################# ##### ### # # ### # ##### # ### # # # # # ####### ##### # # # # # ### # #
#     #         #   #   #     #     # #   # # #   #     # # #       #       # #   #   # # #
# ##### # # ####### # # ##### ####### # # # ### ####### # # ### ##### ####### ####### ### #
# #   # # # #       # #     # #     #   # #   # #   #   # #   #       #     #       #   # #
# # # # # ### ########### # # # # # ##### ### # # # ##### # # ### ######### ##### ##### # #
#   #   # #   #         # # # # # # #   #   # #   #       # #   # #     #       #     #   #
# ####### # ### ####### # # # ### # # ### ### ################# # ### # # ### ####### ### #
# #   #   #   #   #     # # #     # #   # #     #               #     # # #   #   #   #   #
# # ### ##### ### ##### ### ####### # # # # ### # ##################### # ##### # # # # ###
# #   #     #   #     #   # # #     # #   #   #   # #                 # # #     #   # # # #
# # # ### ##### ### # ### # # # ##### ####### ##### # ##### # ######### # # ######### # # #
# # # #   #   #   # # # # # #       # # #     #   #   #   # # #   #     # #         # #   #
# # # # ### # ### ### # # # ####### # # # ##### # # ##### # ### # # ##### ######### # ### #
# # # #     #   #     #   #     #   # # #   #   # # #     # #   # #             # # # #   #
# # # ######### ####### ####### # ### # ### # ##### ### # # # ### ############# # # ### ###
# # #         #     #   #       # #     #   #   #   #   # # # # #             #   #   #   #
# ##### ##### ### ### ##### ##### ##### # ### # # ### ### # # # ######### # ##### ### ### #
#     # #   #   #   # #   #   # #     # # #   #   #   # # # # #     #     # #   # # #   # #
##### # # # ### ### # # # ### # ##### ### # ######### # # # # ##### # ####### # # # # ### #
#       # #       #     #     #           #           #   #         #         #     #     #
###########################################################################################
