#######################################################################
#     #   #           #       #         #   #   #     #               #
##### # # ### ####### ##### # # ##### # # ### # # ### # # ########### #
#   # # #   #     #   #     # # #   # #   #   #     # # #       #   # #
# # # # ### ##### # ### ##### # # # # # ### ######### # ####### ### # #
# # # #   #     # #   # #   # #   # # # #   # #     # # #     #   #   #
# ### # # ##### # ### # ### # ##### # ### ### # ### # # ##### ### # ###
# #   # # #       #   #   #   #     # #   #   #   #   #       #   # # #
# # ### # # ######### ### # ######### # ### ##### ########### # ### # #
#   #   # # #       #   # #         #   #       #   #     #   # #     #
# ### ### ### ##### ### # ######### # ### ### # ### # # ### ### ##### #
# #     #         #   #   #   #     # #     # # # #   #       #     # #
# # ################# ####### # ##### ####### # # ########### ##### # #
# # #         #     #   #     # #   #         #   #       # #   # # # #
# ### ####### # ### ### # ### # # # # ############# ##### # ### # # # #
# #   #     # #   #     # #   #   # # #         #   #     #   #   # # #
# # ### ### # ### ####### ######### ### ####### # ### ##### # ### # ###
# #   # #   #   #   #     #       # #   #     #   #   #   # # #   #   #
# ### # # ##### ### ### # # ### # # # ### # # ##### ### # # # # ##### #
#     # #     #     #   # # # # # #   #   # # # #   #   #   # #   #   #
####### ##### ####### # ### # # ####### ### # # # ### # ##### ### # # #
#     #   #     #     # #   # #       # #   #   # # # #     # #   # # #
# ### ### # ### # ### # # ### ### ##### # ####### # # ##### ### ### # #
# #     # #   # #   # # #   #   #     # #       # #       #     # # # #
# ####### ### ### ### # ### ### ##### # ####### # ####### ####### # ###
# #   #   # #     #   # # #     #   # #       #   #     # # #     #   #
# # # # ### ####### ### # ##### # # # ####### ##### ### # # # # # ### #
#   #   #         # #     #   #   # #       #       #   # # # # #   # #
# ####### ### ### # ##### # # ##### ##### # ######### ### # # # ##### #
#   # #   #   # # #   #   # #       # #   # #       # # # #   #     # #
### # # ### ### # ### ##### ######### # ### ##### ### # # ##### ### # #
# # # # #   # #     #     # #         #   # #   #   # # #     # #   # #
# # # # # ### # ######### # # ########### # # # # # # # ##### ### # # #
# # #   # #   # #       #     #         # #   # # # # #     #   # # # #
# # ##### # ### # ##### ####### ####### # ##### ### # ### ##### # # # #
# #       # #   #     #         #     # # #   #   # #   #     # # # # #
# ######### # ####### ############### # # ### ### # ### ### # # # # # #
#         #   #       #     #         #   #     # #   # #   # # # # # #
# ##### ### ### ### ### ### ### ##### ##### ### # # ### # ##### # ### #
#   #   #   #   # # #   # #   # #   #     #   # #   #   # #     # #   #
### # ### ### ### # # ### ### # # ####### ### ##### # ### # ##### # ###
#   # #   #   # #   #     #   # # #           #   # #   # # #     #   #
# ##### ### ### # ### ##### ### # # ########### # # ### # # # ### ### #
# #   #   #   #     # #     #   #         #     #   #   # # # #   #   #
# # # # ##### # ##### # ##### # ######### # ######### ### # ### ### # #
#   #   #     # #     #     # #     #   # # #       # #   #   #   # # #
# ####### # ##### ######### # ##### # ### # ### ### # ### ### ### # # #
# #   #   # #     #     #   #     # #     # #   # # #   #   #     # # #
# # ### ##### ##### ##### ### ##### ####### # ### # ### ### ##### # ###
#   #   #     #     #   # #   #     #       #   # # # # #     #   #   #
##### # # ##### ### # # # # ### ### # ######### # # # # # ### # ##### #
#     # #   #   #   # #   #   # # # #       #   #   # # #   # # #   # #
# # ####### ### ##### ######### # # ####### # ### ### # ### ### # ### #
# # #       #   #   #       #   #   #       # #   #   #   #       #   #
# ### ####### # # # ### ### # ### ### ####### # ##### ### # ####### # #
#   #   #     # # #   #   # # #     #   #     #       # # # #   #   # #
# # ### ##### # # ### ##### # ##### ### # ########### # # ### # # ### #
# #           # # # # #     # #   #   #   #     #   #   #   # #   #   #
# ############### # # # ##### # # ### ##### ##### # ### ### # #########
#   #             # #   #       # #   #     #     #   #   # #         #
### # ############# ##### ####### # ### # ### ####### ### # # ####### #
#   # #       #         #   #   # #   # #   #       #     # #   #   # #
##### # ##### ####### # ### # # # ##### ### # ####### ##### ### ### # #
#     # #   #     #   #   # # # #   #   # # # #     # #   #   #     # #
# # ### # # ##### # ####### # # ### # ### # # # ### # # # ### ##### # #
# # #   # #   #   #           #   #       #   # #   # # #     #     # #
# # # ##### ### ##################### ######### # ### # ############# #
# # #   #   #   #       #     #     # #   #     #   # # #   #     #   #
# ##### # # # ### ##### # ### # ### ### # # ####### ### # # ### # # # #
#         # #         #     #     #     #         #       #     #   # #
#######################################################################
