###################################################################################################################################
#   #             #       #     #   #     #       #     #     #                       #     #     #                   #     #     #
### # ### ####### # ##### # ### # # # ### # ### ### # ### # # # ################# ##### ### # ### # ####### ######### ### # # # # #
# # # # # #     # #   # #   #   # #   # #     #     # #   # # #   #   #   #     #       #   #   #     #     #     # #     # # # # #
# # # # # # ### # ### # ##### ### ##### ########### # # ### # ### # # # # # ### ######### # ### ####### ##### # # # ####### ### # #
#   # # # # # # # #     #   #   #     #     #     # # # # # #   #   #   #   # # #     # # #   #   #   #   #   # #   #     # #   # #
# ### # # # # # # # ##### # # # ##### # ### # ### ### # # # ### ############# # ### # # # ##### ### # ### # ### ##### ### # # ### #
#   #   #     # # # #   # # # #     #   #   #   #   #     # # #         #   #   #   #   #       #   #   # #   #       # #   # # # #
### ########### # ### # # # # # ######### ##### ### ####### # ######### # # # ### ############### ##### # ######### ### ##### # # #
# #             #     #   # # # #     #   #     # #     #   #     #   # # #       #       #       #   # #         # #         #   #
# ######################### ### # ### # ### ##### ##### # ### ##### # # # ######### ##### # ####### ### ######### # ######### # ###
#       #                 #   #     # #   # #   #       # #     #   #   #   #       #   # #   # #   #             #           #   #
# ##### # ##### ######### ### ##### # # ### # ### ####### ### # # ######### # ######### # # # # # # # ########################### #
# #     # #     #     #     #     # #   #   #   #   #       # # #   #   #   #   #     # # # # # # #   #   #   #                 # #
# # ##### # ######### # ######### # ##### ### # ### ####### ### ### # ### ##### # ### # # ### # # ##### # # ### # ############### #
# #     # # #       #     #       #   #   #   #   # #   #   #     # #   #   # #   # # #       #   #     # #     #                 #
# ##### ### # ##### ##### # ####### ### ####### ### # # # ### ##### ### ### # ##### # ############# ##### # #######################
# #         # #   #     # #     #   #   #     #   #   #   #       #   #     #       # #   #       # #     #       #     #     #   #
# ########### # # ##### # ##### # ### ##### # ### ######### ##### ### ##### ##### # # # # # ##### # # ########### ### # # ### # # #
#         #   # #   # # #   #   #   # #     #   #       #   #   #   #     # #   # # # # #       # # #           #     # # #   # # #
# ####### # ##### # # # ##### ### ### # ####### ##### ### ##### ### ##### # # # # # # # ######### # ########### ####### # # ##### #
#   #   # #       #   #     #   # #   #       #       #   #       #       #   #   # #       #   # # #       #   #     #   #     # #
### # ### ####### ##### ### ### ### ##### ### ####### # ##### ### ########### ####### ####### # # # # ##### # ### ### ######### # #
# # #   #     #   #   #   #   #   #     #   #   #   # #       # # #           #     # #       #   # # #     #   #   #     # #   # #
# # ### ##### # ### # ##### # ### ##### ### ### # # # ######### # # ######### # ### # # ########### # ### ##### # ##### # # # ### #
# #   # #     #   # #   #   #   #       #     #   # #     #   #   # #       # # # # # #             #   #   #   # #     # # # #   #
# ### # # # ### ### ### # ##### ################### ##### ### # ##### ##### ### # # ##### ##### ####### ### # ### # ##### # # # # #
#   # # # # #   #   #     #   #                     # #   #   #       #   #     # #     # #   #   #     # #   #   # #       # # # #
# ### # # # # ### ########### ####################### # ### ############# ####### ##### ### # ##### ##### ##### ### ######### ### #
# #   # # # # # # #   #       #         #             # #               #     #       #     #       #       #   # #           #   #
# # ### # # # # # # # # # ### # # ####### # ##### ##### ####### ####### ### # # ##### ############### ### ### ### ############# ###
#   #   # # #   #   # # # #     # #   #   #   #   #   #       # #     #   # # #     #         #         # #   #       #   #   #   #
# ##### # ### ##### # ### ##### ### # # ##### ##### # ####### # # ### ### # # ##### # ####### ### ####### # ### ##### # # # # ### #
# #   # #     #   # #   # #   # #   #   #     #   # #       #   #   #     # # #     #     #     #   #     #   # #   #   # # # #   #
# # # # ####### # ##### # # # # # ####### # ### # # ##### ######### ######### # ######### ##### ##### # ##### # # # ##### # # # # #
# # # #     # # #       # # # # # #     # # #   #   #   #   #       # #     # #     #   #   #   #     # #     #   #     #   #   # #
# # # # ### # # ######### # # # # # ### # # # ####### ##### # ####### # # # # ##### ### ### ### # ####### ####### ##### ######### #
# # #   #     #   #       # # # #   #   # # #       #     #   #     #   # # #             #   #   #       #     # #     #       # #
# # ### ##### ### # # ##### # # ##### ### ######### ##### ##### ### ##### # ############# ### ### # ######### # ### ####### ##### #
#   #   #   # #   # # #     # #   #   # # #       # #   #   #     #       #   #   #     # # # #   # #       # #   #       #     # #
# ####### # # # ### ### ##### ### # ### # # ##### # # # # # # ### ########### # # # ### # # # ##### ### ### # ### ####### ##### # #
# #   #   # # # #     # #   #   # #     #   #     # # # # # #   # #   #   #   # # # #   #   #     # #   # # # # #   #   #     #   #
# # # # ### # # ### # # ### ### ####### ##### ##### # # # # ### # ### # # # ### # # ### ### ##### # # ### # # # ### # # # ### # ###
# # #   #   # #   # # # #     #         #     #   # # #   # #   #   #   #   #   # #   #   #   #   # # #   #   #   #   # #   # # # #
# # ##### ####### ### # # ### ########### # ### # # # ##### # ##### # ######### # # # ### ##### ### # # ####### # ##### ### # # # #
# #     #         #   #   # #   #     #   # #   # #   # #   # # #   #           # # # # #     #   #   #     #   # #   # #   # # # #
# ##### ########### ####### ### ##### # ### # ### ##### # ### # # ############### ### # ##### ### ####### # # ### ### # ##### # # #
#     # #           #         #   #   #   # # # #         # # # #     # #     #   #   #     # #   #       #   # # #   #     # #   #
##### # # ### ##### # ### ### ### # # ### # # # ########### # # ##### # # # ### ### ### ### # # # # # ######### # # # ##### # ### #
#   # # #   #     # #   #   # # #   # #   # #   #         #   # #     #   #   # #   #     # #   # # # #     # #     #     #   #   #
# # # # ### ##### # ### ### # # ##### # ### ### ### ####### ### # ####### ### # # # # ### # ##### # # # ### # # ##### ######### ###
# # # #   #     # # #   #   # # #     # #   # # #   #     #     #   #   # #   # # # #   # #     # # #   #   #   #   # #     #   # #
# # # ### ##### # ### ### ### # # ##### # ### # # ### ### ##### ### # # # # ### # # ### # ##### # ####### ####### # # # # ### ### #
# #   # # #     #     # #   #   # #   # #   # # # #   #   # #   # #   # # #     # # #   # #     #       #         # # # #   #     #
# ##### # ####### ##### ### # ### # # # ### # # # # ### # # # ### ##### # ######### # ### # ########### # ######### # # ### ##### #
#       #   #   #   #     # # #     # # #     # #   #   #   #       #   # #         #   # #   #       # #   #       # #   #   #   #
####### ### # # ### ##### # # # ####### # ##### # ### ####### ####### ### ### ### ##### # ### # ##### # ##### ##### ##### ### # ###
# #     # # # # # #     # # # #   #     # #     #   #         #   #   #     #   # # #   #   # # # #   # #     #   # #     # # # # #
# # ##### # # # # ##### # # ### ### # ##### ####### ########### # # ####### ### # # # ##### # # # # ### # ####### # # ##### # # # #
#   #   # #   # #     #   #   # #   # #     # #   #   # #       # #   #   #   # # #   #     #   #     # #   #     # #       # #   #
# ### # # ##### # ### ### ### # # ### # ##### # # ### # # ####### # # # # ### ### ##### ############### ### # # # # ####### # ### #
#     #   #   # # #   #   #   # #   # # #     # #     # #   #   # # #   #   #     #     #         #         # # # # #     # #   # #
### ####### # # # # ### ### ### ### ### # # ### ####### ### # ### ######### ####### ### # ####### # ########### ### # ##### # ### #
# # #       #   # #     #   #   #   #   # # #   #         # #     #       # #     #   # #   #   #   #         #     # #     # #   #
# # # ########### ####### # # ### ### ### ### ####### ##### ##### # ##### # # # ### # ##### ### ##### ####### ### ### # ##### # ###
#   #       #   #       # # #   #   # #     # #     # #   #     #   #   # # # # #   #     #   #     # #     #   #     #   #   # # #
# ######### ### ### ##### ##### ### # # ### # ### # # # # ##### ##### # # # # ### ##### # ### # ### # ##### ### ##### ### # ### # #
#     #   #   # #   #     #   #   # # # #   # #   #   # #     #     # # #   #     #   # # #   #   # #       #   # #   # # #     # #
##### # # ### # # ### # ### # ### # # # # ### # ##### # ##### ##### # # ##### ##### # # ### ##### ##### ##### ### # ### # ####### #
#   # # #   # # # # # # #   #     # # # #   #   #   # #   #         # # #   # #     # #   # #   #     # #     #   # #   #         #
# # # ### # # # # # # # # ######### # # ### ##### # # ### ########### # # ### # ######### # # # # # ### # ##### # # # ########### #
# # #     # # #     # # #     #   # # #   # #     # # # #         #   # # #   #     #     #   # # # #   # #   # # # #       # #   #
# ### ####### ##### # ####### # # # # ### # # ### ### # ######### # ### # # ### ### # ### ##### ### # ### # ### # # ### ### # # ###
#   # #   #   #   # #     #   # # #   #   #     #     #       #   # #     #   #   # # #   #       # # # # # #   #       #   # #   #
# # # # # # ### # ### ### # ### # ####### ##### ######### ##### ### # ####### ### # # ##### ##### # # # # # # ########### ### ### #
# #   # # #     #   #   #   #   # #     # #   #     #   #     #   # # #         # # # #     #   #   #   # # #   #   #   #   #   # #
# ##### # ######### ### ####### # ### # ### # ##### # # ##### ### # # # ####### ### # # ##### # # ##### # # ### # # ### ### # ### #
#   # # # #       # #   #       #   # #     # #   #   #   #   #   # # #   #   #     #     #   # # #   # # #     # #   #     # #   #
### # # # # ##### # # ##### ####### # ####### # # ####### # ### ### ### ### # ########### # ### ### # # # ####### ### # ##### # ###
#   # # #   #     # # #     #   #   # #   #   # #     #   #   # #       #   # #       #   # # #   # # # # #   #   # # #       # # #
# ### # ####### ### # ### ### # # ### ### # ### ### ### ##### # # ####### ### # ##### # ### # ### # # # # # # # ### # # ##### # # #
#     #       #     #   # #   # #     #   # #   #   #   #     # # #     #   #   # #   #   #   # # # #   #   # #   # # # #   # #   #
##### ####### ######### # # ### ####### ### # ####### ### ### # # ##### ### ##### # ######### # # # ######### ### # # ### # ##### #
# #   #     # #       # # #   #   #     #   # #     # #     # # #       # #     # #     #     # #   # #     #   #   #     # #   # #
# # ##### ### # ##### # # # ### # ### # # ### # ### # # ### # # ####### # ##### # ##### # ##### ##### # # ### ##### ####### # # # #
# #     # #   #   # #   # # #   #     # # #   # # # # # # # # #     #   #     #       # #   #   #     # #   #       #     #   #   #
# ##### # # ##### # ##### ### ########### # # # # # # # # # # ##### ### # ### ####### # ### # # ### ### ### ############# #########
#     #   # #     #         #       #     # #     #   #   # # #   #   #   #   #   #   #   #   # #   #   # # #   #         #       #
### # ### # ##### ####### # # ##### # ############# ####### # # # ### ##### ### # # ##### ##### # ### ### # # # # ### ##### # #####
#   #   # #     #       # # #     #     #         #       # # # #     #         # #   # #       # #   #   #   # #   #   #   #     #
# ### ### ##### ####### ### ########### ### ##### ####### # ### # ################### # ######### # ### # ##### ### ### # ####### #
#   # #   #   #     # #   #   #     #   #   #     #         #   # #                   #   #       #   # #     #   # # #   #     # #
# # ### ### # ##### # ### ### # ### # ### ####### ######### # ### # ################### ### ##### ### # ##### ### # # ####### # # #
# # #   #   # #     #   # #   # #   #     #     #   #     # #   # #   #         #         # #       # # #   #   #   #       # # # #
# # # ### ##### ##### # # # ### # # ####### ### ### # ### ##### ##### ####### ### ####### # # ####### # # # ### ##### # ### # ### #
# #   #   #   # #     # # # #   # # #         # # # # # #       #   #   #   #       #     # #       # # # #   #     # # #     #   #
# ####### # # # # ### # # # # ### ### ######### # # # # ### ##### # ### # # ######### ### # ####### # # # # ####### # # ##### # # #
#     #   # #   # #   # # # #   #     #   #     #   # # #   #   # #   #   #     #     #   #   # #   #   # # #     # # #   # # # # #
##### # # # ####### ##### # ### ######### # ####### # # # ### # # # ########### # ##### ##### # # ####### # # # ### ##### # # # ###
#   #   # #       #       #   # #       # #       #   #   #   #   #     #   #   #   #       # # #         #   #           # # #   #
# # ### ######### # ######### # # # ### # ####### ######### ######### ### # # ##### ######### # ############# ############# # ### #
# #   # #     #   #   #       # # #   #       # #   #       #       #     #   #     #   #     #   #         #     #   #       #   #
# ### ### ### # ##### # ### # # ### # ####### # ### # ####### ################# ##### # # ####### # ####### # ##### # ######### # #
#   #   # # # #     # #   # # #   # # #     # #   # #       #     #     #     #       # # #       #     # # # #   # #         # # #
### ### # # # ### # # ##### # ### ### # # ### # # # ####### # ### # ### # # # # ####### # # ##### ##### # # ### # # ######### # # #
#   # #   # #   # # #       #   #     # #       # #   #   # # #   # # #   # # # #     #     #       # # # # #   #   #       #   # #
# ### ##### ### ### ######### ######### ####### ### # # ### # # ### # ##### ### # ### ############# # # # # # ####### ### ####### #
#   #     #   #   #   #   #   #   #     #     # #   # #   # # #     #     #     # # #       #     #   # # #   #     # # #       # #
### # ##### # ### ### # # # ### # # ##### ### ### ### ### # ##### ### ### ####### # ####### # ### ##### # ####### # # # ##### ### #
#   # #     #         # # #   # #   #   # # #     # #     #     #     # #   #     #       # # # # #     #         # #   # #   #   #
# ### # ############### # # ### ####### # # ####### ##### ##### ####### ### # ##### ##### # # # # # ######### ##### ### # # ### ###
#   #   #     #       # #   #   #       # # #       #         #       # #   #   #   # #   #   #   #       #   #   # #   # #   #   #
# # ##### ### # ##### ##### # ### ####### # # ##### # ############### # # ##### ### # # ####### ### ##### # ### # # # ### ### ### #
# #       # #   #   # #   # #     #       #   #   #   # #           # #       # #   #   #     # # # #     # #   # # # #     #     #
# ######### ####### # # # # ### ### ####### ##### ##### # ####### # # ######### # ####### ### # # # # ##### # # ### # # ### #######
#   #     #   #     #   # #   # #   #     # #   #       # #     # # #     #     #   #     #   # # # #     # # #     # #   #       #
### # ### # # # # ####### ##### # ### ##### # # ### ### # # ### ### ##### # ##### # # ##### ### # # ##### # # ####### ### ####### #
#   #   #   # # # #       #     # #         # #     #   # # # #     #     # #     # #   # #     #       # # # #     #   #     #   #
# ### # ####### # # ### ### ##### # ####### # ##### ##### # # ##### # ##### ####### ### # ####### ####### # # # ### ### ####### # #
# #   # #   #   # # #   #   #   # # #     #   #     #     # #       #     #       #   # #           #   # # # # #     #     #   # #
# ##### # # # ### # ##### ### # # ### ### ########### ##### ##### ####### # ##### # ### # ########### # # # ### # ### ##### # ### #
#     #   #   #   #     # #   # # #   # #           #   # # #   # #     # # #   # #   # # #   #     # #   #   # # # #   # #   # # #
##### ### ##### # ##### # ##### # # ### ########### ### # # # # ### # # # # # ### # # # ### # # ### # ####### # # # ### # ##### # #
#   #   # #     # #   # # #     # #   #         #   # # # # # #   # # # # #   #   # #       #   # # #       #   # #           #   #
# ##### ### ##### # # # # # ### # ### # ##### # # # # # # # # ### # # # # ### # ################# # ####### ##### # ######### # ###
#     #     #   # # # #   # #   #     # #     # # #   # # #   # #   # # # #   #       #   #       #       # #   # #   #     # #   #
# ### ####### # # # ####### # ########### ####### # ### # ##### ##### # # ########### # ### ### ######### # # # # ##### ### ##### #
#   #   #   # #   #     #   # #   #     #   #     # #   #       # #   # #     #       #     #   #     #   #   # #   #   # #   #   #
### # ### # # ####### # # ### # # ### # ### # ####### ##### ### # # ######### # ####### ##### ### # ### ####### # # # ### ### # ###
#   #     #           #   #     #     #     #               #     #             #           #     #             # #         #     #
###################################################################################################################################
