#####################################################################################################
# #     #             #       #         #         #       #     #     #             #         #     #
# # ### # ### ####### # ##### # ### ### ### ### ### ### # # # # ### # ########### # ### ##### # #####
# #   # # # #     # # #     #   #   # #   #   # #   # # # # # #     #       #   # #   # #   #   #   #
# ### # # # ##### # # ##### ##### ### ### ### # # ### # # ### ### ######### # # # ### # # # ### # # #
#     # #   #   # #   #   # #     #     #   # # #     # #     #   #   #   #   # # #   # # # #   # # #
####### ### ### # # ### # ### ####### # ### ### ##### # ##### ##### # ### ##### # ### # # ### ### # #
#       #       # #     # #   #       #   #   #     # #   # # #     #   #       #   # # #     #   # #
# ####### ####### ####### # ### ### ######### # ##### ### # # # ####### ##### ##### # # ####### ### #
# #   #   #   #   #   #     #   #   #         #         # #   #       # #   #       #   #         # #
# ### # ### # # ### # ########### # # ######### ####### # ##### ####### # # ############# ######### #
#   #     # #   #   #   #       # # # #           #   # # #     #     #   #     #         #   #   # #
### # ##### ##### ##### # ##### # ### ############# # ### # ##### ### # ####### # ######### # # # # #
#   # #   #     # #   # #     # #   #     #   #     #   #   #     #   #       #   #       # #   # # #
# ### # # # ### # # # # ##### # ### ##### # # # # ##### ##### ##### ############# ##### # # ##### # #
# # # # # #   # #   # #   #   # #     # # # # # # #   #       #   #             #     # # # #     # #
# # # # # ##### ##### ### # ### # ### # # # # # ### # ######### # ############# ##### # ### # ##### #
# #   # #     # #       #   #   # # # # #   # #     # #   #     #   #         # # #   # #   #   #   #
# ##### ##### # # ########### ### # # # ##### ### ### # # # ####### # ##### ### # # ### # ##### ### #
# #     # #   #     #   #     #   #   #     #   # #   # #   #   #   #   # #     # #     # #   #   # #
# # ##### # ##### ### # # ##### ### ####### ### ### ### ##### # # ##### # ####### ### ### # # ### # #
# # #     #     # #   #   #     # #       #   #   #   # #     # # #   #     #       # #   # #   #   #
# # # ######### ### ######### ### ####### # ##### # # # # ##### # ### ##### # ####### # ##### ##### #
# # # #       # #   #         #         # # #     # # # #   #   # #       # #         #     #     # #
# # # # # ##### # ### ##### ### ######### # # ####### # ### # ### # ####### # ############# ##### # #
#   #   #     #   #       #   #             # #     # #     #   # #   #     #             #   #   # #
##### ####### ############### # ############# # ### # ######### # ### # ####### ############# # ### #
#   #   #   #               # # #       # #   # #       #       # #   #   #   # #             #   # #
# # ### # ### ############# # # ### ### # # ### ######### ####### # # ### # # ### ############### # #
# #   # #   # #   #           #     # #   # #             #       # #   #   #   # #               # #
# ##### ### # # # ################### # ### # ############# ####### ########### # # ##### ### ### # #
#     # #   #   #   #     #         #   #   # #           # #     #           #   # #   # #   #   # #
# ### # # # ####### # ### # ####### # ### ### # # ####### # # ### # ### ########### # # ### # ##### #
# #   #   #   #   #   # #   # #     #   # #     # #   #   #   #   #   # #     #     # #   # # #   # #
### ######### # # ##### ##### # ### ##### ### ##### # ##### ### ##### # # ### # ##### ### # ### # # #
#   #         # #         #   #   # #   #   # #     #     #   # # #   #     #     #   #     #   #   #
# ### ######### ####### ### # ### ### # ### ### ######### ### # # # ############### ##### ### #######
#   # #       #   # #   #   #   #     #   #   #   #   #   #   # #   #       #       #   # #   #     #
# # # # ##### ### # # ### ### # ####### # ### # # # ### ### ### ##### ##### # ##### # # # # ### ### #
# #   #     #   #   #     #   # #     # #   # # # #     #     # #   # #   # #     # # # # # #     # #
# ######### # ### ######### ### # ### # ### # ### # ##### ##### # # # # # # ### # ### # ### # ##### #
#     #   # #   # #         # #   #   # #   #     #     # #     # # # # # #   # #   # #     # #     #
##### # ### ### # # ######### # ####### # ############# # # ##### # # # # ### ##### # ######### ### #
# #   #     # #   #         #   #   #   # #   #       # # #       # # # #   #     # #   # #     # # #
# # ##### ### ############# ##### # # ##### # # ##### # # ######### # ##### ##### # ### # # # ### # #
# #     # #               #       # # #     #   #   #   #     #   #   #   #   #   #     #   #   #   #
# ##### # ######### ### ########### # # ######### ########### # ####### # # # # # ##### ### ### ### #
#     # #         # #   #         # #   #       #     #     # #         #   # # # #   #   #   #   # #
# # # # ######### # # ### ##### ### ####### ### ### # # ### # # ### ####### ### # # # ### ### ### # #
# # # #       # # # #   # #   #   #         # #   # #   # # # #   #     #   #   # # # #     #   # # #
### # ####### # # ### # # # # ### # ######### ### # ##### # # ### ##### # ### ##### # ##### ##### # #
#   # #   #   # #   # #   # #   # #     #       # # #     # # #       # # #   #     #   #   #     # #
# ### # ### ### ### ##### # # # # ##### # ### ### # ### ### # ######### ### # # ####### # ### ##### #
#   # # #   #     #     # # # # #     # # # #     # #   #   #       #   #   # #   # #   #     #     #
# # # # # ##### ####### # # # # ### # # # # ####### # ### ######### # # # ### ### # # ######### #####
# # #   #     # #       # # # #   # # # #   #       #     # #     # # # # #   #   # # #   #   # #   #
### ### ##### # # ####### ### ### # # # ### # ####### ##### # ### # # ### # ### ### # # # # # # # # #
#   # # #     # # #     #     #   # # # #     #     # #     # # #   # #   # # #     # # #   # # # # #
# ### # # ##### # # ### # ######### ### ####### ##### ##### # # ##### # ### # ##### # # ##### ### # #
#   #   #   #   #   # # # #       # #   #   # #       #     # #     # #   #   #     #   #   #     # #
# # # ##### ### ##### # # # ##### # # ### # # # ####### ### # # ### # ### ##### ######### ######### #
# # #     # #   #       # #   #     #     # #     #   #   # #   # # #   #   #   #     #   #     #   #
# # ####### # ### ####### ### # ########### ##### # # ### ####### # # ##### # ### ### ### # ### # ###
# #         # #   # #   #   # #   #       # #   #   #   #           #     # # #   # #   #     # #   #
# ########### # ### # # ### # # ### ### ### # # ####### ### ############# # # # ### ### ####### ### #
# #       # #   #     # #   # # #   # #   # # #     #     #   #         # # #   # #   #         #   #
# # ##### # # ### ##### # ### # # ### ### # # ##### ##### ### ### ##### # # ##### # # ##### ##### # #
# #   # # # #   #     # #   # # # #     # #   #   # #   # #       #   #   #       # #       #     # #
# ### # # # ### ####### # ### # # ##### # ##### # # # # # ######### # ### ##### # # ######### ##### #
#     #   # #   #   #   # #   # #       #       # # # # #   #       #   # #     # # #   #   # # #   #
####### ### # ### # # # # # ########### # ####### # # # ### # ######### # # # ##### # # # # # # # ###
#     # #   # #   #   # # #           # # #       #   # # # # #         # # # #   #   # # # # #   # #
# # # # # ### # # ##### # ####### ##### # ########### # # # # # ######### # ### # # ##### # # # ### #
# # # # #   # # #     # #       #       #   #       # # # #   # # #       #     #   #   # #   # #   #
# # ### # # # ##### # ### ##### ########### # ##### ### # ##### # # ################# # # ##### # # #
# # #   # #   #   # #     #   # #     #     # #   #   # # #   # #           #   #   # # #     #   # #
# # # ### ##### # ######### # ### ### # ### # # ##### # # # # # ########### # # ### # # # ### ##### #
# # # #         #     #     #   #   # # #   # #       # #   #   #       # # # #     # # # # # # #   #
# # # # ############# # # ##### ### # # ##### ### ##### # ####### ##### # # # # ##### # # # # # # ###
# #   # #     #     #   # #   # #   # #     #   #       # #     # # #   #     # #     # #   # #   # #
# ####### ### # ### ### ### # # # ### ##### ### ######### ### # # # # ######### # ##### ##### # ### #
# #     # # #   #   # # #   # # # #       #   #   #     #   # # # # # #       # #     #       # #   #
# # ### # # ##### ### # # ### # # ####### # # ### ### # ### # # # # # ### ### ##### # ######### # # #
#   #   # # #   # #   # #   # #   #   #     #   #   # #   #   #   # #   #   #     # #   #       # # #
##### ### # # # # # ### ### # ##### # ########### # # ### ######### ### ### ##### # ### ##### ##### #
#   #   # #   #   #     #   # #     #           # # #   #   #         # #   # #   #   #     # #     #
# ##### # ### ##### ##### ### # ############### ### ### ### # ##### # # # ### # ##### ##### # ### # #
#       #   # #     #   # # #   #             # #   #   # #   # #   # #   #   # #         # #     # #
# ####### # # ##### # ### # ##### ### ######### # ### ### ##### # ######### ### # ####### # ####### #
#       # # #     #   #   #     # # #     #     # # #       #   #       #       # #   #   #   #   # #
####### ### ##### ##### ### ### # # ##### # ##### # ####### ### ##### ### ######### # ### ### # ### #
#   #   #   #   #     #   #   # #     # #   #     # #     # #     #   #   #         #   # #   #   # #
# # # ### # # # ##### # # ### ####### # ##### # ### # # ### # ### # ### ##### ######### ### ### # # #
# # #   # # # # #     # #   # #       #       #   #   #   #   # # #     #     #       #   # # # #   #
### ### # ### # ### ####### # # ######### ####### # ##### ##### # ####### ##### # ####### # # # #####
#   #   #     #   # #     # # #     #   #       # #   #         #     #     #   # #       # #   #   #
# ### ### ####### # ### # # # ##### # # ######### ##### ### ######### ##### ### # # ####### # ### # #
#     #         # #     # # #       # # #       # #     #   #   #   #     # #   # #   #     #     # #
# ############### ####### # # ####### # # ##### # # ######### # # # ##### # # ####### ### ######### #
#                 #         #         #   #       #           #   #         #             #         #
#####################################################################################################
