###################################################
# #       #             #     #         #         #
# # ##### ##### # ##### # # # ### ##### ######### #
#   #   #     # # #   # # # #     #   #   #   #   #
####### ##### ### ### # ### ####### # ### # # # ###
#       #   #     #   #   #   #   # #   #   # #   #
# ##### # ######### ##### ### # # ### # ##### # # #
#   # # #     #         # #   # #   # #   #   # # #
### # # # ### # ##### ### # ### ### # # # # ### # #
#   # # #   #   #   #   #   #   #   # # # #   # # #
# ### # ##### ##### ### ##### ### ### # ##### ### #
#   #       #     #   #       #   # # #     #     #
### ####### ##### # ##### ##### ### # ##### ##### #
#   #   # #     #   #   #   # #   #     #       # #
# ### # # ##### ### # # ### # ### ##### # ####### #
#     # #   #   #   # #     #   #     # #     #   #
# ##### # ### ### ### ####### ####### ####### # ###
# #   # #   # #     #   # #         #         # # #
# # # # ### # ######### # # ##### ########### # # #
# # #   #   # #     #   # #     # #   #       # # #
### ##### ### # ### # ### ##### # # # # ####### # #
#   #   #   #   #   #   # #   # #   #   #       # #
# ### # # # ##### ##### # # # # ####### # ####### #
# #   #   #             # # #   #     # # #   #   #
# # ############### ##### # ##### ### ### # # ### #
# #   #     #     # #   # #     #   #     # #     #
# ##### ### # ### ### # # ### ##### ####### ##### #
#     #   #   # # #   # #   # #     #   #       # #
# ### ### ##### # # ### # ### # ##### ### ##### ###
# # #     #     #   # # #     #   #       #   #   #
# # ####### ### ##### # # ####### # ######### ### #
# #         #   #   # # # #     # # #     #   #   #
# ##### # ### ### # # # # # ### # # # ### # ### # #
# #   # # #   #   #   # # # #   # #   #     #   # #
# # # ### ### ### ### # # # # # # ######### # ### #
#   #   #   #   #   # # # # # # #         # #   # #
####### ### ### # # # # # ### # ######### ##### # #
#     #     # # # # # # #     #   #     #       # #
# ### ####### # ### # # ########### ### ######### #
# #           # #   # #         #   # #     #     #
# # ### ##### # # ########### # # ### ##### # #####
# #   # #   # # #   #   #   # # # # #   #   # #   #
# ### ### # # # ### # # # # ### # # # # # ### # # #
# # #     # # #   # # #   #     # #   # #   #   # #
# # ####### ##### # # ########### # ### ### ##### #
# #       #     #   # #   #       #   #   #       #
# ##### ##### ##### # # # # ############# #########
# #   #     #     # #   # # #     #     #       # #
# # # ##### ##### # ##### # # ### # ### ### ### # #
#   #           #       #     #     #       #     #
###################################################
