###################################################################################################################################
#     #   #           #       #   #           #   #     #       #     #                 #   #   #             #     #   #       # #
##### # # ### ####### ##### # ### # ####### ### # # # # # ##### # # # # ##### ######### # # # # ### # ####### # ### # # # ### # # #
#   # # #   #     #   #     # #   #     # #     #   # #   #   # # # # #   # #         #   #   #   # #   #   #   # # # #   # # #   #
### # # ### ##### # ### ##### # # ##### # ########### ####### # ### # ### # ######### ########### ### # # # ##### # # ##### # #####
#   # #   #     # #   # #   # # #     # #           #       # #   # # # # #         # #     #   #   # # # #       # #   #   #     #
# ### # # ##### # ### # ### # # ####### # ######### ####### # ### # # # # ######### # # ### # ##### ### # ####### # ### ### ##### #
# #   # # #       #   #   #   #         #         #       # # #   # #   #   #     # # #   # #     # #   #       # #   #       #   #
# # ### # # ######### ### # ######### ############### ### # # # ### ####### # ### # # # ### # ### # # ######### ##### # ####### ###
#   #   # # #       #   # #         #           #     # # # #   # #   #   # # #     #   #   # #   # #         # #     # #     #   #
# ### ### ### ##### ### # ######### ########### # ##### # # # ### # # # # # # ########### ### # ### ### ##### # # ##### # ### ### #
# #     #         #   #   #   #     #     #     # #       # #   #   #   # # #           #   # #   #   # # #   #   #     #   #   # #
# # ################# ##### # # ##### ### # ##### ######### ### # ####### # ### ####### ### # ### ### # # # ##### ######### ### # #
# # #         #     #   #   # # #   #   #         #       #   # #     #   #   #   #   # #   #   #   # #   #     #           # #   #
# ### ####### # ### ### # ### # # # # ############# ##### # # # ####### ##### ### # # # # ####### # # ######### ############# ### #
# #   #     # #   #     #   # #   # # #         #   #     # # #         #     #   # # # # #       # # #       # #         #       #
# # ### # ### ### ####### # # ##### ### ####### # ### ####### ########### ##### ### # # # # # ####### # ##### # # ### ##### #######
# #   # #   #   #   #     # # #   # #   #     #   #   #       #     #     #   #   # #   # # # #     #   # #   # #   # #   #   #   #
# ### # ### ### ### # ##### # ### # # ### # # ##### ### # ### # ### # ##### # ##### # ### # # # ### ##### # ### ### # # # ### # ###
#     # # #   #     #     # #   # #   #   # # # #   #   # #   # #   #   #   #     # # #   # #     #         #   #   # # #     #   #
####### # ### ########### # ### # ##### ### # # # ### ### # ### # ##### # ####### # ### ### ########### ##### # ##### # ####### # #
#         #   #           # #   #     # #   #   # # #   # #   # #   #   # #     #   #   #     #       # #     # #   # #   #   # # #
########### # # ########### # ### ### # # ####### # ### # ##### ### # ### ##### ### # # ####### ##### # ####### # # # ### # # ### #
#   #     # # #     #     # # # #   # # #       # #     #   #   # # # #   #     # # # # #       #     #       #   # #       #     #
# # # ### # ### ##### ### # # # ### # # ####### # ####### # # ### # # # ### ### # # # # # ##### # ########### # ### ############# #
# # # # # #     #     #     # #   # # #       #   #     # #   #   #   # #     #   # # # # #   # # #       #   #   # #       #   # #
# # # # # ####### # ######### # # # # ####### ##### ### # ##### # ##### # ### ##### # ### # # ### # # ##### ##### # # ##### # # # #
# #   # #     #   # #   #     # # # #     # #       #   #     # #   #   #   # #     # #   # # #   # # #     #   # # #   # #   # # #
# ##### ##### # # ### # # ##### # # ### # # ######### ####### # ### ### ##### # ##### # ### # # ### # # ##### # # # ### # ##### ###
# #   #   #     # #   # #     # #     # #   #       # #       # #       #   # # #   # # # # #   #   #   #     # # #     #     #   #
# ### # # # ####### ### ##### # ####### ##### ##### # # ####### # ##### # # # # # ### # # # ##### ####### ##### # ####### ### ### #
#   #   # # #         # #   # # #     #         #   # #       # # #   # # # #   #   #   # # #   #         #   # #         # #   # #
### ##### # # ####### # # # # ### ### ####### ### # # ####### # ### # ### # ### ### ##### # # # ############# # ########### ### # #
#   #   #   # #     # # # # #     # # #     # #   # # #     # # #   #     #   #   #       #   # #             # #     #       # # #
# ### # ##### # ### ### # ######### # # ### # # ### # ### # # # # ########### ### ####### ##### # ####### # ### # ### ### # ### # #
#     #       # # #     #           #   # # # # # # #   # # # #       #       # #         #   # #     # # # #   #   #   # #   # # #
# ############# # ######### # ##### ##### # ### # # ### # # # # ##### # ####### ######### # # # ##### # # ### ##### ### ##### # # #
#     #         #         # # #   #     # #     # #   # # # # # #   # # #     # #       # # #   # #   # #   #   #   #   #   #   # #
# ##### ######### ##### # # ### # ##### # ####### # ### # # # ### # # # # # # # # ##### # # ##### # ### ### ### # ### ### # ##### #
# #   #     #   #     # #   #   #   # # # #     # # #   # # #     # # # # # #   # # #   # # #     #   #   #   # # #   #   #   #   #
### # ##### # # ####### ##### ##### # # # # # # # # # ### # ####### ### ### # ### # # ### # # ### ### # ### ### # # ##### ### # # #
#   #   #   # #       #       #   # #   # # # #   # #   # #     # # #   #   # #   # # #   # # # #   # #   # #   # #   #   #     # #
# ##### # # # ####### ### ##### ### # ### # # ### # ### # # ### # # # ### ### # ### # # ### # # # ### # # # # ### ### # ######### #
# #   # # # #   #   #   # #     #   #   # # #   # # #   # #   #   # # #     # #     #   # # # # #     # # #   #   #   #     #   # #
# # ### # ##### ### ### # ### ### ##### # # ### # # # ### ### ##### # ### # # ##### ##### # # # ######### ##### ### ### ### # ### #
# #     #     # #     # #     #   #   # #   #   # # # #   # #   #   #   # # # #   #   #   # #     #             # # #     # #     #
# ### ##### # # # ### # ### ### ##### # ##### ### # # ### # ### # ### # ### # ### ### # # # ##### ### ########### # ##### # ##### #
#   #     # #     # # #   # #   #   #         #   # #   #     # # #   #   # #       #   # # #     #   #   #       #   #   # #   # #
### ##### ######### # ### # # ### # # ##### ##### # ### ##### # # ####### # ############# # ### ### # # # ### # ##### ##### # # ###
#   #   # #   #         # # #     # # #   # #   # # # # #   # # # #   #   # #           # #   # #   # # #   # #     #     # # #   #
# ##### # # # # ####### # ####### # ### # ### # # # # # # # # # # # # # ### # ##### ### # ### # # ### # ### ##### ####### # # ### #
# #     #   # # #   #   #       # #     # #   # # # # # # # # #   # #   # #   #   #   # #   # #   #   # # #   #   #     #   # #   #
# # ######### # # # ####### ### # ####### # ### # # # # ### # ##### ##### # ##### ### ##### # ##### ### # ### # ### ### ### # # ###
# # #     #   # # #       # #   #       #   # # # #   #   # # #     #     #         # #     #   #   # #     # #   # #   #   # #   #
# # # # ### ##### ####### # # ######### ##### # ##### ### # # # ##### # ### ##### ### # ####### ### # ##### # # # # # ### ### ### #
# # # # #   #     #       # # #   #     #     #       # # #     #     # #   #   # #   # #   # #   #   #     # # #   #   # # #   # #
# # # # # ### ##### ######### # # ### ##### # ######### # ####### ####### ### # ### # # # # # ### ##### ##### # ####### # # ### # #
# #   # # #   #     #       #   #   # #     #           #   #   #         #   #   # # #   # #   # #     #     # #     #     #   # #
# ##### # # # ### ##### ### ### ### # # ################### # ### ######### ##### # ####### # # # # ##### ### ### ### ####### ### #
#   #   # # #   #   #   # #   # #   # # #                 # #   # #   #   #   #   #       #   # # # #   #   # #   # #         # # #
# # # # # ##### ### # ### ### ### ### # # ############# # # # # # # # # # ### # ####### # ##### # # # # ### ### ### ####### ### # #
# # # # # #     # # # #     #     # # # #   #       #   # # # # # # #   #     #       # # #   # #   # #   #           #   # #   # #
# # # ### # ##### # # # # ######### # # ### ### ### # ##### ### # # ########### ##### # # # ### ####### # ############# # # # # # #
# # #   # # #     #   # #         #   #   #   # #   # #   #   # # #   #         #   #   # #   #       # #     #   #     # #   # # #
### # # # # # ### ##### ##### ### # ### ##### # ##### # # ### # # ### ########### # ##### ### ####### # ### # # # # ##### ### ### #
#   # # #   #   #         #   #   #   #         #     # #     # #   #             #     #         #   #   # # # # #   # #   # #   #
# ##### ####### ########### ### ##### # ####### # ### # ####### ### ################### ##### ##### ####### ### # ### # ### ### # #
# #       #   # #           #       # #   #   # # #   # # #   #   # #         #     # # #     #     #       #   #     #     #   # #
# # ####### # # # ################# # ##### # ### # ### # # # # # # # ####### # ### # # # ##### ####### ### # ### ##### ##### ### #
# # #   #   #   #       #   #   #   #     # # #   # #   #   #   # #   #     #   #   # # #     #         # # # #   #   #     #   # #
# # # # # ########### # # # # # ######### # # # ##### ########### ##### ### ##### ### # ##### ########### # # # ### # ##### ### # #
# #   #     #       # #   #   #         #   #   #   # #             #     #     # #   #   #   #           # # #   # # #   #     # #
# ########### ##### # ####### ##### # ##### ##### # # # ##### ##### # ### ##### # ### ### ### # ### # ##### # ##### # # # ####### #
# #     #     #   # # #     #     # # #   # #     #   # #     #   # #   # #     #       #   # #   # # #     #   #   # # #   #     #
# # ### # ##### # # ### ### ##### # ### # # # ######### ####### # # ### # ############# ### ### ### # # ####### # ### # ### # #####
#   # # #     # # # #   # # #     # #   # # #         # #     # # # #   # #           #   #     #   # # #     # # # # # # # # #   #
# ### # # ##### # # # ### # ####### # ### # ######### # # ### # # # # ### # ######### ### ####### ##### # ### # # # # # # # # ### #
#     # # #     # # # #   # #     # # # # #       # # #     #   # # #   # #         #   # #   #   #     # #   #   # # #   #       #
# ##### # # ##### # # # # # # ### # # # # ####### # # ####### ### # ### # ##### ####### # ### # ### ##### # ####### # ########### #
# #     # # #   # # #   # # #   # # # # #       #   #       #   # #   # #     # #       #   # #   # #     #         #         #   #
# # ##### # # # # # ### ### # # # # # # ##### ##### ####### ##### ##### ##### # # ##### ### # ### # ############# ########### #####
# #       # # #   #   # #   # # #   #       # #   #       #   #   #   #     #   #   #   #   #   # # #         #   #         # #   #
# ######### ##### # ### # ##### ########### # # # # ######### # ### # ##### ####### ##### ##### # # # ####### # ### # ##### # # # #
#     #   # #   # #   # # #     #           # # #   #     #   # #   #     #     # # #     #     # #   # #     #   # # #     #   # #
# ##### # # # # # ### # # # ##### ########### # ##### ### # ### # ##### ####### # # # ##### ##### ##### # ####### # # ######### # #
# #     # #   # # #   # # #     #     #   #   #   # # # #   #     #   #       #   #   #   # #     #     #       #   # #       # # #
# # ##### ##### # # ### # # ### ##### # ### ##### # # # ##### ##### # ##### ##### ##### # # # ##### # ######### # ### # ##### ### #
# #     # #   # # #     # # #       # # #   #       # #     #       #   # #       #     #   # #   # #       #   # # # # #   #   # #
# ##### # # # # # ####### # # ####### # # # # ####### ### # ########### # ########### ##### # # # # ### ### # ### # # # # ##### # #
#   #   #   #   #     #   # #       # # # # # #       #   #       #   # #             #   # #   # # # # #   #   #   # # #       # #
### # ############### # ########### # # # ### # ####### ######### ### # # ### ######### ### ##### # # # # ##### ##### # ### ##### #
# # # #   #         # # #       #   #   #     #   #     #     #   #   # # # # #   #     #   # #   #   # #   #   #     #   # #     #
# # # # # # ### # ### # # ##### # ##### ######### # ##### ### # ### ### # # # # ### ### # ### # # ### # # ### ### ### ### # ##### #
#   # # #     # # #   # # #     #   #   #       #   # #   # # #   #     #   # #     #   # #   # #   # # # #   #   #   #   #       #
# ### ### ##### # # ### # # ####### # ### ### ####### # ### # ### ### ####### # ##### ### ### # ### # # ### ### ### ### ######### #
# # #   # #   # # #     # #         # #     # #       #   # #   #   #     #   #   # # #   #   #   # # # #   #   #     #     #     #
# # ### # # # # # ####### # ######### ##### # # ##### ### # ### ### ##### # ##### # # # ### # ### ### # # ### ########### # # #####
#   #   # # # # #     #   # #     #         # #     #   # #   #   # #     # #   #   #   #   #   #   # #       #         # # #   # #
### # ##### # # ####### # ### ### # ########### ##### # # # # # ### # ##### ### ### ##### ##### ### # ######### ####### ### ### # #
#   #       # # #   #   #       #     #         #     # # # # #   # #     #   #   #   # #   #   #   # #   #     #           # # # #
########### # # # # # ################# ######### ##### # # # ### # ##### ### # # ### # # # # ### ### # # # ################# # # #
#   #     # # #   #       #     #     # # #       #     #   #   # #   # # #   # #   # # # # # #   #   # # #         #     #   #   #
# # # ### # # ##### ####### ### # ### # # # ### ####### ####### # ### # # # ### ### # # # # # # ### ### # ######### # ### ### ### #
# #   # # # #     #   #     # #     #     # #   #     # #   #   #   # # #   #     # # #   # # #     #   # #   #     # # #   #     #
# ##### # ####### ### # ##### ##### ####### ##### ### # # # # ### # # # ##### ### # # # ### # ####### ### # ### ### # # ### # #####
#   #   #         #   # #     #   # #       #     #   #   # #   # # # # #   #   # # # #   # # #     #   #   #   #   # # #   #     #
### # ############# ### # ### # # ### # ##### ##### ########### # # # # # # ### # ### # ### ### # # ### ### # ### ### # # ####### #
#   #           #   #   # #   # #     # #     #   # #     #     # # # #   #     # #   # #   #   # # #   # # # #     #   # #     # #
# ### ##### ##### ### ### # ### ####### # ##### ### # ### # ##### # # ####### ### # ### # # # ### # # ### # # ######### # # ##### #
#   # #   #       # #     # # #   #   # #   #   #   #   # #   # # # #   #   #   # # #   # # #   # #   #   # # #         # #       #
# # # # ##### ##### ####### # ### # # # ### # # # ##### # ### # # # ### # # ##### # ##### ##### # ##### ### # # ######### # #######
# # #   #   #         #   #   #   # #     # # # #     # #       # #   # # #     #       #       #   #   #   #   #       # # #     #
# # ##### # # ######### # ### # ### ####### # ##### ### ######### ### # # ##### ####### ### ####### # # # ######### ##### # # ### #
# #       # # #     #   #   # # #     #     #     #       #       #   #   #   #       #   #     #   # # # #     #   #     # # #   #
# ####### # # # ### # ### ### # ####### ######### ######### ############### ######### ### ####### ### # # # ### # ### ##### ### ###
# #     # # # # # #     #     # #       #     #       #     #                     #   #           #   #     #   # #   #   #   #   #
# # ### # # # # # ########### # # ####### ### # ####### ### # ################### # ####### ################# ### # ##### ### ### #
# # # # # # # #   #         # # #       # # # #     #   #   #     #     #         #     #   #     #     #       # # #       #   # #
# # # # ### ##### # ####### ### ####### # # # ##### # ### ####### ##### # ############# ##### ### # ### ####### # # ### ####### # #
# # #     #       #   #   #           #   # #   #   #   # #     #     # #         #   #     #   # #   #     #     #   #       # # #
### ##### ### ####### ### # ############### ### # ##### # # # ####### # ######### # # ##### # # # # # ##### ##### ### # ##### # # #
#   #   #   #   #   #   #   #       #         # #     # # # #       #   #       #   #   #   # # # # #     #     # #   #     #   # #
# ### # ### ##### # ### ##### ##### # ### ### # ### ### ### ####### ### # ##### ##### ### ##### # # ##### ##### ### ####### ##### #
#     #   #       #     #     #   #   # # #   #   #   #     #         # #   #   #   #   # #     # # #   #   # #   #     # #   #   #
# ####### ############# # ##### # ##### # ####### ### ####### ### ##### ##### # ### ### # # ##### ### # ### # ### # ### # ### # ###
#       #     #   #     #   #   #   #   #       #     #     # #   #     #   # # #   #   #   #   # #   #     #     # #   #   # #   #
####### ##### # # # ####### # ##### # # ##### # ##### # # # # # ### ##### # # # # ### ####### ### # ######### ##### # ### # # ### #
#     #   # # # #   #     #   #   # # # #   # #     # # # # # #   #   #   #   # #   #     #     # # # #     #   #   # #   # #     #
# ### ### # # ####### # ####### ### # # # # # ####### ### # # ####### # ####### ### ### ### ### # # # # # ##### ##### # ######### #
#   #       #         #               #   # #             # #           #             #       #     #   #             #           #
###################################################################################################################################
