#############################################################################################################################################
# #     #             #   #   #         #   #           #         #             #         #       #       # #     #         #         #     #
# # ### # ### ####### # # # # # ### ### ### # ####### # # # ##### # ### ####### # ####### # # ### ### ### # # # # ##### # # ##### ### ##### #
# #   # # # #     # # # #   #   #   # #   #   #     # # # #     # # # #   #     # #     #   #   #     #   #   # # #   # # # #     # #       #
# ### # # # ##### # # ##### ##### ### ### ### # ### # # ####### ### # ### ##### # # ##### ##### ####### ####### # # # ### # # ##### ####### #
#     # #   #   # #   #   # #     #     #   # # #   # #       #       #   #   # #   #   #   #   #     #   #     # # # #   #   #   #   # #   #
####### ### ### # # ### # ### ##### ### ### ### # ### ####### # ##### # ### # # # ### # ##### ### # ##### # ##### # # # ####### # # # # # ###
#       #       # #     # #   #     #     #   # #     #     # # #   # #     # # # #   # #     #   #     #   #   # # #   #       #   #   #   #
# ####### ####### ####### # ### ### ######### # ####### ### # # # # ### ##### ### # ### # ##### ####### ##### ### # ########### ####### ### #
# #   #   #   #   #   #     #     # #         # #     # # #   # # #   #     #     # # # #   # #     # #       #   #     #     #   #     # # #
# ### # ### # # ### # ########### # # ######### # ### # # ####### ### ##### ####### # # ### # ##### # # ####### ####### # ### ### # ##### # #
#   #     # #   #   #   #       # # # #           #   #         # #   #       #     # #     # #     # # #     #       #     # #   #   #   # #
### # ##### ##### ##### # ##### # # # ######### ### ##### ##### # # ######### # ##### ####### # ##### # # ### ####### ####### # ##### ### # #
#   # #   #     # #   # #     # # # #     #   #   #     # #   #   #   #   # # # #     #       #     # #   #   #     # #     # #     #     # #
# ### # # # ### # # # # ##### # ### ##### # # ### ##### ### # ####### # # # # # # # ### # ### ##### # ##### ### ### # # ### # ##### # ##### #
# # # # # #   # #   # #   #   # #     # # # # #   #   #   # #   #   #   # # # # # # #   #   #     #     # #   #   # # #   # # #   # # #   # #
# # # # # ##### ##### ### # ### # ### # # # # # ### # ### # ### # ####### # # # # ### ##### ##### ##### # ### ### # # # # # # # # # # # # # #
# #   # #     # #       #   #   #   #   #   # #   # #     #   # #         #   # #       # # #     #   #   # #     #   # # #   # #   # # #   #
# ##### ##### # # ########### ##### ### ##### ### # ##### ### # ### ######### # ####### # # ### ### # ### # ########### # ##### ##### # #####
# #     # #   #     #   #     #   # # #     #   # # #   # #   #   # #       # # #     #   #   # #   #   # #   # #   #   # #   #     # #   # #
# # ##### # ##### ### # # ##### # # # ##### ### ### # # ### ##### # ### ### ### # ### ### ### ### ##### # # # # # # # ### # # # ### # ### # #
# # #     #     # #   #   #     # # #   #     #   # # #     #   # #   #   #   # #   # # #   #     # #   #   # #   # # # # # #     # #   # # #
# # # ######### ### ####### ##### # # # # ####### # # ####### # # ### ### ### # # ### # ### ####### # ####### # ### # # # ######### ##### # #
# # # #       # #   #       #   #   # #   # #     # #   #     #   #   #   #   # # #   #   # #       #         #   #     # #   #     #     # #
# # # # # ##### # ##### ##### # ##### ##### # ##### ### # ######### ### ### ### # # ### # # ### # ################# ##### # # # ##### ##### #
#   #   #     #   #   #   #   #   #   #     # #       # #     #     #   #   #     # #   # #   # #         #       #   #   # # #         #   #
##### ####### ##### # ### # ### # # ##### ### # ### ### ##### # ##### ### ####### # ### ##### # ##### ### ### ### ### # # # # ######### ### #
#   #   #   #       #     #   # # # #     #   # # #     #   # #       # # #     # #   #   #   #     #   #   # #     # # # # #       #       #
# ##### # # # ############### # ### ### # # ### # ######### # ######### # # ### ##### ### # ####### ### ### # ##### ### # # ####### ####### #
#     # # # # #   #           #       # # # # # #           #   #       #   # #       #   #   #       # # # #     #     # # # #     #     # #
# # ### ### # # # ################### # ### # # ######### ##### # ##### ##### ######### ##### ######### # # ##### ####### # # # ### # ### ###
# #   # #   #   #   #     #         #   #   #   #       #   #   #     #   #   # #       #     #         # #     #   #     #   # # # # # #   #
# ### # # # ####### # ### # ####### ### # ### ### ##### ### # ####### ### # # # # ### ### ##### ######### ##### # # # ##### ### # # # # ### #
# #   #   #   #   #   # #   # #     #   # #       #   #     #   #   # #     #   #   # #   #   #   #   #   #     # # #   #   #   #   # # #   #
### ######### # # ##### ##### # ### ##### ### ##### # ##### ### # # # # ####### # ### # ### ### # ### # # # ##### # # ### ### ### ### # # # #
#   #         # #         #   #   # #   #   # #     #     #   #   # # # #     # # #   # #   #   #   # # #   #   # # # #   # #   # #   # # # #
# ### ############# ##### ### ### ### # ### ### ######### ######### # ### ### # # # ### # # # ##### # # ##### # # # # # ### ### ### ### # ###
#   # # #         # #   #   #   #     #   #   #   #   #   #         #   # #   # # #     # # # #   # #   #     #   # # #       #   #     #   #
# # # # # ### ### # # # ### # ######### # ### # # # ### ### ### ##### # # # ##### ####### # # # ### # ####### ##### ######### ### ### ##### #
# #   # # #   #     # #       #       # #   # # # #     #   # # #   # #   # #     #     # # # # #   #   #   #     #         # # #     #     #
# ##### # # ##### ############# ##### # ### # ### # ##### ### # # # ##### # # ##### ### # # # # # ##### # # ######### ### ### # ####### ### #
#     # # #     # #             #     # #   #     #     # # #   # # #   # # # #     #   # # # # # #       #         #   #         #     #   #
##### # # ##### # # ############# ##### # ############# # # # ### # # # ### # ##### # ##### # # # ### ############# ##### ######### ##### ###
# #   #   #   # # #       #     #   #   # #   #       # # #   #   #   #   # # #     # #   #   # #   # # #   # #     #   #     #   # #       #
# # ##### ### # # ##### ### ### ### # ##### # # ##### # # # ### ######### # # # ##### # # # ### ### # # # # # # ##### # ####### # # ### #####
# #     #     # # #     #   #   #   # #     #   #   #   # #   #       # # #     #   #   # #     #   #   # # # #   #   #         # #   # #   #
# ##### ##### # ### ##### ### ### # # # ######### # ##### ### ####### # # ######### ##### ##### # ####### # # ### # ############# # # ### # #
#     # #     #     #     # #   # # #   #         #       # #       # # #   #       #     #   # #         # #   # #   #   #       # #   # # #
### # # ####### ##### ##### ### # # ##### # ############### # ##### # # ### ### ##### ##### # # ########### # # # ### # ### ########### # # #
#   # #       #   #   #     #   # # #     #   #         #   # #   # # #   #   #       #     # #   #     #   # # #     #   # #           # # #
# ########### ##### ### ### # ### ### ####### ### ##### # # # # # ### ### ### ### ####### ### ##### ### # ### # ######### # # ########### # #
# #       #   #   # #   #   #     #   #     #   # #   # # #   # #   #     # #   # #       #   #     # #   #   #           # #         #   # #
# # # ##### ### # # # # ######### # ### ### ### # # # # # ##### ### ##### # ### # ### # ### ### ##### ##### ####### ### ### # ####### # ### #
#   #   #   #   #   # #           #   #   #   # # # # # # #   #   #     # #   # #   # #   # #   #   #     # #   #   #   #   #   #   #     # #
####### # ##### ### ######### ####### # ### # # # # # ### ### ### ##### # # # # ### # ### # # ### # ### ### # # # ### ### ####### # ####### #
#     # #     # #   #       # #     # # #   # # #   #   # #     # # #   # # # # # # #   # #   #   #   # #     # # # # #   #       # #       #
# ### # ##### # ##### ##### # # # # # ### ### # ### ### # # ##### # # ### # ### # # ### # ##### ##### # # ####### # # # ### ####### # ##### #
# #     #     #     #   # # # # # # #     #   #   #   #   # #       #   # # #   #   #   #     #     #   #   #   # #   # #     #   #   #   # #
# ##### # ######### ### # # ### # ######### ##### ### ##### # ######### # # # ### ##### ##### # ### ### # ### # # ##### ### # # ####### # # #
#   #   #   #     #   # # #     #         #   #   # #       # #         #   # # #     # #   # #   #   # # #   # #     #   # # #         # # #
# # # ##### ### # # ### # ######### ####### ### ### ####### # # ####### ### # # ##### # # # # ####### ### # ### ##### ### # # # ##### # ### #
# # #     # #   #   #   #   #     #       # #   #     #     # #   #   # #   # #     # #   # #       #     #   #     #   # # # #   #   # #   #
# # ####### # ####### ### ### # ######### # # ### ### # ##### ### # # ### ### # ##### ##### ####### ##### ### ##### # ### # # ##### ### # ###
# #         #   #     # #     #     #   #   #   #   #   #     # #   #       # #     # #     #     #     #   # # #   #   # # # #     #   # # #
# ############# # ##### # ######### # # ####### ### ##### ##### ############# ##### # # ##### ######### ### # # # ##### # ### # ######### # #
# #       #     # #     # #     # #   #   #     #   #     #     #     #   #   #     # #   #           # #   # # #     #       #   #   #   # #
# # ##### # # # # # # ### ### # # ##### # # ######### ##### ### # ### # # # ### ##### ### # ##### ### # ##### # ##### ######### # # # # ### #
# #   # # # # # # # #   #   # #     #   # #         # #     #     # # # #   #   #   # #   # #   #   # #   #     #   #   #   #   #   #   #   #
# ### # # ### ### # ### ### # ####### ############# # ### ######### # # ##### ### # # # ##### # # # ##### # ##### # # # # # # ########### # #
#     #   #   #   #   #   # # #     #         #   # #   #     # #     #     #   # #   #       # # #   #   # #     # # # # # # #   #       # #
####### ### # # ######### # # # ### # ##### # # # # ### ##### # # ######### ### # ############# # ### # ### # ##### ### # # # ### # ### ### #
#     # #   # #   #     #     # #   # #     # # #     #       # #         #   #   #         #   #   # #     #     #     # # # #   # # # #   #
# # # # ### ##### # ### # ##### ### ### ##### # ##### ######### ######### ### # ### ### ### # ####### ####### ### ####### # # # ### # # # ###
# # # # #   #   #   #   # #   #   #     #     #   # # #       #         #   # # #     # # # #         #     # #   #     # #   # #   # # # # #
# # ### # ### # ##### ### # # # # ############### # # # ####### ### ##### ### # ### ### # # ######### # ### ### ### ### # ##### # ### # # # #
# # #   #   # #     #   # # # # #         #       #   # #       # #       #   #   # #   #   #         #   # #   # # # #   #     #   # # #   #
# # # ### # # # ### ### ### # ########### # # ####### # # ####### ######### ##### ### ### ####### ####### # # ### # # ##### ### ### # # #####
# # # #   # # # #   #   #   # #     #   # # # #     # # #   #   #   #     # #     #   # #       #       # #   #   #     #     #       #     #
# # # # ### # # ##### ### ### # ### # # # # # # ### # # ### # # # ### # ### # ##### ### ####### ### ##### ####### ##### # ################# #
# #   #   #   # #   # #     # #   #   #   # # # #   #     # # # #     #   # #   #   #         # # # #     # #     # #   #   #               #
# ####### ##### # # # ##### # ### ##### ### # # # ####### # # # # ####### # ### ### # ######### # # # ##### # # # # # ####### ############# #
# #     # #   #   # # #     #   #   #   #   # # #     #   #   # # #   #   #   #     #           #   # #   #   # #   #         #     #       #
# # ### # # # ##### # # ####### ### ##### ##### ##### ######### # # # # # ### ####### ############### # # ##### # ################# # #######
#   #   #   # # #   #   #     #     #     #   # #   #       #   # # # # #   # #     # # #   #         # #       # #   #             #   #   #
##### ####### # # ####### # ### ##### ##### # # ### ##### ### ### # # # ### # ### ### # # # # ### ##### ### ####### # # ### # ######### ### #
#   #   #   # # #   #   # #     #     #   # # #   #     #     #     # #   # # #   #   # # #   #   #     # # #     # #   # # # #       #   # #
# ##### # ### # ### # # # ####### ### # # # # ### # ### ####### ####### # ### # ### ### # ##### ### ##### # # ### # ##### # ### ### ##### # #
#       # #   #   # # # #   # #   # # # # # #   # # # #   #   #   #   # #   # #     #       #   #   #       #   #   # #   #   # # # #   #   #
# ####### # ### # # # # ### # # ### # # # # # ### # # ### # ### ### # ##### # ##### ######### ### ### ######### ##### # # ### # # # # # ### #
#       # #   # # #   #     # #   #   # #   #     # #       #   #   #       #     # #       # #   # # #       # #     # #   #   # #   #   # #
####### # ### # ############# ### ### # ########### # ####### ### # ######### ### # # ##### # # ### # # ### ### ### ### # # ##### ####### # #
#   #   #   # #       #   #     #   # # #           #   #   #   # # #       # # # #   # #   # #   # # #   #   #   #   # # # #       #   # # #
# # # ### # # ##### # # # ##### ### # # ######### ####### # ### # ### ##### # # # ##### # ### ### # # ####### ### # # # # ### ### # ### # # #
# # #   # # #       #   #     # #   # #   #     #       # #     #   #   #   #   #   #   # #     # # # #         # # #   #     #   # #   #   #
### ### # ### ############### # # ####### # ### ####### # ######### ### # ##### ### # ### # ### # # # # ### ##### # ########### ### # #######
#   #   #     #     #           #         #   #         #     #   #   # # #   #   # # #   # #   # #   # # # #   # # # #     #   #   #     # #
# ### ######### ### ########### ########### # ##### ######### # ##### # # # # ##### # # ##### ### # ### # # # # # # # # ### # ### ##### # # #
#     #         #       #   # #           # #     # #     #     #   # # #   #   #   # #       #   #     #   # # # #   #   #   # # #     # # #
# ##### # ### ######### # # # ########### ##### # # # ### # ##### # # # ####### # ### ######### # # ######### # # ####### ##### # ### ### # #
#     # #   # #   #   # # # #   #       #     # # # # # #   #     #   # #         #           # # # #         #   #       #     #     #   # #
##### ### # ### # # # # # # # ### ##### ##### ### ### # ##### ##### ### # ######### ######### ### ### ############# ####### ########### ### #
#   #   # #   # # # #     # #     #   #     #   #   #       #     # #   #   #   #   #       #     #   #     #       #             #   #   # #
### ### ##### # # ######### # ##### # ##### ### # # # ########### # # ####### # ### # ##### ####### ### ### # ### ### ######### ### # ### # #
#     #     # # #     #     #     # #     #     # #   #     #   # # #         #   # #     #   #   # # # # # # #   # # #     # #     #     # #
# ######### # # ##### ### ####### # ##### ### ####### # ### # # # # ############# # ##### ### # # # # # # # # # ### # # # # # ############# #
# #     #   # #   # #   # #     # #   # #   #       # # # #   #   #         #     # #   # # #   # # # #   # # #   # # # # #     #     #     #
# # ### # ### ### # ### # ### # # ### # ### ####### ### # ##### ########### # ##### # # # # ##### # # ### # # ### # # # # ##### ### # # ### #
# #   #   # #   #   # # #   # # # #   #   # #     #     #     # #       #   # #     # # # #     #   #   # #   #   #   # #   #       #   # # #
# ### ##### # # ### # # ### # # ### ##### # # ########### ### # # ##### ##### # # ### # # # ### ##### # # ##### ### ### ### # ########### # #
#   #     #   #     # #   #   #   #   #   # # #             # # #   #         # #     # # #   #     # # #     # #   #   #   #   #   #     # #
# ####### # ######### ### ####### ### # ### # # ########### ### ### ################### # ##### ### # # # ##### # ### ### ##### # # ##### # #
#     #   #     #       #     #       #     # # #     #     #   # #   #         #     # #       #   # #   #   # #   # # #   #   # #     # # #
# ### # ####### # ##### ##### ######### ##### # # ##### ### # ### ### # ##### # # ### # ######### ######### # # ### # # ### ##### ##### # # #
#   #   # #   #   #   #   # # #   #   #   #       #     #   # #     # # # #   # #   #   #     # #           #   # # # #   # #     # #   #   #
### ##### # # ##### ##### # # # # # # ### # ####### ##### ### ### # # # # # ### ### ### ### # # ################# # # # ### # ##### # #######
#   #       # #   #       # #   # # #   # #   #     #     #   #   # # #   #   #   #   # #   #             #       # #   #   # #     #       #
# ### ##### # # # # ####### ##### # # ### ##### ######### # ### ### # ####### ### ### # # ############### # ##### # ### # # # # ########### #
# #   #   # #   # #       #     # # # #   #   #   #     # #     #   # #       #     # #   #     #   #   #   # #   # #   # # #   #       #   #
# ##### # ##### # ####### # ##### # # # ### # ### # ### # ##### ##### # ########### # ### # ### # # ### ##### # ### ### # ### ### ##### # # #
#       #     # #       # #   #   # # #     #   #     # # #     #     #   #     # # # #   #   #   # #         #   #   # #     #   #   #   # #
############# ##### ##### ### # ### ########### ####### ### ##### ##### # # ### # # # ####### ##### # ########### ### ######### ### ####### #
#   #   #   #     # #   # #   #   #             #     #     #   # #   # #   #   # # #       #   # # #   #   #   #   # #         #           #
# # # # ### ##### # # # # # ##### ############# # ### # ####### # # ### ##### ### # ##### ##### # # # # # # # # ### # # ######### ###########
# #   #     # #   #   # # #     #   #         # #   # # #       # # #       #   #         #   #   # # # # #   #     # #   #     #   #   #   #
# ######### # # ####### # ### ##### # ####### # ### # # # ####### # # ##### ### # ######### # ### # ### # ########### ### # ####### ### # # #
#     #     # # #     # #   #     #   #   # # # #   # #   #       #   #   # #   #   #     # #   # #   #     #       #   # #       #   #   # #
# ### ##### # # ### # # ### # # ####### # # # # # ### ##### ####### ### # ### ##### # ### # # ### ### ####### ##### ### # ### # # ### ##### #
# # #     #   #     # # #   # #       # #   # #   #       # #     # # # #   # #     # # #   #   #   #         #     #   #   # # #   # #     #
# # ##### ########### # # ### ##### # # ### # ########### # # # ### # # ### # # ##### # ####### ### ########### ### # ### # # # ##### # ### #
# #     #         #   # # #     #   # #   # #       #   # # # #       # # #   # #     #       #         #       #   # #   # # #   #   # # # #
# ### # ####### # # ### # ####### ### ### ######### # # # # # ######### # ##### # ##### ##### ######### # ####### ### ##### # ### # ### # # #
#   # #   #   # # #   #         # # #   # #     #   # #   # #   #   #   # #     #   # #   #       #   # # #         # #     # #   # #   #   #
### # ### # # ### ### # ####### # # ### # # ### # ### ##### ### ### # ### # ####### # # ### ### ### # ### # ######### # ####### ### # ### ###
#   #   # # #     #   # #   # # # #       # # #   # # #     # #   # # #       #     #   #   #   #   #   # #     #     #       # #   # # #   #
# ##### # # ####### ##### # # # # # ####### # ##### # ##### # ### # # ####### # ##### ### ### ### ##### # ##### # ##### ##### # # ### # ### #
#   #   # #   #     #     # # #   # #       #       #       #   #   #       # # #   #   # #   # #     #   #   # # #     #   # # # #   #   # #
### # ####### # ####### ### # # ##### ######### ############# # ### ####### ### # # ### # # ### ##### ##### # ### ####### # # # # # ### # # #
#   #   #     # #     # #   #   #   #         # #             # #   #     #     # #   # # #   #   #   #     # #   #       # # # # # # # # # #
# ##### # ##### ### # # # ####### # ######### # # ############# # ####### ####### ### ### ### ### # ### ##### # ### ####### # # # # # # # # #
#       #           #   #         #           #               #                   #       #       #         #       #         #     #   #   #
#############################################################################################################################################
