#############################################################
#       #       #           #   #   #           #         # #
####### # ### # # ### ##### # # # # # ### ##### ### ##### # #
#       # #   # # #   #   # # # # # #   #   #   #   #   #   #
# ######### ### # # ### ### # # # ### ##### # ### ### # ### #
# #   #     #   # # #         #   #   #     #     #   #   # #
# # ### # ### ##### # ############# ### ############# ##### #
# #     # # # #     # #   #   #   #   # #     #       #   # #
# ### ### # # # # ##### # # # # # ### # # ### ### ### # # # #
#   #   # #     # #     #   #   #   # #     # #   #   # #   #
### ### # ####### # ############# # # ####### # ### ### #####
# # #   #   #   # #       #     # # #     #   #   #   #   # #
# # # ##### # # ######### ##### # ####### # ### # ####### # #
#   #     #   #         # #     #       # # #   #       # # #
# ####### ######### ### # # ### ##### ### # # ######### # # #
#       #         #   # #   # # #   #     # #     #   #   # #
####### ####### ##### ####### # # # ####### ##### ### ##### #
#     #   #     #     #       #   # #       #   # #   #     #
# ####### ####### ### # # ######### # ####### ### # # # ### #
#         #     #   # # #           # #     #   #   # # # # #
# ######### ### # # # # ############# ##### # # ##### # # # #
# #       # #   # # # #   # #       #     #   #         #   #
# ### ### # # ##### ##### # # # ######### # ############### #
#     # #   #     #   #   #   #   #       # #       #     # #
####### ######### # # # ######### # ####### # ##### # ### # #
#   #     #     # # # #           #   # #   # #   # #   # # #
# # # # ### ### # ### ########### ### # # ### # ### # ### # #
# # # #     # # #   #   #     #   #   #     # #   #   #   # #
# ### ####### # ### # # # ### # ### ####### # # # ##### ### #
# #   #       #     # #   #   # # # #   #   # # #     #   # #
# # ### ##### ####### ##### ### # # # # ##### # # ### ### ###
# #   # #   #     # # #   #   #   #   #       # # #   # #   #
# ### # # # ##### # # # # ### ### ############### # ### ### #
#   # # # #       #   # #   #     #             # #       # #
### # # ##### ######### ### # ####### ######### # # ####### #
#   # #     #           #   #   #   #     #   # # # #     # #
# ### ##### ############# ##### # # ### # # ### # # # ### # #
# #   #     #           #     #   #   # # # #   # # #   #   #
# # ### ############### ##### # ##### ### # # ### # ### ### #
# # #     #           #     # # #   #     # # #   #   # #   #
# # ##### # ######### # ##### ### # ####### # ### ##### #####
# #   #   #   #         #   # #   # #     #   #   #   #     #
# ### # ##### ### ####### # # # ### ##### # ### # # # ##### #
#   #   #   #   # #   #   #   #   #     #   #   # # # #     #
# ####### # ### # ### # ######### ##### ### ### ### # # ### #
# #     # #     # #   #     #     #   #   #   # #   #   #   #
# # # # # ####### # # ##### # ##### # ### ### # # ####### ###
# # # #   # #     # #     #   #   # #   # #     #   #   #   #
# # # ##### # ##### ### ####### # # ### # # ##### # # ##### #
#   # #     #     #   # #       # #   # # # #   # # #     # #
# ### # ### ##### # # # # ####### ### # # # # # ### ##### # #
#   # #   #   #   # # # # # #   # #   # # # # #     #     # #
### # ##### # # ##### ### # # # # # ### # ### ####### ### # #
# # #     # # # #   # #     # #   #   # #     #   #   #   # #
# # ##### # ### # # # # ##### ####### # ####### ### # ##### #
# #   #   #     # #   # #     #   #   #       #   # #       #
# ### # ### ##### ##### # ### # # # ######### # # # #########
#   # # #         #   # # #   # # #   #     #   #   #       #
# # # # ########### # # # ##### # ### ### # ############### #
# #   #             #   #       #         #                 #
#############################################################
