###############################
# #       #             #     #
# # ##### ##### # ##### # # # #
#   #   #     # # #   # # # # #
####### ##### ### ### # ### ###
#       #   #     #   #   #   #
# ##### ### ####### # ### ### #
#     #     #       # # # #   #
##### ##### ##### ### # # # # #
#   # #     #     # # # #   # #
# # # ### ### ##### # # ##### #
# # #   # #   #     #   #   # #
# # ### # # ### # ##### # # # #
# #   # #   #   # #     # # # #
# ### # ##### ##### ##### # # #
#   # # # #         #     #   #
# # # # # # ######### #########
# # #   #     #     # # #     #
### ######### # ### # # # # ###
#   #       # #   #   #   #   #
# ### ##### ##### ######### # #
#     #   #     # #       # # #
# ####### ### ### ### ### # # #
#         # # #   #   # # # # #
######### # # # ### ### # ### #
#   #   #   # # #   #   # #   #
# ### # # ### # # ### ### # ###
#   # # # #   # # #       #   #
# # # # # # ### # # ######### #
# #   #   #       #           #
###############################
