#########################################
#   #                       #         # #
### ##### ########### ##### ### # ### # #
# #     # #     #   # #   #   # # #   # #
# ##### # # ### # # # # # ### ### # ### #
#     # # # # # # #   # # #       # #   #
# ### # ### # # # ##### # ######### # # #
#   # #     #   # #     #     #       # #
### # ####### ### # ######### ###########
#   #       # # #           #           #
# ######### # # # ######### ########### #
# #         # #   # #     #           # #
# # ### ##### # ### # ### ############# #
# # #   #     #     #   #           #   #
# # ### # ############# ########### # ###
# #   # # #   #         #         # #   #
# ### ### # # # ######### ######### # # #
#   #   # # #   # #                 # # #
####### # # ##### # ################# # #
#       #   #     # #       #     #   # #
# ##### ##### ##### # ##### # ### ##### #
# #     #   #       # # #   # #       # #
# ####### # # ####### # # ### ####### # #
# #   #   # # #   #   # #   #   #   #   #
# # # # ### # # # # ### ### # # ### ### #
# # #   # # #   #   #     # # # #   #   #
# # ##### # ######### ##### ### # # # ###
#   # #   #     #   #       #   # # #   #
# ### # # ##### # # # ####### ### ##### #
# #     #     # # #   #         #       #
# ####### ### # # ########### # ##### ###
#   #   #   # #   #         # # #   #   #
### # # ### # ##### ####### ### # # ### #
# #   #   # #       #     #   #   # #   #
# ####### ##### ####### ##### # ### # ###
#       #     #   #   #     # #   # #   #
# ##### ##### ### # # # ### # ##### #####
#   #   #   #   #   # #   #   #   #     #
### # ### # ### ##### ### ##### # ##### #
#   #     #           #         #       #
#########################################
