#########################################################################################################################
#   #             #             # #       #     #         #     #       #         #     #           #   #               #
### ########### # # ##### ##### # # # ##### # # ##### ### ### # ##### # # ####### ### # # ####### # # # # ######### ### #
# #     #       # #   #   #     #   #     # # #   #   # #     #   #   # #     #       # #   #   # #   #   #     # #   # #
# ##### # ####### ##### ### ######### ### # # ### # ### ######### # ### ##### ########### ### # ### ####### ### # ### ###
#     # # #     #     # # # #   #   # # #   #   #   #   #         # #       #   #         #   #   #         # # #   #   #
# ##### # ##### ##### # # # # # # # # # ####### ##### # # ######### # ##### ### # ######### ##### ########### # ### ### #
#   #   # #       #   # # #   #   # #     #     #     #   #   # #   # #   #   #   #       #   # # #   #   #         # # #
### # ### # ####### ### # ######### ##### # ##### ######### # # # # ### # ### # ### ##### ### # # # # # # ######### # # #
#   #   # #       #     #     #   # # #   # #   # #       # # #   #   # #   # #     #   #   # #     #   #   #   #     # #
# ##### # # ##### ####### ### # # # # # ### # ### # ### # # # ####### # ### # ####### # ### # ############# # # ##### # #
# #   #   #   # # #       # #   # # #   #   #     # #   #   #       #     # #   #     # #   #         #   #   #   #   # #
# # # ####### # # # ####### ##### # ##### ### ##### # ############# ####### ### # ### ### ########### # # ####### # ### #
#   #       # # # # #           # #       # # #   # # #           #       #   # #   #   #     #   #   # #       # #   # #
# ####### # # # # # ### ### ##### ######### # # # # # ####### # ######### ### # ### ### ##### # ### ### ##### # # ##### #
#   # #   # #   #       #   #     #           # #   #   #   # # #       #     # #   #       #   #   # # #   # # #       #
### # # ### ############# ### ### # ################### # # # # # ### # ####### # ### ### ### ### ### # # # # ######### #
#   # #   #       #     #   #   # #     # #             # # # #   #   # #     # #   #   # #   #   #     # # # #         #
# ### ### ####### # # ##### ### # ##### # # ### ####### # # ##### # ### # # ### # ##### ### ### ### ##### # # # #########
#       #   #   # # #         # # #   # #   # #   #     # #     # #   # # #   # # #   # #   # #   #   #   # #   #       #
# ####### # # ### # ########### ### # # # ### ### ##### # ##### # ### ### ### # ### # # # ### ### ### # ### ##### ##### #
# #     # # # #   # #         # #   #   # #     #     # # #   # #   #     #   #   # # # #     #   # # #   #   #   #   # #
# # ### ### # # ### # ####### # # ####### ##### ##### ### ### # ########### ##### # # # # ##### ### # ##### # # ### ### #
# # # #     # #   # #   #     # #   #     #     #   #         # #           #     # # #   #     #   #   #   #   #       #
### # ####### ### ##### # ##### ### # ##### ### # # ########### # ####### ### ##### # # ### ##### # ### # ####### #######
#   # #         #   #   #       # # # #       # # #   #     #   #   # #   #   #     # # # #   #   # # # # #     #       #
# ### # ####### ### # ######### # # # # ##### # ### ### ### # ##### # # ### ### ##### # # ### # # # # # # # ########### #
# #           # #   #     # #     # # # #     #     #   # # #     # #     # # #   #   # # #   # # # # #   # #     #   # #
# ########### # # ####### # # ##### # ### ####### ### ### # ##### # ##### # # # # ### # # # ### # # # ##### # ### # # # #
#     #   #   # #         #     #   # #   #   #   #   #   #       #     # # #   #   # #   #   # # #     #     # #   #   #
# ### ### # ### ####### ####### # ### # ### # # ### ##### ######### ### ### ### ### # ### ### ### ####### ##### #########
# # #   #     #         #     # # # # # #   # #   # #             #   #   #   #   # #   #   #   #   #   # #       #   # #
# # ### ########### ##### ### ### # # # ##### ### # # ########### ### ### ### ### # ### ####### ### # # # ##### # # # # #
#   # #           # # #   # #     #   #     # #   # # #     # #   #     #   # #   # # #       #   #   #     #   # # #   #
### # ########### # # # ### ####### ####### # # ### # ### # # # ######### # # ##### # ####### ### ######### # ### # ### #
#   #         #   #   # # #     #       #   #   #   #   # #   #         # # #   #   #     # #   #       # #   # # # #   #
# ### # ##### # ##### # # # # # ####### # ### ### ### # # ### ######### ### ### # ### ### # ### ####### # ##### # # # ###
# #   #   #   # #     # #   # # #     #   #   #   #   # #   #   #     # #   # #   #   #   #   #     #   #       #   # # #
# ##### # # ### # ##### ##### # # ### ### ##### ### ### ### ### # # # # # # # ##### ### ##### ##### # ######### ##### # #
#     # # # #   #   # #   #   #   #   #   #   # #     # #   #   # # # #   # #         #     #     #   #             #   #
##### # # # # ##### # ### # ####### ### ### # # ####### # ####### # ####### # ####### ##### # ### ##### ##### ##### ### #
#   # # # # # #         #   #     # # # #   # #   #     # #       #         # #     # #   # # #         #   # #   # #   #
# # # # # ### # ############# ### # # # # ### ### # ##### # ####### ####### # # ### # # # # # # ######### # ### # ### ###
# # # # # #   #   #   #         # # # # # # # #   #   #       #   #   #   # # # # #   # # # # # #   #   # #     #   #   #
# ### # # # ####### # # ####### ### # # # # # # ##### ######### # ##### # # ### # ####### # ### # # # # # ######### ### #
#   # # # #         # # #   #   #   #   # # #   #   #           # #   # # #     #       # #   # # #   # #     # #     # #
# # # # # ########### # ### # ### ####### # ##### # ######### ### # # # # ######### ### # ### # # ##### ##### # # ### # #
# # # # #     #       #     #   # #       #   #   #         #   # # # # #     #   #   #     # # # #   #   #   # #   # # #
### # ##### # # ########### ### # # # ##### # # ########### ### # # # # ##### # # ### ####### # # # ##### # ### ### # # #
#   # #     # #     #   #     # # # # #     #   #   #     #   # #   #       # # #   #         # #   #     # #   #   # # #
# ### # ##### ##### # # # ##### # ### # # ######### # ### ### # ########### # # ### # ######### # ### ### # ### # ##### #
#       #   #   # #   #     #   #     # # #         #   #   # # #     # #   #   #   # #           #   #   #   # #       #
# ####### # ### # ########### # ######### ####### # ### ### # ### ### # # ##### # ### # ########### ### ##### # #########
#   #   # #   #       #       # #   #     #     # # #   #   # #   # # # # #   # # #   #   #       # # #   # # # #       #
##### # ### ##### ##### ####### # ### # ### ### # ### ### # # # ### # # # # # # # # ####### ##### # # ### # # # # # #####
#     #   #       #   # #     # # #   # #   # # #       # # #   #   # #   # # # # # #     #   #     #   #   # # # #     #
# ####### ##### ### # # # ### # # # ### # ### # ####### # # ##### # # # ### # ### # ### # ### ####### ##### # # # ##### #
#   #   #     # #   #   #   #   # #   #   #   #   #   # # # #     # # #   # # #   #   # #   #     #         # #     #   #
# # # ####### # # ######### ##### ### ##### ##### # # # # ### ### ### # ### # # ##### # ### ##### # ######### ####### # #
# # #   #     # # #                 #   #       #   # # #       #   # # #   #   #   # # #         # #         #       # #
# # # # # ##### # ### ################# # ### # ##### # ########### # # # ####### ### # ########### # ######### ####### #
# # # #   #     #   # #     #     #     # # # #     # # #     #     # # #       #   # #   #     #   #           #   #   #
# # ### ### ####### # ##### # ### # ##### # # ##### # ### ### # ##### # ####### # # # ### ##### # ############### # # ###
# #   #   #   #     #   #   #   #   #       #     # #       # #       # #     # # #     #     # # #   #           # # # #
# ### ### ##### ####### # ##### ################# # ######### # ####### ##### # ####### ##### # # # ### ##### ##### # # #
# # #   #       #   #   #     # #         #       # # #     # # #         #   #       #       # #   #   #   #   # # # # #
# # ### ########### # ##### ### # ####### # ####### # # ### # # ######### # ######### ######### ### # ##### ### # # # # #
#     # #       #   # #   # #   #     # # # # #   #   #   # # #       # # # #       #   #     #     # #   # #   #   #   #
####### # ### # # # # # # # # ####### # # # # # # ### ### # # ####### # # # # # # ##### # # ### ##### # # # # ##### ### #
#       # #   #   # # # #   # #       #     #   #     #   #   #     # # # #   # # #     # #     #     # #   #     # #   #
# ####### # ######### # # ### ### # ######### ######### ####### ### # # # ##### ### ##### ####### ##### ######### ### ###
# #     # #     #     # # #   #   # #     #   #     # #         #   # #     #   #   #   # #       #             # #   # #
# # ### # ##### # ##### # # ### ##### ### ### # ### # ####### ### ### ##### # ### ### # # # ####### ########### # # ### #
# #   # #   # # #       # #     #   # # #   #   # #   #     #   # # # #   #   #   #   # # # #       #         # #   #   #
# ##### ### # # ######### ### ### # # # ### ##### # ### ### ##### # # # # ##### ### ##### # ### ######### ##### ##### # #
#   #   #   # #       #   #   #   #   #   # # #     #   # #     # # #   #       #         #   # #       #     #     # # #
### # ### ### ##### # # ### ### ####### ### # # ##### ### ##### # # ############# ########### # # ##### # ### ### ### # #
#   # #   #   #     # # # # #   #   #       #   #     #       #   # #     #   #   #         # #   # #   #   #   #     # #
# ### # ##### # ### ### # # # ### # # ####### ### ######### ####### # # ### # # ### ### ##### ##### # ######### ####### #
# #           #   # #     # # #   # #   # #   #   #         #       # #     # #     #   #     #     # #         #     # #
# ############# # ### ##### # ##### ### # # ### ### ####### # ### ### ####### ### ####### ##### ##### # ####### # ### # #
#             # #       #   #   #     # # #   #   #     #   # # #   # #   #   #   #     #   #   #     # #       # # # # #
##### ####### ########### ##### # ##### # ### ### ##### # ### # ### # # ### ### ### ### ### # ### ##### # ####### # # # #
#   #       # #   #   #   #     #       #       # #   # #   #   # #   #   #     #   # #   # # #   #     # #     # #   # #
# # ######### # # # # # ### ####### ############# # # # ### ### # ####### ####### ### ### # # # ### ### # ### ### # ### #
# #           # #   # # # #   #   #             #   # # #   #   #       #       #   #   #   # # # # #   #     #   # #   #
# ########### # ##### # # ### # # ############# # ### # ##### ####### # ##### # ### ### ##### # # # # ######### ### ### #
#       #     # #   #       #   #       #     # #   # #     # #       #     # #   #       #   # # # #         #   #     #
# ##### # ##### # # ####### ########### # # ### ##### # ### # ### ######### ##### ####### # ### # # ######### ### ##### #
# #     #     # # # #   #         #     # # #   #   # # #   #   # #             #       # #   # # #         #   # #     #
### ### ####### # # # # ######### # ##### # # ### # # # # ##### # ############# # ### ### # # # # ######### # ### # #####
#   #   #       # # # #   #       #   #   #   #   #   # #     # #       #     #   #   #   # #   #     #   # # #   #   # #
# ### ### ####### # # ### ########### # ####### ### ####### ### ####### # ### ##### ### ####### # ### # # # # # ##### # #
#   #   # # #     # #   #           # # #     #   # #     #             # # #     #   #       # #   #   #   # #     # # #
### ##### # # ##### ### ########### # # # ##### # ### ### ####### ####### # ##### ########### # ############# ##### # # #
#   #     # #     #     #           # # # #     #     # #       # #       #     #   #   #     # #     #           # # # #
# # # ##### ##### ####### ####### ### # # # ########### ####### # # ####### # ##### # # # ##### # ### # ######### # # # #
# # # #   #     # #   #   #     #     # #               #       # # #     # #     #   # #   # #   #   #     # #   # #   #
# ### # # # ### # # ### ### ### ####### ### ############# # ####### ##### # ##### ##### ### # ##### ### ### # # ### #####
#   #   # # #   # #       #   #   #   #   # #   #   #     # #       #     #   # #     #     #     #   #   # #     #     #
# # ##### # ### # ########### ### # # ### ### # # # # ##### # ####### ####### # # ########### ### ### ##### ########### #
# #   #   #   # #             # # # # #       # # #   #   # #   #   #         # #             # #   #   #   #         # #
# # ### ### # ################# # # # ######### # ##### ### ### # # # ####### # ############# # ### ### # # # ####### # #
# #     #   #     #       #     # # #     #   # #   #   #   # # # # #   #   #   #     #       #       #   # # #     #   #
# ####### ##### # # ##### ### # # # ##### # ### ### # ### ### # # # ##### # ### ##### # ####### ########### # # ### #####
#     #   #     #   #   #   # # # #     # #   #   # #   # #   #   #     # #   #   #   #       #   #       # #   # #     #
##### ##### # ####### # ### ### # ##### # ### ### # # # # ### ######### # ### ### # ####### # ### # # ### # ##### ##### #
#   # #     # #   #   #   # #   #       #   #   #   # # #     #       #   # #   # #   #   # # #   # # # # #   #     #   #
# # # # ####### # ##### # # # ############# ### ####### ##### # ##### ##### ### # ### # # # # ##### # # # ### # # # # ###
# #   #         # #     # # #       #       #           #   # #   #   #     #   #     # # # #       # #   #   # # # #   #
# ##### ######### # ####### # ##### # ####### ######### # # # ### ##### # # # ######### # # ######### ##### ##### # ### #
# #   #     #     #   #     #     # #   #     #   #   # # # #     #     # # #     #     # # #       #             # # # #
# # ####### # ##### # # ##### ##### ### # # ### # # # ### # ##### # ##### # ##### # ##### ### ##### # ############# # # #
# #   #     # #     # #   #   #   #   # # #   # # # #     #     # # #   # # #   # #     #     #     #   #       #     # #
# ### # ##### ####### ### # ### # ### # ##### # # # ######### # # # # # # ### # # ##### ####### ####### # ##### ##### # #
#   #   #   #   #     #   # #   #     #     #   #   #       # #   # # # #     #   #   #   #   #     #   # #   #   #   # #
### # ### # ### # ##### ##### ####### ##### ####### # ##### ####### # # ########### # ### ### ##### # ### # ##### ### # #
# # # #   #   # # #   #     # #     #     #   #   # #   # #       # # #             #     #     #   # #   #     #   # # #
# # ### ##### # # # # ##### # # ### ##### ### # # ##### # ####### # ### ################### ##### ##### ### # ##### ### #
#       #       #   #         #   #         #   #               #       #                               #   #           #
#########################################################################################################################
