#########################################
#   #             #   #                 #
### # ### ####### # # # ### ### ####### #
# # # # # #     # # #     #   # #   #   #
# # # # # # ### # # ######### ### # #####
#   # # # # # # # #     #   #     #     #
# ### # # # # # # # ##### # # ######### #
#   #   #     # # # #   # # #   #     # #
### ########### # ### # # # ### ##### # #
# #             #     #   # #       # # #
# ######################### ####### # # #
#             #     #     #   #     # # #
# # ######### # # ### # ##### ##### # # #
# #     #     # # #   #     #     #   # #
# ##### ##### ### # ##### ####### ### # #
#     #     #     #     # #       #   # #
##### ##### ####### ##### # ####### ### #
#   #   # #   #     #     #     #   #   #
# ##### # ### # ##### ######### # ### # #
#     #     # #   # #       #   #   # # #
# # ####### # ### # ####### # ### ### # #
# #     #   #     #     #   #   # #   # #
# ##### # ####### # # ### # ### ### #####
#   #   #   #   #   # #   #   #   #     #
# ### # ### # # ####### ######### ##### #
# #   #   # # #         #       #       #
### ####### # ### ####### ### ######### #
#   #       #   # #       # # #       # #
# ### ######### ### ####### # # ### ### #
# #   #       #   #   #     # # # #     #
# # ### ######### ### ### ### # # #######
#   #           #     #   #   #     #   #
# ### ######### ####### ### # ##### # # #
#   # #       #         #   #     #   # #
### # # ##### # ####### # ##### ####### #
# # # # #     #   #   # # # #   #       #
# # # # ### ##### # ### # # # ### #######
# # # #   #   #   #   # # #     # #     #
# # ##### ### # ### # # # ####### ### # #
#         #     #   #   #             # #
#########################################
