#########################################################################################################################
#   #             #       #     #   #     #       #     #     #     #               #               #                 # #
### # ### ####### # ##### # ### # # # ### # ### ### # ### # # # ### # ####### ##### # ##### ######### ##### ######### # #
# # # # # #     # #   # #   #   # #   # #     #     # #   # # #   # #   #     #     #   #   #         #     #       #   #
# # # # # # ### # ### # ##### ### ##### ########### # # ### # ### ##### # ##### ####### # ### ######### ##### ######### #
#   # # # # # # # #     #   #   #     #     #     # # # # # #   #       #     #   #   # #   # #   #   #   #         #   #
# ### # # # # # # # ##### # # # ##### # ### # ### ### # # # ### ######### ### ##### # # ### # # ### # ### # ####### # ###
#   #   #     # # # #   # # # #     #   #   #   #   #     # # #         #   #       #     #     #   #   # #       # # # #
### ########### # ### # # # # # ######### ##### ### ####### # ######### ### ##################### ##### # ######### # # #
# #             #     #   # # # #     #   #     # #     #   #     #   # # #       #       #       #   # #         # # # #
# ######################### ### # ### # ### ##### ##### # ### ##### # # # # ####### ##### # ####### ### ######### # # # #
#   #           #       # #   #     # #   # #   #       # #     #   #   # # #       #   # #   #   #               # # # #
# ### ##### ### ##### # # ### ##### # # ### # ### ####### ### # # ####### # # ######### # # # # # # ############### # # #
#     #     # #     # #     #     # #   #   #   #   #       # # #   # #     #   #     # # # # # #     #   #       #   # #
# ##### ##### ##### # ### ####### # ##### ### # ### ####### ### ### # # ####### # ### # # ### # ####### # # ##### # ### #
#     #   #     #   #   # #       #   #   #   #   # #   #   #     # #   #   # #   # # #       #   #     # # #     #     #
### ##### # # ### ##### # # ####### ### ### ##### # # # # ### ##### ### # # # ##### # ############# ##### # # ######### #
#   #   # # #   # #     # #     #   #   # # #   # #   #   #       #   #   #   #     # #   #       # #     # #         # #
# ### # # ### # # # ##### ##### # ### ### # # ### ######### ##### ### ####### ### # # # # # ##### # # ############### # #
# #   # #   # #     #       #   #   # #   # # #   #     #   #   #   #     #   #   # # # #       # # #           #     # #
### ### ### ############### # ### ### # ### # # # # # ### ##### ### ##### # ### ### # # ######### # ########### # ##### #
#   #       #       #     # #   # #   #     # # #   # #   #       #       #     #   #       #   # # #       #   # #     #
# # ####### # ##### # ### # ### ### ##### ### # ##### # ##### ### ########### ####### ####### # # # # ##### # ### # #####
# # #     # # #   # #   # #   #   #     #   # #   #   #       # # #           #     # #       #   # # #     #   #   #   #
# ### ### ### ### # ### # ####### ##### ### # ### ############# # # ######### # ### # # ########### # ### ##### # ### # #
# #   # #   #   # #   # #       #       # #     #       #     #   # #       # # # # # #             #   #   #   #   # # #
# # ### ### ### # ### # ####### ######### # ######### ### ### # ##### ##### ### # # ##### ##### ####### ### # ##### ### #
# # #     #   # #   #   #     #         #   #   #   # #   #   #       #   #     # #     # #   #   #     # #   #   #     #
# # ### ### # # # ########### ### ##### # ### # # # # # ### # ########### ####### ##### ### # ##### ##### ##### # ##### #
# # #   #   # # #           #   #   # # # # # # # #   #   # #             #     #     #     #       # #   #     #       #
# # # # # ### # ### # ##### # # ### # # # # # # # # ##### # ############### # # ### # ############### # # # #############
# #   # # #   #   # # #     # # #   # # #   # #   # #     #             #   # #     #   #             # #   #           #
# ##### # # ##### ### ##### ### # ### # ##### ####### ################# # ### # ######### # # ####### # ##### ######### #
#       # # #     #   #   #     #   #   #     #       #     #         # # # # # #         # # #   #   #     # #   #     #
# ####### ### ##### ### # # ##### # # ### ### # ######### # ### ####### # # # ### ######### ### # ######### # # # # #####
# #     #     #     #   # # #   # # # # #   # # #       # #   #       #   # # #   #     # #     #           #   # #     #
# ### # ####### ##### ### ### # ### # # # # # # ### ### # ### ####### ##### # # ##### # # ################### ### #######
#     # #       #     #   #   #     # #   # # # #   # # # # #   #   #       # #   #   # #         #       #     #       #
####### # ##### # ##### # # ######### ##### # # # ### # # # ### # # # ### # # ### # ### ##### ### # ##### ##### ####### #
#     # #   #   # # #   # # #   #   #     # # # # #   #   #   #   # # # # # #     # # # #   # #   # #   #     # #     # #
# # ### ##### ### # # ##### # ### # ##### # ### # # ####### ####### # # # # ####### # # # # # # ### ### ##### # ### ### #
# # #   #   #       # #     #   # #     # #   #   #     #         # #   # #     #   # #   #   #   #   #     # #     #   #
# # # ### # ##### ### # ##### # # # ### # ### ##### # ### ##### ### ##### ##### # ### ########### ### # # ### ##### # # #
# # #     #     # #   # #   # # # # #   #   #   #   # #   #   #   #     # #   #   #     #       #     # #     # #   # # #
# # ########### ### # # # ### # # # ####### ### # ### # ##### ### ##### # ### ######### # ### # ####### ####### # ### ###
# #     #     # #   # # #     #   #       #   # #   #         #     # #   #   #       #     # # #     #     #       #   #
##### # # ### # # ### # ##### ########### ### # # ########### # ### # ##### ### ### # ####### # ### # ##### # ##### ### #
#   # # # # # #   # # #     #   #   #   #     #   #   #     # # #       #     # # # #   #     #   # # #     # #   #   # #
# # # # # # # ##### # ##### ### # # # # ####### ### # # ### ### ######### ### # # # ### # ####### # ### ##### # # ### # #
# #   # #   #       # #   #   #   # # #       # # # #   # # #   #         # #   # # #     #     #   #   #     # # #   # #
# ######### ### ##### ### ### ##### ### # ### # # # ##### # # # # ######### ##### # ######### ##### # ######### # # ### #
# #   #     #   #     #     #   #     # # #   #   # #       # # #   # #       #   #       #   #     # #         # # #   #
# # # # ##### ### ##### ####### ##### ### # ####### # ####### # ### # # ##### # # ####### # ### ##### ### ####### # # # #
# # #   #   #   # # #   #     # #   #     #   #     #     #   # #   #       #   #     #   #     #   #     #     # # # # #
# # ##### # ### # # # # # ### # # # ######### # ######### # ### # ####### ####### ### # ### ##### # ######### # # ### ###
# # #     #   #   #   #   #   #   # # #     # # #     # # #   # # #     # #     # # # # #         #         # # #   #   #
# # ####### # ############# ####### # # # ### # # ### # # # # ### ### # # # ### # # # # ################### ### ### ### #
# # #     # #             #       # #   # #   #     # #   # #   #     # # # #   # # # #   #         #     #   #   #     #
# # # ### ### ########### # # ### # # ### # ### ##### # ### ### ####### ### # ### # # ### # ####### ### ##### ### ##### #
# #   #   #   #   #     # # #   # # #   #   #   #     #   #   #       # #   # #   #   #   # #     #   #       #     #   #
# ##### ### ### # ##### # ##### # # ### ####### # ####### ### ##### # # # ### # ####### # # ### # ### # ####### ### # ###
#     # #   #   #     # # #     # #   #       # #   #   #   # # #   # # #   # #   #     # #     # #   #   #       # # # #
# ### # # ### # ##### # # # ### ##### ####### # ### # # ### # # # ##### ### # ### # ##### ### ##### ##### # ##### # # # #
# # #   # #   #     # # # #   # #     #     # #   # # #   # # # #           # #   #     #   # #     # #   #   #   # #   #
# # ##### # ####### # # # ### # # ##### # # # ### # ##### # # # ############# # ##### # ##### # ##### # ####### ####### #
# #       # #     # #   #     # # #   # # # # # # #   #   # #       #   #       #   # #   #   # # #   #       #     #   #
# # ##### # # ##### ####### ##### # # # # # # # # ### # # # ####### # # ######### # ##### # ### # # # ####### ##### # ###
# # #   # #   #   #         #   # # # # # # # #   #   # # # #   #   # #         # #       # # # # # #       #     # #   #
# ### # # ##### # # ######### # # # # # # ### ### # ### ### # # ##### ######### # ####### # # # # # ####### ##### # ### #
# #   #   #     # # #     #   #   # # # #   #   # #   #     # #       #       #   #   #   #   # # # # #   #       #   # #
# # ####### ##### # # ##### # ##### # # ### ### ##### ### ### # ####### ####### ### # # ##### # # # # # # ### ##### ### #
# #         #     #   #   # # #     # #   #   #     #   #     # #   #           #   # # #   # # #     # #   # #     #   #
# ######### # ######### # # # # ##### ####### ##### ### ##### ### # ######### ### ### ### # # # ####### ### # ### # # ###
#         # #     #   # #   # # #   #   #   #     #     #     #   # #       # # # # #   # # # # #   #   # # #     # # # #
######### # ##### # # # ####### # ##### # # ##### ####### ##### ### # ##### # # # # ### # # # # # # # ### # # ##### # # #
#         #     #   # #       # # #     # # #           #   # #   #   # #   #   #   # # # #   #   # #   # # # #   # #   #
# ############# ##### ####### # # # ##### # # ####### ##### # ### ##### # ######### # # # ######### ### # # ### # ##### #
#   #         # #       #   #     #       # #   #     #   # #   #     # #     #     # #   #       #   #   #     # #   # #
### # ####### ### ####### # ############### ### # ##### # # ### ##### # ##### # ##### ##### ### ### ##### ####### # # # #
#   #   #   #     #       #     #       #   #   #   # # # #     #   #       # #   #   #   # # #   #       #     #   #   #
# ##### ### ##### # ########### # ##### # ### ##### # # # ##### ### ####### # ### # # # # # # ### ############# #########
# #   #   #       # #         #   #   # # #   #   #   # #     # #     # #   #   #   # # # # #   #           #         # #
# # # # # # ####### # ####### ##### # # # # ### ##### # ### ### # ### # # ##### ##### # # # # ####### ### # # ####### # #
#   # # # #       # # #       #     # #   #   #       #   #       #     #   # #       # # # # #     # #   # #     #     #
##### ### ####### # # # ##### # ##### ##### # ### ##### ################### # ######### # # # # ### ### ### ##### #######
#         #     # # # # #   #   #   #   #   #   # #   # #                   #     #     # # # # # #     # #     #       #
# ######### ### ### # # # ####### ### ### ##### ### # # # ################### ### ### ##### # # # ####### ##### # ##### #
#     #     #     # # # #             #   #   #     #   #   #       #       #   #     #       # #             # # #   # #
### ### ### ##### # # # ######### ##### ### # ############# ####### # ##### # # ### ### ####### ####### ### # # ### # # #
#   #   #   #   #   # # #       #   #   #   #         #   #   #   #       # # #   # #   #       #     #   # # #   # # # #
# ### ### ### # ####### # ##### ##### ### ####### ##### # ### # # ##### ### # ### ### ### ####### ### ##### # ### # # # #
#   #   # #   # # #     # #   #       #   #   #   #   # #   #   #     # #   #   # #   #   #       # # #   # # # #   #   #
### ### ### ### # # # ### # # ######### # # # # ### # # # ########### # # # ### # # ### ### # ##### # # # # # # ####### #
# # # #   #   # #   # #   # #     #   # # # #   #   #   #     #   #   # # # #   #     # # # #     # #   #   # # #     # #
# # # ### ### # ##### # ### ### # # # ### ####### ######### ### # # ### # ### ######### # # ##### # ######### # # # ### #
# # #   # #   #     # #   #   # #   #   # #       #       #     #   #   #     # #       #   #     # #   #   #   # #     #
# # # ### # ####### # ### ### # ####### # # ####### ################# ######### # ########### ##### # # # # ### # #######
# # #   # # #   #   #   #   # # #     #   #       # #           #   #           # #           #       #   #     #   #   #
# # ### # # # # # ### ##### ### # # ### ######### # # ####### ### # # ######### # # ##### ##### ######### ######### # ###
# # #   # # # # # #   #     #   # #     #       # # # # #   #     #   #   #   # # #   #   #   # # #     # #       # #   #
# # # # # # # # # # ### ##### ### ####### # ### # # # # # # ########### # # # ### ### # ### ### # # ### # # ### # # ### #
#   # # # # # # # #         #   # #     # #   # # #     # #       #     #   # #   #   # #   #     # #   # #   # # # #   #
# ### ### # # # # ######### # # # # ### # ### # # ##### # ####### # ######### # ####### # # # ##### # # ##### # ### # # #
# #   #   #   # #   #   #   # # # # #   # # # # #     # #     #     #       # #   #     # #   # #   # # #     #   #   # #
# # ### ####### ### # # # ##### # # ### # # # ####### ####### ####### ##### # ### # ##### ##### # ### ### ####### ##### #
#   #   #     # # #   # # #     # #   # # # # #     #       #   #   # #   # #   # #     # #     #   #     #     #       #
### # ### # ### # ##### # ### ### ### ### # # # ### ####### # # # # ### # # ### # ### # # # ### ### ######### # #########
#   # #   # #   #     # # #   # # #   #   # #   # #       # # #   #   # # # #   #   # # # #   #   # #       # #         #
##### # ### # ####### # # # ### # # # # ### ##### ### ### # ##### ### # # # # ##### ### # ####### # # # ### ### ####### #
#   # # # # #     #   # #   #   # # # #     #     #   #   #     #   #   # # #   #   #   # #       # # #   #     #     # #
# # # # # # ##### # ### ##### # # # # ##### ### # # ### ####### ### ##### # ### # ### ### # ##### # ### # ####### # ### #
# # # #   #         #   #     #   # # #   # #   # # #   # #     # # # #   #     # #     #   #   # #   # # #     # #   # #
# # # ### ########### ####### ##### # ### # # ### # ### # # ##### # # # ### ##### ##### ##### # ##### ### # # ### ### # #
# # #   # #     #   # #     #       #     #   # # #   #   #     #     # #   #   #     #     # #     #     # # #   #   # #
# # # # # ### ### # # # ### ################### # ### ######### # ##### # ### # ##### ##### # ##### ####### ### ### ### #
# # # # # #   #   #   #   #   #   #               # #         # #   #   #     #       #     # # #   #     #   #   #     #
# # # # # # # # ##### ### ### # # # ############### ####### ### ### # ################# ### # # # ### # # ### ### #######
# #   # # # # # #       #   #   #   #     #             # #   # #   #   #       #   #   #   # # # #   # #       # #     #
# ####### # # # ########### ########### # ####### ##### # ### # ####### # ### ### # # # ##### # # # ### ######### # ### #
#           # #                         #         #         #           #   #     #   #         #     #             #   #
#########################################################################################################################
