#################################################################################
#     #   #           #       #         #         #     #   #         #         #
##### # # ### ####### ##### # # # ##### # ##### ### # ### # # ##### # ##### # # #
#   # # #   #     #   #     # # # #   # # #   #   # #     # # #   # # #   # # # #
# # # # ### ##### # ### ##### # # # ### # ### ### # ####### # ### # # # # ### # #
# # # #   #     # #   # #   # # # #     # #     #   #     # #   # # #   # #   # #
# ### # # ##### # ### # ### # # # ####### # ### ##### # # # ### # # ##### # ### #
# #   # # #       #   #   #   # #       #   # # #     # # #     # # #       #   #
# # ### # # ######### ### # ######### # ##### # ####### # ####### # ######### ###
#   #   # # #       #   # #         # #       # #       #         #         #   #
# ### ### ### ##### ### # ######### # ### # ### # ############### ######### #####
# #     #         #   #   #   #     #   # # #   # #           #   #   #   # #   #
# # ################# ##### # # ####### # ### ### ######### # # ### # # # # # # #
# # #         #     #   #   # # #   #   #         #       # # # #   #   # #   # #
# ### ####### # ### ### ##### # # # # ############# ##### ### # ### ######### # #
# #   #     # #   #     #   # #   # # #         #   #     #   #   # #       # # #
# # ####### # ### ####### # # ##### ### ####### # ### ##### # ### # # ##### ### #
# #   #     #   #   #     # #     # #   #     #   #   #   # #   #   # #   #   # #
# ### # ### ### ### # ##### ### # # # ### # # ##### ### # # ### ### # # ##### # #
#     #   #   #     #     #     # #   #   # # # #   #   # #   # #   # #       # #
####### # ########### ### ####### ##### ### # # # ### ### ### ### ### ### ##### #
# #     #         #   # # # #     #   # #   #   # # #   #     #   # #   # #     #
# # ######### ##### ### # # # ####### # # ####### # # # ####### ### ### # ##### #
# # #     # #           # # #       # # #       # #   #         #   #   #       #
# # # # # # ############# # ####### # # ####### # ####### ####### # # ######### #
# # # # # #       #   #   #   #   #   #       #   #     # #       # #     #   # #
# # ### # # ##### # # # ### ### # ### ####### ##### ### # # ########### # # # # #
# #   # #   #   # # #   #   #   #   #   #   #       #   #   #         # # # #   #
# ### # ##### ### # ##### ### ### ##### ### ######### ####### ####### ### # #####
#   # # #   #     # #   #     # #     #   # #   #   # #       #           #     #
### # # # ### ##### # # # ##### ##### ### # # # # # # # # ##################### #
#   # # #         # # # #         # #     # # #   # # # #         #     #       #
# ### # ####### ### # ########### # ####### # ##### # # ######### # ### ### #####
#     #     #   #   # #   #     #     #     # #     # #     #     # # #   #     #
# ######### ### # ### # # # ### ##### # # ### # ### # ### ### ### # # ### ##### #
#         #   # # #     #   #     #   # #   # # #   #   # #   #   # # #   #     #
######### ### ### # ######### ##### ##### # # # # ##### # # ### ### # # ### #####
#       # #   #   # #   #   #     #     # #   # #     # # # #     #   # # # #   #
# ### # # # # # ##### # # # ### # ##### ### ### ### ### # # ######### # # # # # #
# #   # #   # # #   # #   #   # #     #   #   # #   #   # # #         # #   # # #
# # ######### # # # # ####### # # ### ### ### # ##### ### # # ######### # ### # #
# # #         # # #   # #   # # #   # # # # # #     #   # #   #   #   # #     # #
# # # ######### # ##### # # # ### # # # # # # ##### ### # ##### # ### # #########
# # # #     #   # # #     # #   # # #   # #   #   # #   #   #   #   # #     #   #
### # ### # # ### # # ##### ### ### ##### # ### # # # ##### # ##### # ##### # # #
#   #   # # #   # #   #   #   #     #     #   # # # # #       #       # #   # # #
# # ### ### ### # # ##### ### ##### # ####### # ### # ############### # # ### # #
# #   #   # #   # #         #       # #     #   #   #   #         #     # #   # #
# ### ### # # ### ######### ######### # # ##### # ##### # ####### ####### # ### #
# #     #   # #     #     # #       # # #   #   #     # # #     #   #   #     # #
# ##### ### # # ### # ### # ##### ### ### # # ####### # # # ### ### # # ##### # #
#     #   # # #   # #   # # #   #   #   # #         # # #   # #   # # #     # # #
##### ### # # ### # # # ### # # ### ### ############# # ### # ### # # ##### ### #
#     #   # #   # # # #       #       #             # #   #   #   #   #       # #
# ######### ### # # # ############### ############# # ### # ### ############# # #
#   #     #   # # # # #     #       # #   #     #   #   # # #   #         #     #
# # # ### # ### # # ### ### # ### ### # ### ### # ##### # ### ### ####### #######
# #     #   #   # # #   #   #   # #     #   # #   #   # #   #   # #     # #     #
############# ### # # ### ####### # ##### ### ##### # # ### # # # # ### # # ### #
#         #   #   #   # # #     # # # #   #         # #   # # # # # #   #   #   #
# ####### # ### ####### # # ### # # # # ### ### ##### ### # # # # # ### ##### # #
# #     # # #         # #     # #     # # # #   #   #     # # # # #   # #   # # #
# ##### # # ######### # ####### ####### # # # ##### # ##### ### # ### # ### # # #
#     # # #       # # #   #   # #   #   #   # #     # #   #   #     # #     # # #
# ### # # # ##### # # ### # # # # # # ##### # ### # # # # ### ##### # ### ### # #
# #   # # # #   # # # #   # # #   # #     # #   # # # # #     #   #   #   #   # #
### ### # ### # # # # # ### # # ### ##### ##### # ### # ####### # ##### ### #####
#   #         #   #     #   # #   #     #   #   # #   # #       # # #     #     #
# ####################### ### ### ### # ### # ### # ### # # ##### # # ######### #
#             #             # # # #   # # #   #     #   # #     # #   #       # #
# ######### # # ############# # # # ### # ##### ##### ######### # ##### ##### # #
# # #     # # #     # #   #   # # # #     #     #   # #         #     #   # #   #
# # # ### ### ##### # # # # ### # # ####### ##### # # # ############# ### # ### #
#   #   # #   #   # #   # # #     # #       #     #   #     #       #     #     #
### ### # # ### # # ### # # ##### # # ####### ######### ### # ##### ####### #####
#   #   #   #   # #   # # #     # # # #     #         # # #       #   #         #
# ### ####### ### ### # # ##### ### # # ### ######### # # ########### ######### #
# # #         #   #   # #   # #   #   #   #         # #   #   #     #     #   # #
# # ########### ### ##### # # ### ####### # ######### ##### # # ### ##### # ### #
#             #           #     #         #                 #   #         #     #
#################################################################################
