###################################################################################################################################
#   #             #                   #     #       #                       #         #     #   #       #       #     #           #
### ##### ####### # ############### # # ##### # ##### ##### ####### ####### # ####### # ##### # # # # ### ### # # ### # # ####### #
# #     # #     # # # #         #   # #       #       #   # #   #   #   #   #   # #   # #     #   # # #   # # # # #   # # #     # #
# ##### # # ### # # # # ####### # ### ### ####### ##### # ### # # ### # # ##### # # ### # ######### # # ### # ### # ### # # ##### #
#   # # # # # # #   # #       #   #     # #     # #     #   # #   #   # #       #     # #   #   #   # # #   #     #     # #       #
# # # # ### # # # ### ####### ######### ### ### ### ####### # ##### ######### ####### # ### # ### ##### ### ############# # #######
# #   #     #   # #   #     # #   #   #     #       # #     #   #   #   #     #   #       # # #   #   #   # #           # #   #   #
# ### ####### ### # # ### # # # # # # ##### ######### # ##### # # ### # # ##### # ##### ### # # ### # ### # # ####### ### ### ### #
#   #     # # # # # #     # #   # # # #     #   #   #   #     # #     #     #   #   #   #   # #   # #   # #   #   # #   # #       #
### ##### # # # # # ####### ##### # # # ##### # ### # ### ##### # ########### ##### ##### ### ### # ### # # ### # # ### # ####### #
#   #       # # #   #     #     #   # # #   # #   # #   # #     #         #       # #     #     #   #   # #     #   #   #     #   #
# ### ####### # ### # ### ########### ### # # ### # ### ### # ######### ### ####### # ##### ### ##### # # ######### # # ##### ### #
# #     #     #     #   #           # #   #   # # #   # #   # #     #   #   #     # # #   # #   #     # #   #       # #   # #   # #
# ####### ############# ########### # # ####### # # # # # ##### ### ##### ### ### # # ### # # # # ### ##### # ####### ### # ### ###
#       # #   #         #         # # #   #     # # #     #     # #       #   #     #   #   # # #   # #     #   #   # # #   # #   #
####### # # # # ######### ######### # ### # ### # # ####### ##### ######### ########### ##### ##### ### ######### # # # ### # ### #
#     # # # #   # #                 #   #   #   # # #       #   # #       #       #   #     #     #   #   #       # # # #   #   # #
# ### # # # ##### # ################# # ### ##### # # ####### # # # ##### ####### # # ##### ### ##### ### # ####### # # # ### ### #
# #   # #   #     # #       #     # # #     #     # # #   #   #   #   #         #   #     #   #   #     #   # #     # # #   # #   #
# # ### ##### ##### # ##### # ### # # ####### ####### # ### # ### ### ######### ### ### ##### ### # ### ##### # ##### # ### # # ###
# #     #   #       # # #   #   #   #       #     #   #     #   #   #     #   #   #   # #         # #   #     # #   # #   # # #   #
# ####### # # ####### # # ### # ### ####### ##### # ####### ### ### ##### # # ### ##### # ####### # ##### ### # # # # ### # # ### #
# #   #   # # #   #   # #   # # #   #     # # #   # #     #   # #       #   #   # #   #   #     # # #     #   #   # #   # #     # #
# # # # ### # # # # ### ### ### # ### # ### # # ### # ### ##### ############### # # # ##### ### ### # ##### # ##### ### # ##### # #
# # #   # # #   #   #     # #   # #   #   #   #   # #   # #   #   #         #   #   #       # #   # #     # # #   #     #       # #
# # ##### # ######### ##### # ### # ##### ### ### # ### # # # ### # ####### # ############### ### # ##### # # # # ####### ####### #
#   #     #     #   #       # #   # #   #       #       # # #     # # #     #       #   #   #   # #   #   # #   #   #     #   #   #
# ### ### ##### # # # ####### ##### ### ################# # ##### # # # ########### # # # ### # # # ### ### ##### ### ####### # ###
# #     #     # # #   #       #         #         # #       #     # # #         #   # #   #   # #   #   #   #     #   #   #   #   #
# ####### ### # # ##### ### # # ######### ####### # # ########### # # ######### # ### ### # ### # ### ### # ####### ### # # ##### #
#   #   # #   #   #     #   # # #         # #     #   #   #     # # #         # # #   #   # # #   #     # # #           # # #     #
### # # ### ####### ##### # ### # ######### # ##### ### # # ### # # ##### ##### # # # # ### # ##### ##### # # ########### # # ### #
# #   #   #     #   # #   # #   # #         #   #   #   #   # # # # #     #     # # # #   # #     #   #   # # #   #   # #   # #   #
# ####### ##### # ### # # ### ### ### # ### ### ##### ####### # ### # ### # ##### # # ##### # # ##### # ##### # ### # # ### # # ###
#     # #     #     # # # #   # #   # # #     #       #       #   # #   # # #     # #   #   # # #     #   #   # #   # #     # # # #
# ### # ##### ##### # # ### ### ### ### ### ############### # ### # ### ### # ##### ### # ### # # ####### # ### # ### ### ### # # #
# #   #     #   # # # #     #     #   #   # #             # # #   #   #   # # #   # # # #     # # #     #       # # #   #   # #   #
# # ####### ### # # # ####### ####### # # ### ####### ### # ### ##### ### # # ### # # # # ####### # ### ##### ### # ### # ### ### #
# #   #       # # # #         #       # #           # #     #   #   #   #   #   #     #   #       # # # #   # #   #   # # #   #   #
# ### # ####### # # ### ##### # ############# ####### # ##### ### # # # ### ### ######### # ####### # # # # # # ##### # ### ##### #
#   # # #   #   #       #     # #       #   # #       #   #   #   # # #   #   #         # # # #   # #   # # # # #     #   # #   # #
# # # # # # # ### ######### ### ### ### # # ### ######### # ##### # ##### ### ######### ### # # # # # ### # ### # ### ### # # # ###
# # #   # #   #     #     #   #   # # # # #   #         # # #     # #     #   #       #     # # #   #     # #   #   #   # #   #   #
# # ##### ########### ### ####### # # # # ### ######### ### ### ### # ####### # ##### ### ### # ########### # ### # ### # ####### #
# # #   # #           # #   #     # # # # # #   #       #   #   #   #   #   #   #   #   #     # #         #   # # # #   #     #   #
# # # # # # ########### ### # ##### # # # # ### # ##### # ### ### ### # # # ##### # ### ### ### # ### ######### # # ######### # ###
# #   #   #     #           #     # #     # #   # # #   #     # # #   #   #     # # # # #   #   # #   #       #   #       #   #   #
# ######### ### ##### ########### # ####### # ### # # ######### # # ######### # # # # # ##### ### ##### ##### # ######### # ### # #
# #   #   #   #     # #     #     #   #     # #   # # # #         # #       # #   # # # #   #   #   #   #   #   #       #   # # # #
# # ### # # ####### # # ### # ##### # # ##### # ### # # # ######### # ##### ####### # # # # ### # # # ### # ##### ##### ##### # # #
# #     #   #       # # # #   #   # # #         #   # # # #         # #   #     #   #     #     # #   #   #   #       #   #     # #
# ##### ##### ####### # # ##### ### # # ######### ### # # ######### # # ####### # ############### ##### ##### # ##### ### # ##### #
#     #     #   #   #   # #       # # #   #     #   #   #   #     # # #       # #         #       #   # #   # #   #   #   # #     #
##### ##### ### # # ##### # ##### # # ##### ### # # ### ### # ### ### ####### # ##### ### # ####### # # # ### ##### ### ### # #####
#   # #   #   #   #     #     #   # #   #   # # # #   #   #   # #   #   #   #   #   # #   # #       #   #   #       #   #   #     #
# ### # ##### ####### # ##### # ### ### # ### # ### ##### ##### ### ### # # # ### # ### ### # ##### ##### # ######### ### ####### #
#     #   #   # #   # # #   # # #   # #       #   #     #     #   #   #   # #     #   #   # # #     #   # #         # # #     # # #
# ##### # # ### # # ### # # # # # ### ########### # ### ##### # ##### ### # ######### # # # ### ##### ### # ##### ### # ##### # # #
#     # # #     # #   # # # # # #   # #           #   #   #   # #   #   # #   #   #   # # #   # #     #   #   #   #   #       # # #
##### ### ##### # ### # # # ### ### # # ####### ####### # # ### # # ### ##### # # ### ### ### # # ##### ##### # ### ### ####### # #
#   #   #   #   # #   #   # #   #   # #   #     #     # # # #   # #     #     # #   #     # #   #       #     #   #   #         # #
# ##### # ### ### # ####### # ### ### ### # ##### ### # # # ### # ####### ##### ### ####### ##### ####### ####### ### ####### ### #
#     # #       # # #       # #   #   # # # #   # # # # #       #   #   # #       # #           #   # #   #   #   #   # #   # #   #
# ### # # ####### # ### ##### # ### # # # # # # # # # ####### ##### # # # # ####### # ##### # ##### # # ### # ##### ### # # # # ###
#   #   #   # #   # #   #     #   # #   # # # #     #     #   #   # # #   #   # #   # #   # # #     # #     #       #     #   #   #
### ####### # # ### # ### ### ### # ### # ### ####### ### # ### # # # ### ### # # ### ### # ### ##### ########################### #
#   #     # # #   # #   # # #     #   # #       #   #   # # #   # # # #   # #   # #       #   #   #       #     #       #         #
# ##### ### # ### # ### # # ####### # # ######### # ##### # # ### # # # ### ### # ########### ### ##### # # ##### # ### # ####### #
# #   #     #   # # #   # # #     # # # #       # #       # # # #   # #       # #           #   #   #   # #       #   #   #     # #
# # # # ####### # # # ### # # # ### # # # ##### # ######### # # ##### ######### ########### # ##### # ### # ######### ##### # ### #
#   # # #       # # # #   #   #     # # #   # # #   #   #   # #                 # #       # #     # #   # #   #     # #     # #   #
##### # # ####### # # # ############# # ### # # ### # # # ### # ########### ##### # ##### # # ### # ### # ### # # # # ### ##### ###
#     #   #     # #   # #           # # #   # #     # # # #   #     # #   #   # #   #     # #   # # #   # #   # # # # #   #     # #
# ######### ### # ##### # ######### # # # ### ####### # # # ####### # # # ### # # ### ##### ##### # # ### # ##### # # # # # ##### #
# #         #     #   # # #       #   # # #         # #   # #     #   # # #   #     # #     #     #   #   #       # # # # # #     #
# ### # ########### # # # ##### # ##### # # ######### ##### # ### ##### # # ### ##### # ##### ### ##### ####### ##### # ### ##### #
#   # #     #   #   # # #     # #   # # # #         #     #   # #       # #   #   #   # # #   #     # #   #   # #     #   #   #   #
### # ##### # # # # ### ##### # # # # # # ##### ### # ######### ######### ### ##### ### # # # ##### # ### # # # # ####### ### # ###
# # # #     # # # #   #   #   # # #   # #     #   #   #         #       #   #   #   #   #   #     #     # # #   # #         # #   #
# # ### ##### # ##### ### # ### # ### # ##### ### ##### ##### # ####### ### ### # ### ######### # ##### # ####### # ####### # ### #
# # #   #     #     #       #   # #   #   # #   #     #   # # #           #   # #   #   #     # #   #   #         #   #   # #   # #
# # # ### ######### ########### # ####### # ### ##### ### # # ####### ####### # ### ### # ### # ### ################# # # # ### # #
#   #           # #           # #       # #   # #     #   # # #       #       #     # # # # # #   # #     #           # #   #   # #
# ############# # ########### # ####### # ### # ####### ### # ##### ### ########### # # # # # ##### # # # # ##### # ######### ### #
# #     #     #   #     #     #       #       #       # #   #     # #   #   #         #     # #   #   # # #     # # #       # #   #
# ### # ### # ### # ##### ####### ################### # ### ##### # # ### ### ############# # # # # ### # ### ### # # ##### # ### #
#     #   # #       #     #     # #         #         #   #     # # # #           #       # #   # # # # #   # #   # # # #   #   # #
######### # ######### ##### # ### # ####### # ### ####### # ### # ### # ########### ##### ### ### # # # ### ### ### # # # ##### # #
#     #   # #     #   #     #     # #     # #   # #       # #   # #   # #   #       #   #   #   # #   #   # #   #   #   #       # #
# ### # ##### ### # ### ########### # ##### ### ### ######### ### # ### # # # # ##### # ### ### # ##### # # # ######### ######### #
# #   # #     # #   #   #   #     # #   #       #   #       #   # #   #   # # # #     #   # #   #     # # #   #       #     #   # #
### # # # ##### ######### # # ### # # # # ####### ### ##### ### # ### ####### # # ####### # ####### # ### ##### ### ####### # # # #
#   # #   #           #   #   # # # # #   # #     #   #   #   # #   #     #   # #   #   # #       # # #   #     # #     #   # #   #
# ######### ######### # ####### # # ##### # # ##### # # # ### # ### ##### # ####### ### # ####### ### # ### ##### ##### # ### ### #
# #     # #       #     # #     # #     # # #   # # #   #   #     #       #   #       # #     # # #   # #   #   #   #   #   #   # #
# # # # # # ##### ####### # ### # ##### # # ### # # ####### ##### ######### # # ##### # ##### # # # ### # ### # # # # ##### ### ###
# # # # #       #     #       #   #   # #   #   #   #       #   # #         #   #   #     #   #     #     #   #   # #     #   #   #
# # # # ##### ##### # ########### # # # ##### ### ### ####### # # ########### ### # ##### # ######### ##### ##### # ### # ### ### #
#   # #     # #   # # #         #   #   #     #   #   #     # # #           #   # # #   # #     #     #     #   # #   # # # #   # #
##### ##### ### # ### # ####### ######### ##### ### ### ### ### ########### ##### # # ### ##### # ##### ##### # ### # # # # ### # #
#     #   #     #   # # #     #   #       #     # #       # #             #   #   # #         # #   #     #   #   # # # #     #   #
# ##### ##### ##### # # # ### ### # ######### ### ######### # ##### ######### # ### ########### ### ##### # ##### # # # ######### #
# #   #       #   #   # #   # #   #   #     #       #       #   #   #       # #   #             # #   #   # #   #   # #   #       #
# # ### ####### # # ### # # ### ##### # ### ####### # ####### # ### # ### # # # # ############### ### # ### # ####### ### # #######
# #       #     # # #   # #   #   #   #   #   #     #     #   #   # # # # # # # #   #       #     #   # #   #       #   # #       #
# # ####### ##### ### ### ### ### # ##### ### # ######### ### ### ### # # ### # ### ##### # ### # # ### # ### # ### ### # ####### #
# #   #   # #   #   # #   #     #   #   # # # #   #     #   # # #     # #     #   #     # #     # # #   #   # #   #   # #       # #
# ### # # # # # ### # # ### ######### # # # # ### # ### ### # # ####### ######### ##### # ####### # # ##### # ### ##### # # ##### #
#   # # #   # # # #   #   #           # # # #   # # #     # #   #               # #     #       # # # #     # # #     # # # #     #
# # ### ##### # # ####### ######### ### # # ### # ### # ### ### ######### ##### # # ### ##### # ### ### ##### # ##### # # # # #####
# #     # #   #   #         #       # #   #     #   # # #   # #     #     #     # #   # #   # #   #   #     #     #   # # # #   # #
# ####### # # ##### ####### # ####### ##### ####### # # # ### ##### # ##### ######### ### # ##### ### ### # ##### # # # # # ### # #
# #         #       #     # #   #         #   #   # # # #   #         #     #       #   # #   #     #   # # #   # # # # # #   # # #
# # ################# ### ##### ### ##### ### ### # # ##### ########### ##### ##### ### # ### # ### ### # # ### # # ### # ##### # #
# # #         #   #   #   #   #   # #   #   #   # # #     #       #   #       #   # #   #   # # #   #   # #   #   # #   #       # #
# # ### ##### # # # ### ### # ### # # # ### ### # # ### # ####### # # ######### ### # ### ### # ##### ### ### # ### # ########### #
# #   # # #   # # # #       #   # #   #   #   # #   #   # #       # #     #       # #     #   # #     #     # # #   #     # #     #
# ### # # # ### ### ########### # ##### # ##### # ### ##### ####### ##### # ##### # ##### # ### # ########### # # # ##### # # ### #
# #   # # # #     #     #     # #     # #       #     #   # #     #     # #   # # #     # # #     #           # # # # #   #   #   #
# # ### # # ##### ##### ##### # # ### ##### ########### # # # ### # ### # ### # # ##### ### ##### ### ########### # # # ##### # # #
# # #   #         #     #   # # #   #     #           # #   #   # # #   #   #   #     #   #     #   # #           #   #     # # # #
# # ### ####### ### # ### # # # ######### ########### # ####### # # # ######### # ####### # ### ### # # # ################# ### # #
# #   #       # #   # #   # # #   #     #   #       #   #       #   #   #     # #     #   # # # # #   # # #     #     #     #   # #
# ### ####### # # ##### ### # ### # ### ### # ### # ##### ############# # # # # ##### # ### # # # ##### ### ### # ### # ##### #####
# #     #     # #       #   #   #   # # #   # # # # # #   #     #     # # # # #   # # # #     # #         # # # #   # #   #       #
# ##### # ############# # ##### ##### # # ### # # # # # ### ### # # ### # # ##### # # # ####### # ####### # # # ### # ### ####### #
# #   #   #           # #     #   #     # # #   # #   # #   #   # #   # # #     #   # #       # # #   # # # # #   # #     #     # #
# # # ##### ######### ####### # ### ##### # ### # ##### # ### ####### # # ### ##### # ####### # # # # # # # # ### # ####### ### # #
#   #       #                 #           #     #         #           #     #       #           #   #   #       #           #     #
###################################################################################################################################
