###########################################################################################
#   #             #       #     #   #     #       #     #     #   #               #   #   #
### # ### ####### # ##### # ### # # # ### # ### ### # ### # # # # # ####### ##### ### # # #
# # # # # #     # #   # #   #   # #   # #     #     # #   # # # #   #     #   # #   #   # #
# # # # # # ### # ### # ##### ### ##### ########### # # ### # ### ####### ### # ### ##### #
#   # # # # # # # #     #   #   #     #     #     # # # # # #   #         #   #   #   #   #
# ### # # # # # # # ##### # # # ##### # ### # ### ### # # # ### ######### # ### # ### # # #
#   #   #     # # # #   # # # #     #   #   #   #   #     # # #         # # #   #   #   # #
### ########### # ### # # # # # ######### ##### ### ####### # ######### ### # ########### #
# #             #     #   # # # #     #   #     # #     #   #     #   # #   #         #   #
# ######################### ### # ### # ### ##### ##### # ### ##### # # # ########### # ###
#         #               #   #     # #   # #   #       # #     #   #   # #     #   #   # #
# # ##### # ##### ### ### ### ##### # # ### # # # ####### ### # # ####### # ### # # # ### #
# # # #   # #   #   #   #   #     # #   #   # # #   #       # # #   #       #   # # # #   #
# # # # ### # # ### ### # ####### # ##### ### ##### ####### ### ### # ####### # # # # ### #
# # # # # # # #   # #   # #       #   #   # #     # #   #   #     # #   # #   # # # #     #
### # # # # # ### ### ##### ####### ### ### # # ### # # # ### ##### ### # # ### # # ##### #
#   #   #   # #       #   #     #   #   #   # #   #   #   #       #   #   # #   # # # #   #
# ### ####### # ####### # ##### # ### ##### # ### ######### ##### ### ##### ##### # # # ###
#   #         #   #     #   #   #   # #     # # #       #   #   #   #     #     # # #   # #
# # ########### ### ##### ### ### ### # ### # # ### # ### ##### ### ##### # ### # # ### # #
# #           # #   #   #   #   # #   #   # #     # # #   #       #       #   #   #   #   #
# ########### # # ### # ### ### ### ##### ####### # # # ##### ### ########### ####### ### #
#   #   #   # # #   # #   #   #   #     #         # # #       # # #           #     #   # #
### # ### # # ##### ##### ### ### ##### ####### ### ########### # # ######### # ### # # ###
# # #   # #   #   #     #   #   #       #     # # #           #   # #       # # # # # #   #
# # # # # ##### # ##### ### # ########### ### # # ######### # # ##### ##### ### # # ##### #
#   # # # #     #       #   # #           # # #     #       # #       #   #     # #     # #
# ##### # # ############# # # # ####### ### # ##### # ####### ########### ####### ##### # #
#     # #   #     #   #   # # # #     # #   # #     # #   # #   #       # #     #     #   #
##### # ####### # # # ### # # # # ##### # ### # ##### # # # ### # ##### # # ### # # ##### #
# #   #     #   # # #     # #   # #   # # #   #     # # #     #   #   # # #   #   #   #   #
# # ### ### # ### # ####### ##### # # # # # ####### # # ########### # # # ### ####### # ###
#   #   # # # #   #   #   #     # # # # #     # #   # #         #   # #     #   #     # # #
# ### ### # # # ##### ### ##### # # # # ##### # # ### # ####### # ### ##### ### # ##### # #
#   #   # # # #   #   #     #   #   # #   #   #     # # #       #   #   #   #   #       # #
### # # # # # ### # ### ##### ####### ### # ######### # # ####### ##### # ### ########### #
#   # # # #   #   # #       # #   #     # # #     #   # #   #     #     # #   #       #   #
# ##### # ##### ### ##### # # # # # # ### # # ### # ### ### # ##### ##### # ### ### # # # #
#       #     #   # #   # #     # # # #   # # #     #     #   #   #       #   #   # # # # #
########### ##### # # # ######### # # # ### # ############### # ############# ##### # # # #
#           #     #   #     #   # # # #   # # #             #   #       #     #     # # # #
##### ####### ####### ##### # ### # ##### # # # ########### ##### ##### # ##### ##### # # #
#     #       #     # #     #   #   #     # # #   #     # #           # # #     #     # # #
# ### # ######### # ### ####### ### # ##### # ### ### # # ############# # # # ####### ### #
#   # # #       # #   #       #     # #         # #   #   #       #     # # #   #   # #   #
# # # # ### ### # ### ####### ##### # ########### # ####### ##### # ### # # ### # # # # # #
# # # # #   # # # # #   #   #     # #   #         # #       #   # #   # # #   #   # # # # #
### # # # ### # # # ### # # # ### # ### # ######### # ######### # # # # # ######### # # # #
#   # # # #   #   #   #   # # # # #   #   # #       #   #     # # # # # #     #     #   # #
# ##### # # # ##### # ##### # # # ### ##### # ##### ### # ### # # ### # ##### # ##### #####
#     #   # #     # # #   # #   # #   #   # # #   #   #   # # #       #   #   #   #   #   #
# ### ##### ### # # ### # # ##### # ### # # # ### ### ##### # ############# ##### ##### # #
#   #       #   # # #   # #     # # #   # # #       # #     # #   #       #     #     # # #
### ######### ### # # ### ##### # # ### # # ### ##### # # ### # # # ##### ##### ##### # # #
#   #   #   # #     #   #     #   #     # #   # #   #   #   # # #   #   #     #     #   # #
# ### # # # # ##### ### ##### ########### # # # # # ### ### # # ##### # ### ####### # ### #
#   # #   # #   #     # #   #         # # # #   # #   #   # #   #   # #   #       # # #   #
### # ##### ### # ##### # # ####### # # # ### ### ### ### # ##### # ### # ####### # ### # #
#   # #     # # # #       #       # #   #   #   # # #   # #   #   #   # # #       #   # # #
# ### # ### # # ### ########### ### ####### ##### # ### # # ### # ### # # # ######### # ###
# #   # #   # #         #   # # #   #     #       #   # # #     #   # # # #           #   #
# ##### # ### ####### ### # # # # ### # ########### ### # ######### # # # ############### #
# #   # #     #     # #   # #   #     #       #     #   # #   #   # # # #   #   #         #
# # # # ##### # ### ### ### ##### ########### # # ### ##### # # # # # ### # ### # ### #####
#   #   #   # # # #     # #     #     #   #   # #   # #   # #   # # #     #   # #   #     #
######### # # # # ####### ##### # ##### # # # # ### # # # # ##### # ######### # # ####### #
#     #   #   # #   #       # # # #   # # # # # #   #   #   #   #   #   #     #   #   #   #
# ##### ####### # # # # ### # # ### # # # # ### # ########### # ##### # # ####### # # # # #
# #     #       # #   #   #   #   # # # # #     #       #   # #     # # #   #   # # #   # #
# # ##### ####### ####### # ##### # # # # ########### ### # # # ### # # ### # # # # ##### #
# # # #   # #     #   #   # #   #   #   # #           #   #   #   # # #   #   # # #     # #
# # # # ### # ##### ### ##### # ######### # ### ####### ######### ### ### ##### # ##### # #
#   # # #         #   #       #       #     # # #       # #     #   #   #       # #   # # #
# ### # # ####### ### ############# ### ##### # # ####### # # ##### ### ######### # # # # #
# #   # # #     #           #     #     #   #   #       #   # #       #   #   # # # # # # #
# ### # ### ### ############# ### ##### # # ########### ##### # ##### ### # # # # # # # ###
#   # # #   # #           #   # #     # # #           # #     #     # # #   # # # # # #   #
### # # # ### ########### # ### ##### # # ######### ### # ######### # # ##### # # ### ### #
# # # # #   #     #   #   #   #     # # # #       #   # #         # # #     # # #   #   # #
# # # # ### # ### # # # ##### ##### # ### ### ### ### # ##### ##### # # # ### # ### # # # #
#   # #     #   # # #   #     #   # #   #   #   # #   #     #   #   #   # #   #       # # #
# ### ########### # ##### ##### # # ### ### ##### # # ##### ### # ####### # ### ######### #
# #   #         # #       #     #   # # #   #     # # #   #     #   #   # #   # #         #
# # # ####### # # ######### ### ### # # # ### ##### # # # ##### ### # # # ### ### ####### #
#   #         # #           #   #   # # #   # #     # # # #     # #   # # # #     #     # #
############### ############# ### ### # ### # # ##### # # # ##### ##### # # ########### # #
#             # #     #     # #   #   #   # # # #   # # # #   #   # #   #               # #
# ####### ##### # ### # ### # # ### # ### # # # # # ### # ### # # # # ################### #
#       #         #     #     #     #   #     #   #     #       #   #                     #
###########################################################################################
