###############################################################################################################
#       #       #           #   #   # #         #   #   #     #   #   #             #           #       #   # #
####### # ##### # ####### # # # # # # # ##### # # # ### # # ### # # # # # ######### # ######### # ##### # # # #
#       # #   # # #       #   #   # #     #   # # #   #   #   # # # # # #     #   #   # #   #   # #   #   #   #
# ######### # # # # ############### ##### # ### # ### ####### # # # # # ##### # ####### # # # ### # # ####### #
# # #       #   # #   #       #   # #   # # #     #       #   # #   # # #   # #         # #   #     #       # #
# # # # ####### # ### # # ### # ### # # # # ####### ##### # # # ##### # # ### # ##### # # ##### ########### # #
# #   # #     # # #   # # # # #   #   # # #     #   #   #   # #   #   # # #   #   # # # # #   #   #         # #
# ##### # # ### # # ### # # # # # ##### # ##### ##### # ######### # ### # # ##### # # # # # # # ### ######### #
#   #   # #     # #   # # # # # #     # #   # #       # #     #   #   # # # #   #   # # #   # # #   #   #   # #
### # ####### ### ### ### # # ##### ### ### # ######### # ### # ##### # # # # # ##### ####### ### ### # # # # #
# # # #     #   #   # #   #       # #   # #       # #   # # #   # #   #   #   # #     #     #   #   # #   # # #
# # # # ### ##### ### # ######### # # ### ####### # # # # # ##### # ##### ##### # ##### ### ### ### ####### # #
#   #     #       #   #     #   # # # #             # # # #   #   #     # #   # #       # #     #   #     #   #
# ####### ######### ### ### # # # # # ### ######### # ### # # ### ##### # ### # ####### # ####### ### ### #####
#       #   #     # #     #   # #   #   #   #   # # #   # # #     #   # # #   #       #   #     #   #   #     #
####### ### ### # # ### ####### ### ### ### # # # # ### # # ##### # # # # # ######### ### # ### ### ### ##### #
#     #   #     # #   # #       #     #   # # # #   #   #   #   #   # #   #       #   #     # #     # # # #   #
# ####### ####### ### ### ####### ####### ### # ##### # ##### ####### ##### ### ### ######### ##### # # # # ###
#         #     # #   #   #         #   #   # #   #   #   #         # #       #   #         #     #   #   #   #
# ######### ### # # ### ############# # ### # ### # ####### ##### ### ####### ### ######### ### # # ##### ### #
# #       # #   # # #     #           #   #   #   # #       #   #   #     # # # #         #   # # # #       # #
# ### ### # # ##### ##### # ############# ##### ### # ######### ### ##### # # # # ####### ### ### # # ####### #
#     # #   #     # #   # # #   #       #     #   # # #         # #       # #   # #     # # #   #   # # #     #
####### ######### # # # # # # ### ##### ##### ### # # # ####### # ######### ### # # ### # # ### # ### # # #####
#   #     #     # #   # #     #   # #   #   #       #   #     #   #       #     # # #   #     # #   #   #     #
# # # # ### ### # ### # ##### # ### # ### # # ############### ### # ### ### ##### # # ####### # ####### ##### #
# # # #     # # #   # #     # # #   # #   # # # #       #       # # # #     #   #   #   #     # #     # #   # #
# ### ####### # ### # ##### # # # ### # ### # # # # ### # # ##### # # ####### # ####### # ##### # ### # # ### #
# #   #       #     #     # # #   #   #   # #   # #   #   # #     #   #       #         # #     # #   # # #   #
# # ### ##### ####### ##### ##### # ##### # ##### ### ##### # ######### ################### ##### # # # # # # #
# #   # #   #     # # #   #     # #       #     # #   #   # #           #   #     #         #     # # #   # # #
# ### # # # ##### # # # # ##### # ############# # # ### # ########### ### # # ### # # ####### ##### ##### # ###
#   # # # #       #   # #   #   #   #     # #   # #     #         #   #   # #   #   # #           #       #   #
# # # # ##### ######### ### # ##### # ### # # ### ######### ##### # ### ### # # ####### ######### ########### #
# # # #     #           #   #     # #   #   #   #     #   # #     # #   #   # #           #     #   #     # # #
# ### ##### ############# ##### # # ### ####### ##### # # # ####### # ### ### ########### # ### ### ### # # # #
# #   #     #   #       #     # #     # #     #     #   # # #   #   # # # #       #     # # #   #       #   # #
# # ### ##### ### # ######### # ##### # # ### ### ####### # # # # ### # # # ####### ### ### # ####### ####### #
# # #     #   #   #         # # #   # #     #   #       # #   #   #   #   #   #     # # #   #     #   #       #
# # ##### # ### ####### ##### ### # # ####### # ####### # ######### ### ####### ##### # # ####### # ### ##### #
# #   #   #   #     #   #   # #   # #     #   #   #   #   #   #     #           # #     # #     # # # #     # #
# ### # ### # ### ### ### # # # ### ##### # ##### # # ##### # # ################# # ##### # ### # # # ##### ###
#   #   #   #     #   #   #   #   #     #   #     # # #     # #       #       #     #     # #   # #     # #   #
# # ##### ######### # # ######### ##### ##### ##### # # ##### # ##### # ### # # ##### ##### # ### ##### # ### #
# #     #     #     # #     #     #   #   # # # #   #   #   # # # #   # #   # # #     #     # #   #         # #
# ##### ##### # ########### # ####### ### # # # # ####### # # # # # ##### ##### ##### ### ### # ### ####### # #
# #       #   # #         #   #       # # #     #   #   # #   # # # #   #       #   #   #   # #   # #   #   # #
### ##### # ### # ##### # ##### # ### # # # ##### # # ### ##### # # # # # ##### # # ### ### # ### ### # ##### #
#   # #   # # #   #     # #     # #     # # #   # # #     #     # #   # # #   #   #   #   # # #   #   #       #
# ### # ### # ##### ### ### ##### ##### # # # # ### # ######### # ##### ### # ####### # # # ### ### ######### #
# # #     #   #   #   # #   #   #     # # # # #     #   #     #   #   #   # # #   #   # # #     #   #     # # #
# # # ####### ### ### ### ##### ##### # # ### ######### ### # ### # # ### # # ### # ##### # ##### # # ### # # #
# #     #           # #   #         # # #     #       #   # #   #   # # #   #   # #       #   # # # # # # #   #
# # ##### ########### # ### # ####### ######### ### # ### # ### ##### # ####### # ########### # # # # # # ### #
# #   #       #       # #   # #     #         #   # # #   #   # #     # #     # #     #     # #   #   # #   # #
# ##### ####### ####### ##### # ### ######### ### # ### ### # # ### ### # ### # # # ### ### # # ####### ### # #
#       #     # #     # #   # #   #   #         # #   # #   # #   # #   #   #   # #   #   # # #   #     # # # #
# ####### ### # # ### # # # # # ### # # ######### ### # ### # ### # ### ### ######### ### # # ### # ### # # ###
#     # # #     # #   #   # # # #   # #     #       # #   # # # # #     #   #     #     # # #   # # # # # #   #
##### # # # ##### # ####### # # # ### ##### # ####### ### # # # # # ##### ### ### # # ### # ### # # # # # ### #
#   #   # # #     # #   #   #   # #     #   # # #     #   # # #   # #   # #     #   # #   #   # # # #     #   #
# # # ### # # ##### # # # ### ### # ##### # # # # ### # ##### ### ### # # # ### ####### ### ### # # ####### # #
# #   #   # #     # # #   #   #   #   #   # #   # #   # #   #   #     # # # # #           #   # #   #     # # #
# ##### ##### ##### # ##### ### ##### # ####### # ##### # # ### ####### # # # ########### ### # # ### ### # # #
#   # #       #     # #   # #   #   # # #       #     #   # #   #         #   #       #   # #   # #   #   # # #
### # ######### ##### # ### # ### # # # # ########### ##### # ########### ##### ##### # ### ####### ### ### # #
#   #         #     # # #   # # # #   #   #   #       # #   # #         # #     #     # #     #     #   #   # #
# ########### ##### # # # ### # # ########### # ##### # # ### # ####### ### ##### ##### # # # ### ### ### ### #
#                 #   #   # # # #   #         #   # #   # #     # #   #     #   # #     # # #     #       # # #
################# ##### ### # # ### # ####### ### # ### # # ##### # # ####### # # # ##### # ############### # #
#     #         #   # # #   # #   # # #     # #   #     # #     #   #         # # # # #   #         #         #
### # ##### ####### # # # ### # ### # # ### # # ##### ### ##### ####### ### ##### # # # ########### ###########
#   #   #   #       #     #   #     #   #   # # #   #   # # #   #   #   #   #   # # # # #         # #     #   #
# ##### # ### ############# ### ##### ### ### # # # ##### # # ### # # ### ### # # # # # ####### ### # ### # # #
# #     # #   #         #   # # #     #   # # #   #       # # #   #   #     # #   # #   #       #   # # #   # #
# ### ### # ### ####### # ### # ####### ### # ############# # # # ##### ##### ##### # ### ####### ### # ##### #
#   # #   #   #   #     #   # #     #   #   #     #   #     # # # #   #   #   #     #     #     #   #       # #
### # ### ### ### ##### ### # ##### # ### # ##### # ### # ### ### # # # ### ### ########### ### ### ### ##### #
#   #   #   #   #     #   # # #     # # # #     # #   # #     #   # #   #   #       #       # #   #     #     #
# ##### ### ### ### # ### # # # ##### # # ##### # ### # ####### ####### # ######### # ####### ### ####### ### #
#     #       #   # # # # # # #     # #   #   # #     # #   #   #     # # #   #   # # #         #   #     # # #
# ### ### ####### ### # # # # ##### # ### # # # ##### # ### # # # ### # # # # # # # # # ####### ### # ##### # #
#   # #   #     #     #   # # #     #   # # # #   #   #   # # # #   # # #   # # # #   #       #   #   #       #
### # ##### # ######### ### # # ####### # # # # ### ##### # # # ### # ####### ### ##### ##### ### ##### #######
#   #       # #     #   #   #     #     # # # #     # #   # # #   # #       #   #           # # #   # # #     #
# ########### # # # # ### # ##### ### ##### # ##### # # ### # ### # ### ### ### ########### # # ### # # ##### #
# #   #     #   # # # #   #     #   #       #     #   #   #     #     #   # # #       # #   # #     # #       #
# # # ##### ##### # # ### ##### ### ##### ####### ####### ############### # # ####### # # ### ### ### ####### #
#   #   #   #     # #   # #     #   #   #   #   #       # #             # #   #   #   # #   #   # #         # #
####### # ### # ####### ### ##### ### # ### # ####### # # # ########### # ### # # # ### ### ### # # ### ##### #
#   #   # #   # #     #   #   # #     # #   #       # # # # #     #   #   #   # #   #       # # #   #   #     #
# # # ### # ### # ### ### ### # ####### # ######### # ### # # ### # # # ####### ##### ####### # ##### ### #####
# # #     #   # # #     #     # #       #       #   #     # # #   # # # #       # #   #       #   #   # # #   #
# ####### ### ### # # ######### # ############# # # ####### # ##### # # # ####### # ####### ##### # ### # # ###
#         # # #   # # #       #   #         #     # #   #   #       #   # #       #       #     # # #   # #   #
# ######### # # ### ### ##### # ####### ### ####### # # ### ############# # ##### ####### ### # # # # # # ### #
# #       # #     #   #   #   #         # # #     #   #     #         #   # #     # #         # # #   # #     #
# # ##### # ######### ### # ############# # # ### ######### # ####### # ### ### ### # ########### ##### ##### #
#   #   #   #       #   # #       #       #   # # # #       #       #   # #   #   # # # #       # #   #     # #
####### ### # ##### # # # ##### ### ##### ##### # # # ############# ##### # # ### # # # # ##### # # # ##### # #
#     # #   #     #   # #   # # #   #   #       # #   #     #     #   #   # # #     #   #     #   # #     # # #
# ### # # ####### ######### # # # ### ######### # ##### ### # ### ### # # # # ######### ##### ### # ##### ### #
#   # # # #     #     #     # #   #       #   #   #     #   #   #     # #   # #       # #   # #   # #     #   #
# # # # # ### # ##### # ##### ######### # # # ##### ##### ### # ####### ##### # ### ### # ### # ### # ##### ###
# # #   #     # #   #   #               #   #     # #   #   # #   #   #   #   #   #     # #   # #   #     # # #
# # ########### ### ##### ####### ############### # # # ### ##### ### ### # ##### ####### # ##### ####### # # #
# #       #   # #       #       # #   #   #     #   # #   # #   #   #   # # #     #   #   # #   # #   # #   # #
# ####### # # # # ##### ######### # # # # # ### ##### ##### # # ### # ### # # ##### # ### # # # # # # # ##### #
#       #   #     #               # #   #     #               #     #     #         #     #   #     #         #
###############################################################################################################
