#######################################################################################################################################################
#     #   #           #       # #         #           #             #         #     #           #           #     #               #         #       # #
##### # # ### ####### ##### # # # ####### # ##### ### # ##### ##### ####### # # # # ### ####### # ######### # # ### # ########### ##### # ### # ### # #
#   # # #   #     #   #     # #     #     #   #   #   #     #     # #     # # # # #   # #       # #       # # #     # #         #     # #   # # #   # #
# # # # ### ##### # ### ##### ####### ##### ### ### ####### ##### # # ### # # # # ### # # ######### ##### # # ####### ### ##### ##### # ### # # # ### #
# # # #   #     # #   # #   # #       #     #   #   #   #     #   # # #   # #   # # #   # #         #   # #         #   # #   #     # #   # # # #     #
# ### # # ##### # ### # ### # # ####### ##### ### ##### # ##### ### # # ######### # ##### ### ####### ### ############# # # ##### ### ##### # # ##### #
# #   # # #       #   #   #   #       # #     # #       # #     #   # #         # #         #   # #   #   #       #     # #     # #   #   #   #   # # #
# # ### # # ######### ### # ######### # # ##### ####### # # ##### ### ######### # ######### ### # # # # ### ##### # ##### # ### # # ### # ####### # # #
#   #   # # #       #   # #         # # #     #         # #   #   #   #       # #         # #   #   #   #     #   # # #   #   #   #     #     #   #   #
# ### ### ### ##### ### # ######### # # ##### ########### ### # ### # ##### # # ######### # # ### ####### ### # ### # # # ################### # ### ###
# #     #         #   #   #   #     # #     #               # #   # # #   # # #           #   # #   #     # # #     # # #   #               # # #     #
# # ################# ####### # ##### ##### ############### # ### # ### # ### ################# ### ### ### # ####### # ### # ##### # ####### # #######
# # #         #     #   #   # # #   #             #       # #   #   #   #   #                 #   #   #   # #     #     # # #     # # #       #       #
# ### ####### # ### ### # # # # # # # ############# ##### # ### ##### ##### # ####### ####### # # ### ### # ##### ##### # # ##### # ### ####### ##### #
# #   #     # #   #     # #   #   # # #         #   #     # # #         #   #   #   # #   #   # #   # #   #     #     #   #       #   #   #   # #     #
# # ### # # # ### ####### ######### ### ####### # ### ##### # ########### ##### ### # # # ### # # ### # ### # ####### ### ########### ### # # # # ### #
# #   # # # #   #   #       #     # #   #     #   #   # #   #       #   #   #       #   #   # # #     #     # #       #   #     #   #   # # #   #   # #
# ### # # # ### ### ####### # ### # # ### # # ##### ### # ### ### # # # ### # ##### ####### ### ############# # ####### ### # ### # # ### # ####### # #
#     # # #   #     #       #   # #   #   # # # #   #   # #   #   # # #     # #   #   #   #                 # #     # #     # #   # #   # # #     # # #
####### # # ######### ####### ### ##### ### # # # ### # # ##### ### # ######### # ##### # ################# ####### # ####### # ### ### # # # ##### # #
#   #   # # #       #   #     #       # #   #   # #   # #       #   #     #     #       #       #   #   #   #       # #     # # #   #   # #   #   # # #
### # ### ### ### # # # # ##### ####### # ####### # ### ######### ####### # ################### # # # # # ### ####### # ### # # # ### # # # ### # # ###
#   #   # #   #   # # # # # #   #     # #       # #   #           #     #   #   #   # #       #   #   # # #         #     #   # #   # # # # #   # #   #
# ##### # # ### ##### # # # # ### ### # ####### # ####### ########### # ##### # # # # # # ### ##### ### # ######### ########### ### # ### ### ### ### #
# #     #   # # #     # #   #       # #       #   #     #   #     #   #     # #   # #   # #   #   # #   #           #         #   # #   #     # #     #
# # ######### # # ##### # ######### # ####### ##### ### ### # ### # ####### # ##### ##### # ### # ### ############# # ####### ### # # # ####### ##### #
# #       #   #   # #   # #       # #       #       #   # #   #   #       #   #   #       # #   #     # #   #   #   #     # #     # # #       #       #
# # ##### ### ##### # ### # ##### ### # ############# ### ##### ### ##### ####### ######### # ######### # # # # # ####### # ####### # ####### # #######
# # #   #   #     # #     #   # #   # # #           # # #     # #   #   # #       #         # #     #     #   # #       #       #   # #       #       #
# # # # ### # ### # ######### # ### # # # ##### ### # # # ### # # ##### # ##### ### ######### # # # # ######### ####### # ##### # ### # ############# #
#   # # #   # #     #     # # #   # # # # # #   #   # #   #   # #     # #     # #   #   #     # # # # #     # #         # #   # # #   #             # #
##### # # ### ##### # ### # # # # # ### # # # ##### # # ### ### ##### # ##### # # ### # # ####### # # ### # # ########### # # ### # ########### ### # #
#     # # #     # #   # #   # # # # #   #   # #   # # #   # #   #   # #     # # # #   # #     #   # #     # #       #     # #     #     #     #   # # #
# ##### # ### # # ##### # ### # ### # ##### # # # # # ##### # ##### # ### # # # # # ### ##### # ### ####### ### # # # ##### # ######### # # # ### ### #
# # #   #   # # #       # #   #     #     # #   # # #   #   # #     # #   # # #   #   #       # #     #   #   # # # # # #   # #       # # # # #   #   #
# # # ##### ### # ##### # # ### ##### # ### ##### # ### # ### # # ### # ### # ####### ### ##### ##### # # ### ### # # # # ##### ##### # ### ### # # ###
# # #   # #     #   #   # # #       # #         # #   # #   # # #     #   # #   #     #   #   #   #   # #   #     # #   #     # #   # # #   #   # #   #
# # ### # ####### # # ### # ####### ############# ##### ### # ####### ### # ### # ######### # ### ##### # ######### ### ##### # ### # # # # # ####### #
# #   # # #       # #   # #   #   #             #   #   #   #       #     # #   # #         #   #   #   #         # #   # #   #     # #   # #     #   #
# # # # # # ####### ##### ### # # ####### ##### # # # ### ######### ######### ### # ########### # # # ####### ##### # ### # ####### # # ######### # ###
# # # # #     #   # #   #   #   # #       #   # # # #   #         #         # #   #   #         # #   #   # #   #   # #   #   #     # # #       # #   #
# # # # ##### ### # # # ### ##### # ##### # # # ### ### # ##### # ######### # # ##### # ######### ##### # # ### # ### # # ### # ##### # # ##### # ### #
# # # #     #     #   #         # # #   # # # #   # #   # #   # #         # # #       # #     # # #     #   # # # #   # #   # # #     # #   #   #   # #
# # # ##### ##################### ### # ### # ### # # ### # # # ##### ##### # ######### # ### # # ##### ### # # # # ### # # # # # ##### ### # ### # # #
# # # #   #                   #   #   #     #   #   # #     # # # #   #     #         #   #   #     #   #     #   #   # # # #   # #   #   # #     # # #
# ### # # ##### ############# # # # ########### ##### ### ##### # # ### ######### ##### ### ####### # # ##### ####### # # # ##### # # ##### ######### #
#   #   #       #     #       # # #   #   #   #     #   # #   # #   # #   #       #   # #   #   #   # # #   # #       # # # #     # # #   # #   #   # #
### ############# ### ### ##### ##### ### # # ##### ### ### # # # ### ### # ##### # # ### ### # ### # ### # ### ####### # ### ##### # # # # # # # # # #
#   #   #       #   #   # #   #     #   # # #     #   # #   #   # #     #   # #   # #     #   #   #   #   #     #   #   # #   #     #   # #   #   # # #
# # # # # ##### ### ### # # # ##### ### # # # ####### # # ####### # ### ##### # ### # ##### ##### ##### ######### # # ### # ### ######### ######### # #
# # # # #     #     #   #   #     #     #   # #       # #   #       #   #     #   # # #     #   #   #   #     #   # # #   #     #       #     #     # #
# ### # ##### ####### ########### # ######### # ##### # ### ############# ### ### # ### ####### ### # ### ### ### # ### # ######### ######### # ##### #
# #   #   #   #     #     # #   # #           # # #   #   # #           #   #   # #   #   #     #   #     #   #   # #   #           #   #   # # #     #
# # ### # # ####### ##### # # # # ### ######### # # ##### # # ######### ### ### # ### ### # ### # ######### ### ### # ### ########### # # # # # # #####
#     # # # #     #   #   #   # # #   #   #     # # #   # #   # #     #   # # #   #     # #   # #       #   #   #     # # #         # #   #   # # #   #
# ##### # # # ### # # # ####### # ##### # # ##### # # ### ### # # # # # ### # ##### ##### # # ##### ##### ### ### ##### # # ####### # ######### # ### #
# # #   # #   # # # # #       #         #   #     # #   #   # #   # # #     # #   # #     # #     #           #   #   #   #   # #   #     #     #     #
# # # ### ##### # # # ####### ############### ### # ### ### # ##### ######### # # # # ######### ####### ####### ### # ##### # # # ####### # # ####### #
#   # #     # #   # # #     # #   #       #     # #       # # #   #       #     # # #   #       #     # #     # #   # #   # # # # #       # #       # #
### # ##### # # ### # # ### # # # # ##### # ### ######### # # # # ### ### ####### # ### # ### ### ### ### ### # # ### # # ### # # # ### ##### # ### # #
#   #     #   #   # #   #   #   # #     #   # #     #     # #   # #   #   #       #     # #   #   #       # # # # # # # #     # # # #   #   # # #   # #
# ####### ### ### # ##### # ##### ####### ### ##### # ##### ##### # ### ### ##### ####### # ### ### ####### # ### # # # ####### # # ##### # ### ##### #
# #     #   # #   # #     #     #       # #       # # #   #   #   #   #     #     #       #   #   # #     #       # # # #       #   #     #   #   #   #
# # # # ### ### ##### ################# # # ##### # # # # ### # ##### ####### ########### ##### # ### ### ######### # # # # # ### ### ####### ### # ###
# # # # # #     #     #               # #   # #   #   # #     # #   #   #     #       #   #   # #   # # # #   # #   # # # # # #   #   #     #   #   # #
# ### # # ####### # ### ############# # ##### # ####### ####### # # ### # ######### # # ### # ### # # # # # # # # # # # ### ### ### ####### ### # ### #
#     #       #   #             #     # #     #   #   # #     # # #     #   #   #   #   #   #   # # # # #   # #   # # #   # #     #         #   #     #
############# ################# # ### # # ### ### # ### # # # # # ######### # # # ####### ##### ### # # ##### # ### # # # # # ##### ######### ####### #
# #         #   #     #       # # #   # #   #       #   # # # #   #   #   #   #   #     # # #       #     # # #   # # # # # # #   # #         #     # #
# # # ##### ### # ### # ##### ### # ### ##### ####### ##### # ##### # # # ####### # ### # # # ########### # # ### # # # # # # # # # # ##### ####### # #
# # #   #   #   # # #   #   #     # # #     #   #   # #     # #     # # #   #   # # #     #     #           #   # # # # # # # # #   # # #   #     #   #
# # ### ##### ### # ##### # ####### # ##### ##### # # # # ##### ##### # ### # # # # ######### ### ############# ### # ### # # # ##### # # ### ### # ###
# # # # #     #   #       # #             # #     #   # # #   # #   #   # #   #   #         # #       #         #   #   # #   #     # #   #   # # # # #
# # # # # ##### # ######### # ############# # ######### # # # # ### ##### ################# ### ####### ######### # ### # ### ##### # # ### ### # # # #
#   # #   #     # #       #   #       #     #         # #   #   #       #     #     #     #       #     #   # #   #   # #   # #     # #   # #   # #   #
# ### ########### # ##### ### # ##### # ### ######### # ######### ##### # ### # ### # ### ######### # ### # # # # ### # ### ### ##### ### # # # # #####
#       #       # #   # #   # #   #   # #     #     # #           #   # #   # #   # # #         #   # #   # #   #   # #     #     #   #   #   # #     #
####### # ##### # ### # ### ##### # ### ##### # ##### ############# # # ### ##### # # ######### # ### # ### # ##### # ##### # ##### ########### ##### #
#     #   #   # #     #   #   #   #   #   #   #     #       #       # #   # #   # # # #   #   #   #   #   # #     # #   #   # # #   #       #   #   # #
# ### ##### ### # ##### ##### # ##### ### # ####### ####### ### ### # ### # # # # # # # # # # ##### ##### # # ##### ### # ### # # ### ### ### ### ### #
#   #       #   #   #   #   # # #   #   # #       #       #   #   # #   # #   #   # # # # # # #         # # # #   #   # #   # # #     # #   # #     # #
### ##### ### ##### # # # # # # ### ### # ####### # ######### # ### ### # ### ##### # # # ### # ######### # # # # # # # ### # # ####### ### # # ### # #
#     #   #   #     # # # #   #   #   # # #   # # # #     #   # #   #   #   # #   # #   #   #     # #     # # # # # # #   # # #           # # # #   # #
####### # # ### ####### # ####### # ### # # # # # # # ### # ### # ##### ### # # ### ####### ##### # # ##### ### # ### ##### # # # ######### # ### ### #
#       # #   #   #     # #     #   #   #   # # # # # # #   # # #     #   # # #   #   # #   #   #   # #   # #   #   #       #   # #         #   # #   #
# ####### ### ### ### # # # ### ### # ####### # # # # # ##### # ##### ### # # ### # # # # ### # ##### ### # # ##### ##### ### ##### ####### ### # # ###
#   #   # #   #       # # #   #     #       # #     # #     #       # #   # #     # #   #     #       #   # #   # # #   #   # #     #     #   #   #   #
### # # # # ############# ### ########### # # ####### ### # ####### # # ### ### ### ### ############### ### ### # # # # ### # # ##### ### # ##### ### #
#   # # # #     #       #     #       #   # # #       #   #       # # # # # #   #   #   # #       #     #     # # #   # #   # #       #   # #       # #
# ### # # ##### # ##### ##### ##### # # # ### # ####### ######### # # # # # ##### ### ### # ### # ##### # ##### # ##### # ### ######### ##### ####### #
#     # #   # #   #   #     #       # # # #   #   #     #     #   # # #   #       #   #       # # #   # #     #     #   # #   #       #       #       #
# ##### ### # ##### # ##### ######### # # # # ### # ##### ### # ### # # ########### ########### # # # # ##### ### ### ##### ##### # ########### ##### #
#     # #     #     #       #     #   # # # # # #   #       # #   # # # #       #   #   #   #   #   #       #   # #   #   #       # #     #   # #   # #
##### # ####### ############# # ### ### # # # # ########### ##### ### ### ##### # ### # # # # ############# # ### # ### # ##### ##### ### # # # # ### #
# #   #     #   #   #         # #   #   # # #         #   # #   #   #     #     #   # #   # # # #         # # #   #     #       #     # #   #   # #   #
# # ####### # ### # # ####### ### ### ### # ######### # # # # # ### # ##### ### ### # ##### # # # ####### # # # ################# ##### ######### # ###
#   #     # #   # # # #     #     #   #   # #   #   #   # # # #   # # #   #   # # #   #     # #   #     #   # # #     #     # #   #               #   #
# ### ### # ### # ### # ### ####### # ##### # # # # ##### # # ### # # # # ### # # ##### ##### ##### ### ##### # ### # # ### # # ####### # ########### #
#   # #   #     #     # #   #       # #   #   # # #     # # # #   # #   # # # # # #   #   #   #   # #         #     # # #     # #     # #       #     #
### # # ############# ### # # ### ##### # ##### # ####### # # # ### ##### # # # # # # ### # ### # # ######### ####### # ####### # ### ### ##### # #####
# #   # #           #     # #   # #     # #   # # #       # # #   #   # #   # # # # #   # #     # #   #   #   # #     #     #   #   #   #     # #   # #
# ##### ##### ##### ### ##### # ### ##### # # # # # ####### # ### ### # ### # # # # # ### # ##### ### ### # ### # ##### ### # ##### ### ####### ### # #
#     #     #   # #   # #   # #   # # #   # #   # #       # #   #   # #     # #   # #   # # #       #   #       #   #   #   # #     # #           #   #
# # ####### ### # ### ### # ### # # # # ### ##### ####### # ### ### # # ##### ##### ### # ### ##### ### ####### ### ##### # # # ##### ### ####### ### #
# #       # #   #   # #   #   # #     #   # #     #         #   # # # #     #       #   # #   # #     #     #     #   #   # # #   # #     #     #   # #
# ### ### # # ##### # # ##### ########### # # ### # ######### ### # # ##### ######### ### # ### # ####### # ######### # ### # # # # # ##### ### ### # #
# # #   # #   #     # #   #     #     #   # # #   #   #   #   #   # # #         #   #   #   #     #     # #           # #   # # # #   #     #   #   # #
# # ### # ##### # # # # # ##### # ### # # # # ####### # # # ### ### # ######### # # ### ##### ##### ### ######### ##### # ### # # ##### ##### ####### #
# # #   #     # # # # # #   #     # #   # # #       #   # # #   #   #   #   #     # # #     #   # # # #         #       #   # # # #     #   # #       #
# # # ####### ### ### # ### ####### ##### # # ### ####### # # # # ##### # # ####### # ### ##### # # # ######### ##### ####### # # # ##### ### # #######
#   # #           #   #   #   #     #   # # # # #     #   #   # #     # # #     #       # #   # # # #         #   #   #     # # # #   #   #   #   #   #
### # # ######### # ######### # # # # # # # # # ### ### ####### ### ### # ##### ####### # # # # # # ##### # ##### ##### ### # ### ### ### # ##### # # #
# # # # #     #   # #       # # # # # #   # #     #           #   #   #   #   #       # #   #   # #     # #             # #   #     # #   #     # # # #
# # # ### ### ##### # ##### # ### # # ##### ##### ############# ##### ##### ######### # ######### ##### ### ############# ##### ##### # ##### ### # # #
#   #   #   #   #   # #     # #   # # #   #   #   #     #       #       #   #     #   #               #   # #   #               #     #     #     # # #
####### ### ### # ### ##### # # ##### # # ### # ##### ### ####### ##### ### # # # # ####### ######### ### # # # ############# ### ##### ### ####### ###
#     # #     # # #       #   # #     # # # # #       #   #     # #   #   # # # # #     #   #     # # #   # # # #           #     #       #       #   #
# ### # # ##### # ####### ##### # ##### # # # ####### # ### ### # # ##### # # # # ##### ##### ### # # # ##### # # ######### # ##### ######### ### ### #
#   # #     #   # #       #     #   #   #   #   #     # #   #   # #       #   # #   # #     #   # #   #       #       #   # # #   # # #     #   #     #
### # ##### # ### # ######### ##### ### ### ### ### ### # ### ### ### ######### ### # ##### # # # # ################# # ### # # # # # # ### # # ##### #
#   # #   # #   #   #       #     # #   # #   #   #   #   #   # #   # #         #   #   #   # # # # #       #       #   #   # # #     # # # # # #     #
# ### # # ##### ######### # # # ### # ### ### ### ######### ### ### # ##### ##### ### ### ##### # # # ##### # ##### ##### ### # ####### # # ### #######
#   # # #     #     #     # # #   #   #       # # #       # #   #   #       #     #     # #     # # #   # # #   #         #   #   # #   #     # #     #
### # # ##### ### # # ##### # ### ##### ####### # # ##### # # # # ########### ######### # # ##### # ### # # ### # ######### ##### # # ####### # # ### #
#   # #   # #     # # #   # #   # #     #       # #     #     # #     #   #   #     #   #   #   # # #   #   #   # #   #   # #   #   #     # # # #   # #
# ### # # # ####### # ### # ##### # ##### ##### # ##### ########### # # # # ### # # # ####### ### # # ### ### ##### # # # # # ##### ##### # # # # ### #
# # # # # #       #   #   #   #   # #     #     #       #         # # # # # #   # #   #         # # # # #   # #     # # # # #     #     # #   #   #   #
# # # ### # # ######### ##### # ### ### ### ############# ####### ### ### # ### # ##### ####### # ### # ### # # ##### # ### # # ####### # ### ##### # #
# #       # #     #         # #   #     # # #     # #     #           #   #   # #   #   # #     # #   #       #     # # #   # # #       #   #       # #
# ######### ##### # ####### # ### ####### # ### # # # ################# # ### ##### # ### # ##### # ### ######### ### # # ##### # ######### ######### #
#   # #   # #     #   #   #       #       #     # # #         #     #   #   # #   # # #   #       #   # #         #   # #     #   #   #     #     #   #
# # # # # # # ##### ### # ######### ### # ####### # ######### # ### ### ### # # # # # # # ######### # ### ######### ### ##### ##### # # ##### ##### ###
# # #   #   #       #   #           #   #   #   # #     #     # # #   # #   #   #   # # # #     #   # #           #   #   # #       #   # #       #   #
# # ######### ####### ############### ##### # # # # # ### ### # # ### # ####### ##### # # # # ### ### # ############# # # # ############# # ##### ### #
# # #       #   #   #     # #       # #   # # # # # # #   #   # # #   #   #     #     # #   #   # #   # # #       #   # #                 #     #   # #
# # # ##### ### # # ##### # # ### ### ### # # # # # # # ### ### # # ### # # ##### ##### ####### # # ### # # ##### # ### ####### ############### ### # #
# #   # #   #     # #   # #     #   #   #   # #   # # # #     #   # #   #   #     #           # # #   #   # # #   #   # #     # #             #   #   #
# ##### # ######### ### # ######### ### ##### ##### # # ######### # # ####### ############# ### # ### ### # # # ##### # # ### # # ######### # ### #####
# #     #     #         # #   #       #   #   #     # # #         # #   #     #         #   #   # # #     # #     #   #     # # # #       # #   # #   #
# ##### ##### # ######### # # # ##### ### # ### ##### # # ######### ### # ##### ####### ### # ### # ##### # ##### # ######### ### # ### # # ##### ### #
#     #   #   # #       #   # # #   #   # # # # #     #   #       # #   #   # #       #   # # #     #   # #   #     #         #   # #   # # #   # #   #
##### ### # ##### ##### ##### # # # ### # # # # # ######### # ##### ####### # # ##### ### ### # ##### # # ### ####### # ####### ##### # ### # # # # ###
#     #   #       #   #     #   # # #   #   #   # #     #   # #     #       # # #   # # #   #   #     # #   #   #     #   #     #     # #   # #   #   #
# ##### # ########### # ### ##### # # ########### # ### # # ### ##### ####### # ### # # ### ##### ##### ### ### ######### # ##### ### ### ### ####### #
#   #   #     #       #   #       # #   #   #   #     #   # #   #   #   #           # #   #     #   # #   #   #         # # #     #   #   #   #     # #
### # # ##### # ### ##### ######### ### # # # # # ##### ### # # # # ### ### ######### # # ##### ### # ### ### ######### # # # # # ##### # # ### ### # #
#   # #   # #   # # #     #     #     #   # # # # #   #   # # # # #   #   # #   #   # # #     # #   #   #   #   #       #   # # # #     # # #   # # # #
# ####### # ##### # # ##### ### ########### # # ### # ##### # ### ### ### ### # # # # # ### ### # ### # ### ##### ####### ##### # # ####### ### # # # #
#         #         #         #               #     #       #       #         #   #   #   #       #   #           #             # #             #     #
#######################################################################################################################################################
