###########################################################################################
#   #             # #           # #       #     #         #     #       #     #           #
### ########### # # # ### ##### # # # ##### # # ##### ### ### # ##### # # ##### ####### # #
# #     #       # #   #   #     #   #     # # #   #   # #     #   #   # #           #   # #
# ##### # ####### ##### ### ######### ### # # ### # ### ######### # ### ##### ####### ### #
#     # # #     #     # # # #   #   # # #   #   #   #   #         # #       #   #     #   #
# ##### # # ### ##### # # # # # # # # # ####### ##### # # ######### # ##### ### # ##### ###
#   #   # #   #   #   # # #   #   # #     #     #     #   #   # #   # #   #   # #   # # # #
### # ### ### ### # ### # ######### ##### # ##### ######### # # # # ### # ### # ### # # # #
#   #   # #     # #     #         # # #   # #   # #       # # #   #   # #   # # #   # # # #
# ##### # # ##### ########### ### # # # ### # ### # ### # # # ####### # ### # ### ### # # #
#     #   # #   #           #   # # #   #   #     # #   #   #       #     # #   # #     # #
### ####### # # # ######### # # # # ##### ### ##### # ############# ####### ### # ##### # #
#   #       # #   #     #   # # # #       # # #   # # #           #       #   # # #   #   #
# ### ####### ##### ##### ##### ########### # # # # # ####### ### ####### ### # # # # ### #
#   #       # #               #   #           # #   #   #   #   #       #     # # # #   # #
# # ####### # ##### ######### ### # ################### # # ### ### # ######### # # ### # #
# #         # #   # #     # #   # #     #   #           # # #   #   # #       # #     # # #
# ########### # # ### ### # ### # ##### ### # # ####### # # ##### # ### ### # # # ##### ###
#   #       #   # #   # # #       #   # #   # #   #     # #     # # #   # # # # # #   #   #
### # ####### ### # ### # ######### # # # ### ### ##### # ##### # ### ### # # # ### # # # #
# # #   #   #   #   #   #   #   #   #   #     # #     # # #   # # #       # # #   # # # # #
# # # # # # ##### ### # ### # # # ####### ##### ##### ### ### # # # ####### ##### # # # # #
#   # # # # #   #   # #   #   # #   # #   #         #         # #   #       #     # # # # #
# ##### # # # # ### # ### ##### ### # # ### ####### ########### # ### ### ### ##### # # # #
# #     # # # #   #   #     #   # # # # # #       #   #     #   # #   #   #   #     # # # #
# # ##### # # ### ########### # # # # # # # ##### # ### ### # ##### ### ### ### ##### # # #
#   #     # #   #           # #   # #   #   #     # #   # # #     # # # # # # #   #   # # #
##### ##### ### ########### # # ### # ### ### ### ### ### # ##### # # # # # # # # ### # # #
#     #   #     #             # #   # # #   #   # #   #   #       # #     # #   #   # # # #
# ##### ######### ############# # ### # ### ### ### ### # ######### # ##### ### ### # ### #
# # #             #     #     # # # # #       #   # #   #       #   # #   #   #   # #   # #
# # # ######### ##### ### ### ### # # ##### ##### # # ### ####### # ### # ### ### # ### # #
# # # # #     #       #   # #     # # #   # #     # # #   #       #     #   # #   # # #   #
# # # # # ### ####### # ### ####### # # # # # # ### # # ### ########### # # # ##### # ### #
# #     #   #   # #   # # #     #       # # # # #   # # #   #     #   # # # #   #   #   # #
# ######### ### # # ### # # # # ######### ### ### ### ### ### # ### # ### # ### # ### ### #
#           #   # #   # #   # # #     # #     #   #     #     # #   #     #   #   # #     #
# ########### ### ### # ##### # # ### # # ##### ### ### ####### # ################# # #####
#       # #   #       #   #   #   #   #   #   # #     #     #   # #                 # #   #
####### # # ### ######### # ####### ### ### # # ##### # ##### ### # ############# ### ### #
#   #     #   # #       #   #     # # # #   # #   #   #   #   # #   #     #     #     #   #
# # ######### # # ##### ######### # # # # ### ### # ##### # ### ####### # # ### ####### # #
# #           #   #   #   #       # # # # # # #   #   #   #         #   # # #   #       # #
# ################# # ### # ### ### # # # # # # ####### # ######### # ##### # ### ##### # #
#     #         #   #   #   #   #   #   # # #   #       #         # # #   # #     # #   # #
# ### # # ### ### # ### ##### ### ####### # ##### ####### ######### # # # # ####### # ### #
# # # # # #   #   # #     #   # # #       #       #     # #       # #   # # # #     #   # #
# # # ### # ### ### ####### ### # # # ##### ####### ### ### ##### # # ### # # # ### ### # #
#   #   # #   #   #             # # # #     #     #   #     #   #   #   # # #   #     # # #
####### # ####### ############# # ### # ### # ### ### ####### ####### ### # # ### ### # # #
#       #       # #   #   #     #     #   #   # #     #           #   #   # # #   #   # # #
# ####### ### ### ### # # ############### ##### ########### ##### # ### # # ### ### ### # #
#   #   #   # #   #   # #     #       #   #               #   # #     # # #     #     # # #
# # # # ### # # ### ### ##### # # ##### ### ### ######### ### # ##### # # ####### ##### # #
# # # #   # #   #     #     #   # #   #   #   #   #     #   #   #   # # # #     # #     # #
### ##### # ####### # ##### ##### # # ### ##### # ### # ### ### # # ### # # ##### # ##### #
#   #   #   #     # #     # #   # # #   #     # # #   # #   #   # #     #   #     # #   # #
# # # # # ##### # ### # ### # # # # # # ##### ### # ##### ####### ### ####### ##### ### # #
# # # # #       #     # #   # #   # # #     # #   # #   # #     #   # #     #   # #   #   #
# ### # ##### ######### # ### ##### # ##### # # ### # # # # # # ### ### ### ### # ### #####
#   # #     # #     #   #   #       #     # #   # #   #   # # #   # #   # #   # # #   #   #
# # # ##### # # ### # ##### ############# ####### # ######### ### # # ### ### # # # ### # #
# #   #     # # # # #   #   #       #   #     #   # #         # #   #   #   #   # #     # #
####### ##### # # # ##### ### # ### ### ##### # # # # # ####### ### ### ### ##### ####### #
#       # #   # # #       #   # #       #   #   # # # #     #       # #       #       #   #
# ####### # ### # ############# ####### ### ##### # ####### ####### # ####### # ##### # ###
# #     # #   #   # #   #       #   # #   # #     #       # #     # #       # #   #   #   #
# # ### # ### ### # # # # # ##### # # ### # # # ######### # # ### # # ### ### # # # ##### #
# # # # #   # # # #   #   #     # # #   #   # # #       # # #   # #   #   #   # # # #     #
# # # # ### # # # ##### ####### # # # # ### # ### # # ### # ### # # ####### ##### ### ### #
#     #   #     #     # #   #   # # # #   # # #   # # #   #     # # #     #       #   #   #
####### # ##### ##### ### # # ### # # # ### # # ### # # ######### # # ### ##### ### ### ###
#     # #   # #   # #   # # #     # # #     # # #   # # #       # # # # #       #   # # # #
# ### ##### # ### # ### # # ### ### # ####### # # ##### # ##### # ### # ######### ### # # #
# # # #     #   # # #   # #   # #   #   #     # #       #     # #               #   # # # #
# # # # ##### ### # # ### ### ### ##### # ### # ############# # ################### # # # #
# #   # #     #     # #   #   #   #     # #   #   #   #       #                     # # # #
# # ### # ### # ##### ### # ### ### ##### # ##### # # ### ########################### # # #
# #     # # #   #   #     #     #   #     #   #   # #   #     #       #     #   #   #   # #
# ####### # ##### # ############# ### ####### # ### ### ##### # ### # # ### # ### # # ### #
#     #   # #     #             # # #   #   # #   # #   #   # #   # # # #     #   #   #   #
# ### ### # # ########### ##### # # ### # ### ### # ### # # # ### # # # # ##### ####### # #
#   #   # # # # #     #   #     #     # #     #   #   #   #   # # # #   # #     #       # #
### ### # # # # # # ### ####### ##### # ### ### ### # ######### # # ####### ####### ##### #
# #   # #   # #   #   # #     #   #   #   # #   #   # #         # #         #     #     # #
# # ### # ### ##### # # # ### ##### ##### # # ####### ### ##### # ########### ### ####### #
#   #   # #   #   # # #   # #     # #   # # # #     #   #   #   #     #       #   #       #
# ### ##### ### # ### ##### ##### # ### # ### # ### ### # # ######### ##### ### ### ##### #
#   #           #               #       #       #       # #                 #       #     #
###########################################################################################
