###################################################
#   #             #             #   #     #       #
### ##### ####### # ######### # # ### ### # ##### #
# #     # #     # # #       # #   #   #   #   # # #
# ##### # # ### # # ##### ### # ### ### ##### # # #
#     # # # # # # #   #   #   # #   # # #   #   # #
# ##### ### # # # ### # ### # ### ### # # # ### # #
# #   #     #   #   #   #   # #   #   #   #     # #
# # # ####### ### ##### # ### # ##### ########### #
# # #     # # #   #     #   # # #     #     #     #
# # # ### # # # ### ####### ### # ### ##### # ### #
#   # #     # #     #     #       #         # #   #
##### # ##### # ##### ### ################# # ### #
#     # #     #     #   #           #     # #   # #
# ##### # ############# ########### # ### # ### ###
# #     # #   #         #         # # #   #   #   #
# # ##### # # # ######### ######### # ### ####### #
# #   # # # #   # #                 #   #         #
# ### # # # ##### # ################### ######### #
# #   # #   #     # #       #           #   #     #
# # ### ##### ##### # ##### # ##### ##### ### #####
# #     #   #       # # #   #     # #     #   #   #
# ####### # # ####### # # ######### # # # # ### # #
# #   #   # # #   #   # #   #     # # # # # #   # #
# # # # ### # # # # ### ### # ### # # # ### # # # #
# # #   # # #   #   #     # # #     # # #   # # # #
# # ##### # ######### ##### # ####### # # ### # ###
#   #     #     #   #       #   #   # # #   # #   #
# ### ### ##### # # # ######### # # # # ### ##### #
# #     #     # # #   #         # # # #   #     # #
# ####### ### # # ##### ### ##### # ##### ##### # #
#   #   # #   #   #   # #   #     #     #         #
### # # ### ####### # ### ### ######### ###########
# #   #   #         #     #   #     # #           #
# ####### ##### ### ####### ##### # # ########### #
#       #     #   #         #     #   #     #     #
##### ####### ### ########### ####### # ##### ### #
#   #       #   # #           #   #     #     # # #
# # ##### # ### # ######### ### ### ##### ##### # #
# #   #   #   # #         # #   #     #   #   #   #
# ### # ####### ### ##### # # # # ##### ### ### ###
#   #   #   #   #   #   #   # #     #   #   #   # #
# # ### # # # ### ### # ####### ##### ##### # ### #
# # #   # #   #     # #       # # #   #   #   #   #
# # ##### ########### ####### # # # ### # ### ### #
# # #   # #         #   # #   #   #     #   #   # #
# # # # # # ####### ### # # ##### ####### # ### # #
# #   #   # #     #   # # # #   #   #   # # #   # #
# ######### # ### ### # # # # # ##### # ### # ### #
#           #   #       #     #       #     #     #
###################################################
