#############################################################################################################################################
#       # #         #     #                 #       #           #   #   #               #     #               #     #         #             #
####### # # ##### # # ##### ####### ######### ##### # ##### ### # # # # # ########### # ### # # ####### ####### # ### ##### # # ########### #
#       # #   # # #   #     #     # #             #     #   # # # #   # #     # #     #     # # #     #   #     #       #   # # #         # #
# ####### ### # # ### # ######### # # ############# ##### ### # # ########### # # ########### # # ### ### # ########### # ### # # ####### ###
# #     # #   # # #   # #         # #         #   # #     # #   #     #     # # #           # # #   #   # #       #   # # #   #     #   #   #
# # # # # # ### # ##### # ##### ### ######### # # # # ##### # ##### # # # # # # ########### # # ### ### # ### ##### # ### # ##### ### # ### #
# # # # # #     #     # #   # # #   #         # # # #     #   #   # # # # # # #       # #   # #   # #   #   # #   # #     #     # #   #     #
# ### # # ##### ##### # ### # # # ### ######### # ####### # ### # ### # # # # # ##### # # ### ### ### # # ### # # # ##### ##### ### ####### #
#   # #   #   # # #   #   # #   #   # #     #   #         # #   #   #   # # #   #   # # # #     # #   # #     # # #     # #   #     #   #   #
### # ##### # # # # ##### # # ##### # # ##### ############# # ##### # ### # ##### # # # # ####### # ########### # ##### # # # ######### # ###
# # # #     #     #     # # # #     #   #     #       #     #   # # #   # # #     # #   #       #   #           # #     # # #   #       #   #
# # # # ############# # # # # # ### ### # # ### ##### # ####### # # ##### ### # ### ### ####### ### # ########### # ####### ### ##### ##### #
#   #     # #         # # # # # #   #   # # #   #   # # #       #   #     #   #   #   # #     #     # #     #   # # #     #   #     #     # #
# ####### # # # ######### # # # ##### ### ### ### # # # # ####### ### ### # ##### ##### ### ######### # ### ### # # # ### ### ##### ### ### #
#       #   # # #         # # #       # #     #   #   #   #         #   # # #   # #   #   #         # #   #   #   #     #         #   #     #
####### ### # ### ######### ########### ####### ##### ############# # # ### ### # # # ### # ##### # # # ##### # ####### ############# # #####
#     #   # #         #             #   #     # #   # #     #   #   # #   #   # # # #   # # #   # # #   #   # # #     # #   # #       # #   #
# ####### ########### # ####### ##### # # ### # # # # # ### # # # ####### ### # # # # ### # # ### # ##### # # # # ### # # # # # ####### # # #
#         #     #     # #       #     #     # # # #   # # #   # #           # # #   #     #   #   # #   # #   # #   # #   #   #       #   # #
# ######### ### # ####### ##### # ######### # # ####### # ##### # ##### ##### # ############### ### ### # ##### ### # ####### ####### ##### #
# #       # #   #   #   #   #   # #       # # #   #   #     # # # #   # #     #     #       #   # # #   #   #       # #   #         # #   # #
# ### ### # # ##### # # ### # ### # ##### ### ### # # ##### # # ### # ### ####### # ##### # # ### # # ##### ######### # # # ######### # # # #
#     # #   #     #   #   # #   # # #     #     #   # #     # #   # # #   #       #       # # # #   #     # #   #   #   # #   #   #   # #   #
####### ######### ####### # ### # # ### ### ######### # ##### ### # # # ### # ############# # # # ##### ### # # # # ##### # ### # # ### #####
#   #     #     # #     # #   # # #   #     #         #         #   #   # # # #   #   #   # # #       #   #   # # # #     # #   #   #   #   #
### # # ### ### # ### # # ### ### ### # ##### ####### ######### ######### # # # ### # # # # # ####### ### ##### # # # ####### ######### ### #
#   # #     # # #   # # #   #     #   # #     #   #       #   #   #   #   # # # #   #   #   # #     #     #     # # # #       #       #     #
# ### ####### # ### # ##### ####### ### # ### # # ####### ### ### # # # # # # # # ########### # ### ##### # ##### ### ##### ### ##### ##### #
# #   #       #     #         #   # #   #   # # #     #     #   # # #   #   # # #         #   # #   #   # # #     #   #   # #   # #   #   # #
# # ### ##### ####### ####### # # # ####### # # ##### ##### # # # ### ####### # ######### ### # # ### ### # ### ### ### # # # ### # ### # # #
# #   # #   #     #   #   #   # #   #       # # #     #   #   # #   # # #     #     #   #   # # #   #     #   #         #   # #   # #   # # #
# ### # # # ##### # ### # ### # ### # ####### # # ### # # ##### ### # # # ####### # ### ### # # ### # ####### ############# # # ### # ### # #
#   # # # #       #   # #   # #   # # #       # # #   # # #   # #   #   #   #     #     #   # # # # #   #   #     #         #   #   #   # # #
### # # ##### ######### ### # ### ### # ####### # ##### # # # # # ##### ### # # ####### # ### # # # ##### # ##### # ##### ##### # ##### # ###
#   # #     #           #   #     #   #     #   #       # # # # # #   # #   # #       # # #   # #   #     # #     # #   # #   # #       #   #
# ### ##### ############# ####### # ######### ########### # # ### ### # # ####### ### ### # ### # ### ##### # ####### # # # # # ########### #
# #   #     #   #       #     #   #       #   #     # #   # #   #   #   # #     # #   #   # #   # #   #     #         # #   # #         #   #
# # ### ##### ### # ######### # ##### ### # ##### # # # ### ### ### ##### # ### ### ### ### # ### # ### ##### ######### ##### ### ####### # #
# # #     #   #   #         # # #   #   #   #     #   # #     #   #       # # #   #   #     # # # # #       #     #     #   #   # #       # #
# # ##### # ### ####### ##### ### # ### ####### # ##### # ##### ######### # # ### ### ### ### # # # ####### ####### ##### ### ### # ####### #
# #   #   #   #     #   #   # #   # #         # # #   #   #   #   #       # #     #     # #   # # #       #   #   # #     #   #   # # #     #
# ### # ### # ### ### ### # # # ### ######### # # # # ##### # ### # ####### ### ### ##### # ### # ####### ### # # # # ### # ### ### # # #####
#   #   #   #     #   #   #   #   #     #   #   # # # #     # #   # #     #   #   #       # # #   #   #   # #   #   # # #   #   #   #       #
# ####### ######### # # ######### ##### ### ### ### # # ##### # ### # ### ### ### # ####### # # ### # # ### ### ##### # ##### ### # ####### #
#       #     #     # #     #     #   #   #   # #   #   #   # #   #   #     # #   #     #   #   #   #   #       #   #       # # # # #   #   #
##### ####### # ########### # ##### # ### # ### # ####### # # # # ### ####### # ######### ### ### ####### ####### # ### ##### # # ### # #####
#   #     #   # #         #   #     # # # #     #   #   # #   # # #   #   #   # #     #   #   #   #     # # #   # # #   #       #     #     #
# # ### # # ### # ##### # ##### # ### # # # ##### # # ### ##### # # ### # # ### ### # # ### ### ### ##### # # # # # ##### ################# #
# #   # # # # #   #     # #     # #     # # #   # # #     # #   # # # # #   # #     #   # # #   # #     #   # #   #     #   #     #   #     #
# ### ### # # ##### ### ### ##### ##### # # # # ### # ##### # ### # # # ##### ########### # # # # # ### ### # ######### ### # ### # # # ### #
#   # #   #   #   #   # #   #   #     # # # # #     #   #     # #     # #         #       # # # #     # #   # #       #     #   #   #   # # #
# # # # ##### # # ### ### ##### ##### # # ### ######### ### ### ####### # # ##### ##### ### ### # ##### # ### ### ### ######### ######### # #
# # #   #       #   # #   #         # # #     #       #   #       #   # # #     #       #   #   # #   # #   #   # # # #   # #   #   #       #
### # ### ########### # ### # ####### ######### ### # ### # ####### # # # ##### ####### # ### ##### # # ### ### # # # # # # # ### # ### #####
#   # #       #       # #   # #     #         #   # # #   # #       #   #     # #   #   #     #   # # #   # # #   # # # #   #     #   # #   #
# ##### ####### ####### ##### # ### ######### ### # ### ### # ########### ##### # # # ####### # # # # # ### # ##### # # ### ######### # # # #
#       #     # #     # #   # #   #   #         # #   # #   # # #         #     # # # #   #   # #   # #   #         #   #   #       # # # # #
# ####### ### # # ### # # # # # ### # # ######### ### # ### # # # ######### ##### ### # ### ### ##### ### ### ########### ### ##### # ### # #
#     # # #     # #   #   # # # #   # #     #       # #   # # #   #         # #         #     # #   #   #     #             #   #   #   # # #
##### # # # ##### # ####### # # # ### ##### # ####### ### # # ### # ######### # ######### ##### # ##### # ##### ############### # ### # # # #
#   #   # # #     # #   #   #   # #     #   # # #     #   # #   # #       #     #         # #   #     # # # #   #   #   #       # #   #   # #
# # # ### # # ##### # # # ### ### # ##### # # # # ### # ##### # ##### ### ##### # ######### # ### # # # # # # ### # # ### ####### # ##### # #
# #   #   # #     # # #   #   #   #   #   # #   # #   # #   # #     # #   #   # #       #   # #   # # # # # # #   #   #   #     # # #   # # #
# ##### ##### ##### # ##### ### ##### # ####### # ##### # # # ##### # # ### # ######### ### # ##### ### # # # # ### ### ### ### # ### # ### #
#   # #       #     # #   # #   #   # # #       #     #   # #     # # #   # #         #     #       #   # # # #   # #   #     # #   # # #   #
### # ######### ##### # ### # ### # # # # ########### ##### # ##### ##### # ##### ######### ### ##### ### # # ### ### ### ### ##### # # # # #
#   #         #     # # #   # # # #   #   #   #       # #   # #     #   #   #     #       # #   #     #     #   # #   #   # #     # # #   # #
# ########### ##### # # # ### # # ######### # # ##### # # ### # ##### # ### # ##### ### ### # ### # ####### ### # # ### ### ### ### # ##### #
#                 #   #   # # # #   # #     # #   #   # # # # #       #   # #     # # #     #   # # #     #   # # # # #       #   #   #     #
################# ##### ### # # ### # # ### ##### # ### # # # ########### # ##### # # ######### # ### ### ##### # # # ####### ### ##### #####
#     #         #   # # #   # #   # # # # #   #   #     # # # #     #     #     #   #     #     #   # # #         # #   #     # #   # #   # #
# ### ##### ####### # # # ### # ### # # # ### # ####### # # # # # # # ### ####### ##### ### ####### # # ########### # # # ##### # # # ### # #
# #   #     #       #     #   #     #       # # #   #   # # # # # # # #   #     #     # #   # #   # #   #       #   # #         # #     # # #
# # ### # ### ############# ### ##### ####### # # # ##### # # ### # # ### # ### ##### # # ### # # # ### ##### # # ### ########### ### ### # #
# #   # # #   #         #   # # #     #     # #   #       #     # # #   # #   #   #   # # #   # #     # #     # # #   # #     #   #   #   # #
# ### # # # ### ####### # ### # ##### # ### # ################# # # ### # # ##### # ### # # # # ### ### # ####### # ### # ### # ####### ### #
# # # # # #   #   #     #   # #     # # #   #   #       #   # # # # #   # # #     #   # # # # #   # #   # #       # #   # # # # #       #   #
# # # # # ### ### ##### ### # ##### ### # ### ### # ### # # # # # # # ### # # ####### # # ### ### ### ### # ####### # # # # # # # ######### #
# #     #   #   #     #   # # #     #   #   #     # # #   # # #   # # #   # # #   # # # #   #   # #   #   #     #     # # #   # #   #     # #
# ######### ### ### # ### # # # ##### ##### ####### # ##### # # ##### # ### # # # # # # ### # # # # ### # ##### ####### # # ### ### ### # # #
#     # #     #   # # # # # # #     # #             #   #   #   #   # # #   #   # #   # #   # # #       # #   # #     # # #     #   #   # # #
# ### # # ####### ### # # # # ##### # ############### # # ### ### # # # # ####### # ### # ### ########### # ### # ### # # ##### # ### ### # #
#   # #   #     #     #   # # #     #   #         #   # #   #   # #   # #   # #   #     #   #     #   #     #   # # # # # #     # # #   #   #
### # ##### # ######### ### # # ##### # # ####### ### # ### ##### ##### ### # # ### ####### ### ### # ####### ### # # # # # ##### # # # #####
#   #       # #     #   #   #     #   # # #     #   # #   # #     #   #   # # #   # #     #     #   #         #     # # # # #     #   #     #
# ########### # # # # ### # ##### ### # # # ### ### # # ### # ##### ##### # # ### ### # # ##### # ########### # ##### # # ### ##### ####### #
# #   #     #   # # # #   #     #   # #   #   #   # # # #   # # #   #   # # #   #     # #     # # #     #   # # # #   # #   # #   # #     # #
# # # ### # ##### # # ### ##### ### ##### ### ### # # # # ### # # # # # # # # # ##### # ##### # # # ### # # # # # # ####### # # ### # # ### #
#   #   # # #     # #   # #     #   #   #   # #   # # #   #   #   #   #   #   # #   # #     # # # # # # # #   #   #       # # #     # # #   #
####### # ### # ####### ### ##### ### # ### ### # # ##### # # # ########### ##### # ##### # ### # # # # ### ### ######### # # # ####### # ###
#   #   # #   # #     #   #   # #     # # # #   # #     # # # #     #       #     # #   # #     #   # #   # #   #         # # #         #   #
### # ### # ### # ### ### ### # ####### # # # ### ##### # ### ### ### ####### ##### # # # ########### ### # # ### ######### # ######### ### #
#   #     #   # # #     #     # #       #     # # #     #     #   #   #   #   #   #   # # #   #       # # # # #   #   #   #   #       #   # #
# ####### ### ### # # ######### # ############# # # ####### ####### ##### # ### # ##### # # # ### ### # # ### # ### # # ### ######### # ### #
#         # # #   # # #       #   #         #     # #       #       #   # #     # # #   #   #     #   # #     # #   # #   # #     #   # #   #
# ######### # # ### ### ##### # ####### ### ####### ##### ### ####### # # ####### # # ##### ####### ### ####### # ### ### # # ### # ### # # #
# #       # #     #   #   #   #         # # #     # #   #   #   #     # # #   #   # #   #   #   #   #         #   #   #   # #   #   #   # # #
# # ##### # ######### ### # ############# # # ### # # # ####### # ##### # # # # ### ### ##### # # ######### ####### ### ### ### # ### ### # #
#   #   #   #       #   # #       #       #   # # # # #       # #   #     # #   #     #   #   # #         #   #     #   #   #   # #   # # # #
####### ### # ##### # # # ##### ### ##### ##### # # # ##### ### ### ####### ##### ### ### # ### ######### # # # ####### # ### ### # ### # ###
#     # #   #     #   # #   # # #   #   #       # #   #   #   # #   #   #   #       #   #   # #     #   # # # #     #   #   # #   # #   #   #
# ### # # ####### ######### # # # ##### ####### # # ### ##### # # # # # # ##### ##### ####### ##### ### # # # ##### # ##### # ##### # # ### #
# #   # # #     #     #     # #   #     #   # #   # #   #     #   # # #   #   # #   #     # #   #   #   # # #   #   #     # # #     # #   # #
# # ### # ### # ##### # ##### ##### ### # # # ##### # ### ### ##### # ##### # ### # ### # # # # # ### # # ### # # ####### # # # ####### ### #
# #   # #     # #   #   #       #     #   #   #   #   #   #   #     # #     #     #     #   # #   #   # # #   # # #     #   #       #   #   #
# ### # ####### # # ######### # ##### ####### # # ### # ### ### ##### # ### ### ######### ### ##### ##### # ### # # ### ### ####### # # # # #
#   #         # # #     #     #       # #     # # #   #   # #   #     # #   #   #   #   # #   #             #   # # # #   #       #   # # # #
# # ### ##### # # ##### # ### ######### # ####### # ##### # # ### ####### ####### # # # ### ################# ### # # ### ####### ### ### # #
# # #   #   # # # #       #   #       # # # #     # #   # # #   # #       #       # # #   # #           #   # # #   #   # #         # #   # #
# # ##### # ### # ####### ##### ##### # # # # # ### # # # ##### # # # ##### ####### # ### # # ######### # # # # ##### ### ######### ### ### #
# # #   # # #   #       # #     #     # # #   #   # # # #       # # #       #     # #   # #   #       # # # # #     #   #         #     #   #
### # # # # # ### ##### ### ##### ##### # ####### # # ######### # # ############# # ### # ##### ##### # # ### ### ### # ######### ###########
#   # #   #   #       #     #   # # #   #       # #   #       # # #       #   #   #     #     # #   #   #   #   #   # #         # #     #   #
# ### ################# ##### # # # # # ####### # ### # ##### # # ####### # # # ############# # # ######### ### # # # ##### # ### # ### # # #
#   # #     #   #     #   #   # # # # #     #   #   # # #   # # # #     # # #   #       #     # #           #   # #   #     # #   # # #   # #
# # # # ### # # # ### ### # ##### # # ##### # ### ### # # # # ### # # # # # # ### ### # # ##### ####### ##### ######### ####### ### # ##### #
# #   #   #   #   #   # #   #   # # #   # # # #       # # # # #   # # # # # # #   #   # #       #       #   # #         #     #   #       # #
# ####### ######### ### ### # # # # ### # # # ######### ### # # ##### ### # ### ### ### ######### ##### # # # ### ####### ### ### ### ##### #
# #       # #     #   # #   # #   #   # # #   #         #   # #     # #   #   # # # #   #   #         # # #       #       # #   #     #     #
# # ### ### # # # ### # # ### ##### # # # ##### ######### # # # ### # # ##### # # # # ##### # ####### # # ####### # ####### ### ####### ### #
# #   # #   # # #   # #   #   #     # # #       # #       # # #   # #   #   #     # # #     # #   #   # # #   #   # #   #     #   #     #   #
# ##### # # # # ##### # ### ### ### ### # ####### # ### ##### ##### # ### # ####### # # ### # # # # ##### # # # ### # # # ### ### # ##### ###
#       # #   #       # #   #     # #   #   #     #   # #   # #     # #   # #     # #   # # #   # #       # # # # #   # #   #   #   #   # # #
######### ############### ####### ### ##### # ####### # # # # # ##### # ### # ### # ##### # ##### ######### # # # ##### ### ### ##### # # # #
#     #   # #           # #       #   #     # #     # #   #   # #     #   # #   # # #     # #   # #       # # #       #   #   #   #   #   # #
# ##### ### # ##### ### # # # ##### ### ##### # ### # ######### # ####### # ### # # # ### # # # # # ####### # ######### # # # ##### ####### #
#     #   #   #   #   #   # # #     #   #       #   #         # # #   #   #     #   #   #   # # # # #     # #         # # # # #   # #   #   #
##### ### # ##### ### ####### # ##### ### ####### ########### # # # # # ### ####### ######### # # # # ### # ######### # # ### # # # # ### # #
#       # #       # #       #   #     # #   #   #         # #   #   # # #   #     # #         #     # #   # # #     # # #   #   # # #     # #
# ##### # ####### # ####### # ### # ### ### # # ####### # # ######### # ##### ### ### ############### # ### # # ### # # ### # ### # ####### #
# #     # #   #   # #   #   #   # # #   #   # #     # # #     #   #   #     #   #           #     #   #     # #   # # #   # #   # #         #
# # ##### ### # ### # # # ##### ### # ### ### # ### # # ##### # # # ####### ### ####### ##### ### # ### ##### ### # # ### # ### # ### #######
# #     #   #       # #   #   #     #   #   # # # #   #     #   # # #     #     #   #   #     # # # #   #   #     # #   # # #   #     #     #
# ##### ### # ####### ##### # ######### ### # # # ### ##### ##### # # # # ### ### # # ### ##### # # ##### # ##### # ### # # ##### ##### ### #
# #       # # #       # #   #   #         # # # #   #     #     # # # # #   # #   # # #   # #     #       # #   # #   # # #     # #       # #
# ######### # # ####### # # ### # ### ##### ### # ####### ##### ### # # ### ### ### # # ### # ############# # # # # ### ####### ### ####### #
#   #     # # # #     #   # #   # # #       #   #       # #   # #   # # # # #   #   # #   #   #       #   #   # # #   # #     #     #   #   #
# # # ### # ### # # ### ### ##### # ######### ### ##### # ### # # ##### # # # ### ####### # ### ##### # # ##### # ### # # ### ####### # # # #
# #     #       # #       #                   #       #       #         #     #           #     #       #       #   #     #           #   # #
#############################################################################################################################################
