###############################
#   #             #     #     #
### # ### ####### # ##### # ###
# # # # # #     # #   #   #   #
# # # # # # ### # # # # ##### #
#   # # # # # # # # #   #   # #
# ### # # # # # # # ##### # # #
#   #   #     # # # #   # # # #
### ########### # ### # # # # #
# #             #     #   # # #
# ######################### # #
#     #                   #   #
# # # ######### ### ##### ### #
# # #   #     #   # #   #   # #
# # ### # ### ### # ### ### # #
# # # #   #   #   #   #     # #
# # # ##### ######### # ##### #
# # # #   #       #   # #   # #
### # # # ####### # ##### # # #
#   # # #     #     #     #   #
# ### # ### ### ##### #########
# #   #   #       #   #       #
# ### ### ######### ### ### # #
#   #         #   #   # #   # #
### # ######### # ### ### #####
#   # # #       #   #   #     #
# ### # # ####### ##### ##### #
# #     #   # #   #   #       #
# ######### # # ### # ####### #
#             #     #         #
###############################
