###################################################################################################################################
#   #             #             # #       #     #         #     #       #         #     #           #   #                   #     #
### ########### # # ##### ##### # # # ##### # # ##### ### ### # ##### # # ####### ### # # ####### # # # # ######### ####### # #####
# #     #       # #   #   #     #   #     # # #   #   # #     #   #   # #     #       # #   #   # #   #   #     # #   #     #     #
# ##### # ####### ##### ### ######### ### # # ### # ### ######### # ### ##### ########### ### # ### ####### ### # ### ### ##### # #
#     # # #   # #     # # # #   #   # # #   #   #   #   #         # #       #   #         #   #   #         # # #   #   # #   # # #
### ### # # # # ##### # # # # # # # # # ####### ##### # # ######### # ##### ### # ######### ##### ########### # ### ### # # # ### #
#   #   # # #     #   # # #   #   # #     #     #     #   #   # #   # #   #   #   #       #   # # #   #   #         # # #   #   # #
# # # ### # ##### # ### # ######### ##### # ##### ######### # # # # ### # ### # ### ##### ### # # # # # # ######### # # ####### # #
# # #   # #     # #     #     #   # # #   # #   # #       # # #   #   # #   # #     #   #   # #     #   #   #   #     # #       # #
# # ### # # ### # ####### ### # # # # # ### # ### # ### # # # ####### # ### # ####### # ### # ############# # # ##### # # ####### #
# #   #   # # # #         #   # # # #   #   #     # #   #   #       #     # #   #     # #   #         #   #   #   #   # #   #     #
# ######### # # ############# # # # ##### ### ##### # ############# ####### ### # ### ### ########### # # ####### # ### ### # ### #
#   #         #   #   #     # # # #       # # # #   # #           #       #   # #   #   #     #   #   # #       # #   # # # #   # #
# # # ######### # # # # ### # # # ######### # # # ### ####### ########### ### # ### ### ##### # ### ### ####### # ##### # # ### # #
# #     #     # #   # # # # #   # #           #     #   #   #           #     # #   #       #   #   #   #   #   #       #   #   # #
######### ### # ##### # # # ####### ################### # # # ######### ####### # ### ### ### ### ### ### ### ########### ####### #
#   #     # # #     # # # #       #     #   #           # # #     #   #       # #   #   # #   #   #   #         #   #     #     # #
# # # ##### # ####### # # ####### ##### ### # # ####### # # ##### ### ####### # # ##### ### ### ### ##### ####### # # ##### ### # #
# #   #   #   #     #   #     #   #   # #   # #   #     # #     #   # #       # # #   # #   # #   #     #     #   # # #     # # # #
# ##### ### ### ### # ### ### # ### # # # # # ### ##### # ##### ### # # ##### # ### # # # ### ### # ### ### ### ### # ##### # # # #
#   #     #     #   #   # #   # #   #   # # # # #     # # #   # # # # # #     #   # # # #     #   # # # #   #   # # #   #   # #   #
# # # ### ####### ##### # # ### # ####### ### # ##### ### ### # # # # # # ####### # # # # ##### ### # # ### # ### # ### # ### ### #
# # #   #       # #   # # # # # #   #   #     #     #         # # # # # #   #     # # #   #     # #   #   # # #   #   # # # #   # #
### # ### ##### # ### # # # # # ### ### # ######### ########### # # # # # ### ##### # # ### ##### ### ### ### # ### # # # # # # # #
#   # #   #   # #   #     #   #   # #   # #           #     #   #     # # #   #     # # # #   #     #   #   # # #   # #   #   #   #
# ### # ### # ##### # ####### ### # # ### # ####### ### ### # ##### ### # # ### ##### # # ### # # ##### ### # # # ### ##### #######
# #   #   # # #     # #   #   #   # # #   # #   #   #   # # #     # #   # # # #   #   # # #   # # #     #   #   # # # #   #   #   #
# ### ### # # # ####### # ##### ### # # ### # # # ### ### # ##### ### ### # # # # ### # # # ### # # ##### # ### # # # ### ### # # #
#   #   #   #   #       #       #   #   # #   # # #   #   #       #   # # # #   #   # #   #   # # #     # # #   # #       #   # # #
### ######### ### ##### ####### # ### ### # ### # # ### ########### ### # # ### ### # ### ### ### ### ### ### ### ######### ### ###
#   #   #   #     #     #     # # #   #     #   # # #               #     #   #   # #   #   #   #   # #   #   # # #   #   # #     #
# ### # # # ####### ##### ### ### # ######### ### # # ########### ### ####### ### # ### ####### ### # # ### ### # # # # # # ##### #
# #   #   #       #   #   # #     #     #   # #   # # #     #     # #   #   # #   # # #       #   #   #   # #   #   #   #   #     #
# # ############# ### # ### ########### # # # # ### # # ### # ##### ### ### # ##### # ####### ### ####### # # # ############# #####
#   #           # #   # #       #         #   # #   # # # #   #     # #     #   #   #       #   #       # #   #     #   #   # #   #
# ### ######### # ##### # ### # ############# ### ##### # ####### # # ##### ### # ####### # ### ####### # ######### # # # # # # # #
# #   #     #   #     # #   # # #     #       #   #     #         #     # #   #   #       #   #     #   # #       # # #   # #   # #
# # # # ### # ####### # ##### # # ### # ####### ### ##### # ########### # ### ####### ####### ##### # ### # ### # # # ##### # ### #
# # # #   #         # #   #   #   #   #   #   # #     #   #       #   #   #   #       # #     #   #   #   # #   # # #   # # # #   #
# # # ####### ####### ### # ####### ### ### # # ### # # ######### # # ### # ### ### ### # ##### # ##### # # # ##### # # # # ### ###
# # #       # #     #   #   #     # #   #   # #   # # # #       # # #   # # #     # #   # #   # #   #   # # #       # # #     #   #
# ######### # # ### # ####### ### # # ### ### ### ### # ### ### # ### # # # ### ### # # # # # # ### # ##### ######### # ##### ### #
#         # # # # # #   #       # # # # # # # #   #   #     #   #   # # # #   # #   # # # # #   #     #     #     #   #     #     #
######### # ### # # ### # ##### ### # # # # # # ### ######### ##### ### # ### # # ### # # # ##### ##### ##### ### # ####### ##### #
#       # #   # # #   # #     # #   #   # # #   #   #     #       #   #     # # # #   # #   #   # #     # #   #   #   # #   #   # #
# ####### # # # # ### # ### ### # ####### # ##### ### ### ####### ### ##### # # # ### # ### # # ### ##### # # ### ### # # ### ### #
# #       # # # #       #   #   # #       #       #   # # #     # #   #   # # # #   # #   # # #     #   #   #   # #   # #   #   # #
# # ####### # # ######### ### # # # # ##### ####### ### # # ### # # ### # # # ##### # ### # # ####### # # ##### ### ### ### # # # #
# #     #   # #           #   # # # # #   #       # #   #   # # # #   # # # #       # # # # #     #   # #   #   #   #     # # #   #
# ##### ##### ############# ### # ### # # # ##### # ### ##### # ##### # # ########### # # # ##### # ### ### # ### ##### # # # #####
# #     #   #   #       #   #   #     # # #   #   # #         #     #   #         #   # # #   #   # #     # #         # # # #   # #
# # ##### # # ### ##### # ### ######### ##### # ### # ####### ##### ############# # ### # ### # ### # # ### ######### ### # ### # #
#   #     # #         # # #     #       #     #   # # #     #     # #           # #     #     # #   # # #     #   #       # #   # #
# ##### ### ####### ### # ##### # # ##### ####### # # ### ####### # # ######### # ##### ####### ##### ### ##### # ### ##### # ### #
# #     # # #     # #   #   #   # #       #   # #   #   #     #   #   #       # #     # #     #   #   #   # #   #   # #     #   # #
# ### ### # # ### ### # ### ##### ######### # # ####### # ### # ############# # # ### # # ####### # # # ### # ##### ### ####### # #
# #   #   # #   #     # # #     #       #   #   #       # #   # #     #     # # #   #   #       # # # #     #   #   #   #     #   #
# # ### # # ### ####### # ##### ####### # ##### ### # ### # ### # ### # ### # # ### ####### ### # # # ### ##### # ### ##### # ### #
# #   # #       #         #   #   #   # # #       # #   # #   #   #   #   # # #   #       # #   # # # #   #     #     #     # #   #
# ### ################### # ##### # # # # ####### ### # # ### ##### ### # # # ### ####### ### # # # ### ### ########### ##### # ###
#   #     #     #       # #     #   #   # #   # #   # # #   #     # #   # # #   #     #       # # #     #   #   #         #   #   #
### ##### # ### # ##### # ##### ######### # # # ### ### ### ### ### ##### # ### ##### ########### ####### ### ### ####### ### ### #
#   #     # # #     #   #       #       #   # #   #     #   # #   #     # #         #   #         #       # #   #   #   #   # # # #
# ### ### # # ####### ######### # ##### ##### # # ####### ### ### ##### # ############# # ######### ####### # # ### # # ### # # # #
#   # # # #   #       #         #     # #     # #     #   #     #   # # #             # #           #     #   #   # # # # # #   # #
### # # # ### # ##### ##### ######### # # ########### # ##### # # # # # # ########### # ############# ### # ##### # # # # # ##### #
# # # #     # #     # #   #           # # #           #     # # # #   # #         #   #     #         #   #     # #   #   # #     #
# # # ####### ##### ### # ############# # # ### ########### # # # ##### ##### ##### ####### # # ############### # ####### # # #####
#   #             #   # # #     #     # # # # #     #         # #     #     # #     #     # # #         #     # #   #   # # #   # #
# ######### ##### ### # # # ### ### # # # # # ##### # ############### ##### # # ### # ### # # ######### # ### # ### # # # # ### # #
# #       # #   #   # # # # #       # #   # #     # #       #         #   # # #   # # # # # #     #   #   # #   # # # #   #     # #
# # # ### ### # ### # # # # ############### # # ### ####### # ####### # ### # ### # # # # # ##### # # ##### ##### # # ########### #
# # # # #     #   # #   # #               # # # #     #     # #     #   #   #   # # # #         # # # #   #       # # #     #     #
# # # # ######### ##### # ########### # ### # ### ### # ##### # # ##### # ### ### ### # ######### # # # # # # # ### # ### ### # # #
# # # #         #     # # #         # #     #   # #   # #   # # #     # #   # #   #   # # #     # # # # #   # # #   #   # #   # # #
# # # # ############# # # # ####### ####### ### # # ### # # # ##### # # ### ### ### ### # # ### # # # # ##### # # # ### # # ### ###
# # # #         #     # #   #       #     #     # #   #   # #     # #     #   #   #   #   #   #   # #     #   # # # #   #   # #   #
# ### # ####### # ##### ##### ####### ### ####### ### ### ####### ########### # # ### # ##### ############# ### # # # ##### # ### #
#     # #     #   #     #     # #       #         #   #   #       #       #   # #   # # #     #           #   # # # #     # #   # #
####### # ### ########### ##### # ##### # ######### ### ### ####### ##### # ##### ### # # ##### ### ##### ### ### # ##### # # ### #
# #     #   #   #         # #   # #     # #   #   # # # # #       #   # # #       #   # #     #   # #   #   #   # # #   # #   #   #
# # ####### ### # ######### # # # # ### ### # ### # # # # ####### ### # # ####### # ######### # ### # # ### ### # ### # # ### # # #
# #         # #   #     #     # # # #   #   # #   #   #   #     #   # # #       # #       #   # #   # #   #   # #     #   #   # # #
# ########### ##### ##### ##### # # ##### ### # ##### ### ### ### # # # ####### # ##### # # ##### ### ####### # ########### ### ###
#   #       #     #   #   #   #   #   #   # # #     #   # #   #   # # #       # #   # # # #       #       #   #         #   # #   #
# # # ### # # ### # # # ### ######### # ### # # # ##### # # ### ##### # # ##### ### # # # ############### # ####### ##### ### ### #
# #   #   # #   #   # # #   #       # #     # # #   #   #   #   #     # #     #   #   # #     #           # #     #             # #
# ##### ### ### ##### # ### # ##### # ##### # ##### # ### ### ### ##### ##### # # ### # ####### # ### ##### # ### # ########### # #
# #     #   #   #     #     # # #   # #   # #     #   #   #   #   #   # #   # # #   # #         #   # #     # # # # #   #   #   # #
# # ####### # ### ####### ### # # ### # # # ##### ##### ### ### ### ### # # # # # ### ############# # # ##### # # ### # # # ##### #
# #       # #   # #       #   #     # # #       # #     # #   # #         # # # # #   # #         # # # #     #     # #   #   #   #
# ##### # # ##### # ####### ####### # # ######### # ##### ### # # ########### # # # ### # # ### ### ### # ######### # ####### # ###
# #   # # #       #   #   # #   #     # # #       # #       #   # #   #     # # # # #     #   # #   #   # #     #   # #     # #   #
# # # ### ####### ### # # # # # ##### # # # ##### # ##### # ##### ### # ### # # ### # ####### # # ### ### # ### # ### # ### # # # #
# # # #   #       # #   # #   #   #   # # # #   # #     # #     #     # #     #     #       # # # #   #       # #   # #   #   # # #
# # # # ####### ### ##### ####### ##### # # # # # ##### ##### # # ##### ##### ######### ##### # # # ### ##### # ### # ### ##### # #
# # #   #     #   #     #   #   #         # # #     # #       # # #   #   # #   #       #     # #   #   #   # #   # # # #   # # # #
### # ### ### ### ##### ### ### ########### ####### # ######### # # # ### # ### # ####### # ######### ### # # ### # # # ### # # # #
#   # #   # # #           #   # #     #     #   # # #         # # # #     #   # # #     # # #         #   # #   # #   #   # #   # #
# ##### ### # ########### ### # # ### # # ### # # # # ####### # ### ######### # # # ### # ### ######### ### ### # ##### ### # ### #
#     # #   # #     #       #   # #     # #   # #     #       #   #   #       # # # #   #   # #     #   # #   # # #   #     #   # #
# ### # # ### # ### ####### ### # ####### # ### ########### ##### ### ##### # # # # # # ### # # ### # ### ### ### # ### ####### # #
# # #   #   #     #       #   # #     #   # # # #         #     #   # #     # # # # # #   #   # #   # #           #     #   #   # #
# # ####### ####### ##### # ### ##### ### # # # # ####### ##### ### # # ####### # ### ######### # ### ##### ######### ##### # ### #
# #   #   # #     #   # # # #   #   #   # # # #   #   #   #     #   # #       # #   #       #   #   #     #   #     #     #   # # #
# # # # # # # ### ### # # ### ### ##### # # # ##### ### # ####### ### # ##### # ### # ##### # ##### ##### ##### ### ##### ### # # #
#   #   #   # #   #   # #     #   #     # #     #     # # #   #   #   # #   #     # #   #   #   #   #   #   #     # #   #   #   # #
######### ### # ### ### ####### # # ##### ##### # ### # ### # # ##### ### # ####### ### # ##### # # # # ### # ##### # # ### # ### #
#   #   # #   # # #             # #     # #     # #   #   # #   #     #   #         #   #     # # #   # #   #   #   # #   # # #   #
# # # # ### ### # ### ####### ##### ### # # ##### # ##### # ####### # # ##################### # # ##### # ##### # ### ### # ### # #
# #   #     #   # #   #     # #   #   # # #     # #     #   #       # # #     #     #   #   # # # #   # #       #   #   # # #   # #
# ########### ### # ### ### ### # ##### # ##### # ### ########### ### # # ### # ### # # # # # # # # # # ########### ### # # # ### #
# #     #       #   #   # #   # #       # #     #   # #           #   # # # # #   #   #   # #   # # #   #   #     #   # # #   # # #
# # ##### ##### ##### ### ### # ######### # ######### # # ############# # # # # # ######### ##### # ####### # ### ### # ####### # #
# #       #   #     #   # #   # #   #   # # #     #   # #                 #   # # #   #           #         #   # #   # #     #   #
# ######### # ##### ### # # ### # # # # ### # ### # ### ####### ########### ##### # ### ####################### # # ### # ### # ###
# #         # #         #   #   # #   #   # #   # #       #   # #     #   #       #         #         #     #   #   #   # # #   # #
# # ######### ########### ### # # ####### # # # # ### ##### # # # ### ### # ######### ####### ####### # ### # ######### # # ##### #
#   #   #   #     #     # #   # # #     #   # # #   # #     # # # # #   #   #   #   #   #     # #     # # #   #   #   # #     #   #
# ### # # # ##### ### ### ##### # # # ######### ### # # ##### ### # ### ##### # # # ##### ##### # ##### # ##### # # # # ##### ### #
#     # # #     #   #       #   # # #           # # # # #   # #   #   # #     #   #     # #     # #     #     # #   # #   #   #   #
####### ### # ##### ####### # ### # ##### ####### # # # # ### # ### ### # ############# # ##### # # # ### ### # ##### ### # ### # #
#     #   # # #     #   #     #   # #   #   #     # # # #     #   # #   #     #         #     # # # #   # #     #   #     # #   # #
# ####### # ### ##### # # ##### ### ### ### # ### # ### # ####### # # ### ### ### ########### # # ### # # ####### ####### # # ### #
#     #     #   #     # # #   # #         # #   # #   # #   #     # # #     #   #             # #   # # #   #   #       # #   # # #
# ### # ##### ### ##### ### # # ######### # # # ##### # ### ### ### # # ##### # ############### ### # # ### # ### ##### # ##### # #
# # # # # #   #   # #   #   # #     #   # # # # #   #   #   #   #   # # #   # # #   #           #   # # #   #         #   #     # #
# # # # # # ### ### # ### ### ##### # # ### # # # # ##### ### ### # # ### # ### # ### ### ####### ##### # ################# # ### #
#   #     #         #       #         #     # #   #           #   #       #     #       #               #                   #     #
###################################################################################################################################
