#####################################################################################################
#     #   #           #       #   #     #           #   #               #         #                 #
##### # # ### ####### ##### # ### # # # # ### ##### # # ########### ### ### ##### ### # ########### #
#   # # #   #     #   #     # #   # # # # #   #   #   #             #   #   #       # #       #   # #
# # # # ### ##### # ### ##### # ### # # ### ### # ################### ### ### ##### ######### # # ###
# # # #   #     # #   # #   # # #   # #     #   #         #         #     #   #   # #       # # #   #
# ### # # ##### # ### # ### # # # ### ####### ########### ### ######### ##### # # # # ##### # # ### #
# #   # # #       #   #   #   #     #       #     #     #   #   #     # #   # # # #   #   # #     # #
# # ### # # ######### ### # ######### ##### ##### ### # ### ### # ### # # # ### # ##### # # ### ### #
#   #   # # #       #   # #         #     # #   # #   # # #   # #   #   # #     # #     # #   # #   #
# ### ### ### ##### ### # ######### ##### # # # # # ### # ### # # ####### ####### # # ### ### ### # #
# #     #         #   #   #   #     #   # #   # #   #     #   #   #   #   # #     # # #     #     # #
# # ################# ####### # ##### ### ##### # ######### ### ### # # ### # ##### # # ########### #
# # #         #     #   #     # #   #         #   #       # #     # # # #   #     # # #   #       # #
# ### ####### # ### ### # ##### # # # ############# ##### # ##### # # # ### ##### # # ### # ### # # #
# #   #     # #   #     #     #   # # #         #   #     #   #   # #   #   #     # # #   # #   # # #
# # ### ##### ### ####### ### ##### ### ####### # ### ##### # ##### ##### ### ####### ##### # ##### #
# #   # #   #   #   # #   # #     # #   #     #   #   # #   #   #   #     #   #       #     #       #
# ### # # # ### ### # # ### ##### # # ### # # ##### ### # ##### # ##### # # ### # ### # #############
#     # # #   #     #         #   #   #   # # # #   #   # #   # # #     # #   # # #   #   #   #     #
####### # ### ####### ####### # # ##### ### # # # ### # # ### # # # # ####### # # ### ### # # ##### #
#     #   # #   #   # #     # # # #   # #   #   # #   # #     #   # #       # # #   # #   # #     # #
# ### # ### # # ### # # ### ### # ### # # ####### # ### ##### ############# # # ### ### ### ##### # #
#   #   #   # #   # # #   # #   #     # #       # #   #     #               # #   # #   #   #     # #
### ####### # ### # # ### # # ######### ####### # ######### ##### ########### ### # # ##### # ##### #
#   #       #   #   # #   #   #   #   #       #   #     #     #   #     #   # #   #         #       #
# ##### ### ### ##### # ####### # # # ####### ##### ### # ### # ### ### # # # ##################### #
#   #   # #   #   #   #         #   #       #       #   #   # # # # #     # #         #       # #   #
### # ### ### ### # ################### ### ######### ### # # # # # ####### ######### ##### # # # ###
# #   #     # # # # #     #       #     #   #       # #   # # #   #   #   #       #   #     #   #   #
# ##### ##### # # # # ##### # ### # ##### ### ##### # # ### ##### ### ### ####### # ### ####### ### #
#       #     # # # #     # #   # #   #       #   # # # # #     #   #   #       # #   #       # #   #
# # ##### ##### # # # ### # ### # ### ####### # # # # # # ##### ### ### ### ### # ### # ##### ### ###
# #       #     #   #   #   # # #   #   #   # # # # # #       #   # # #   # #   #   # # #   #   #   #
# ############# ####### ##### # ### ### # # ### # # # ####### ### # # ### ### ##### # # # ##### ### #
# #               #   # #   # # #   # #   #     # # #   #     # #   # #   #   #     # #   #   # #   #
# ####### ####### # # # # # # # # ### ####### ### ##### # ##### ##### # ### ### ##### ### # # # # ###
#         # #   #   # #   #   # #       #   #   #     # # # #       # #   #   #   #   #   # # # # # #
########### # # ##### ####### # ######### # ### ### ### # # # ### # # ### ### ### ### ##### # # # # #
#             #   # #     #   # #   #     # #     # #   # #   #   #     #   #   # #   #     #   #   #
########### ### # # ##### # ### # # # ##### ### ### # ### ### # ####### ### ### # # ### ########### #
#         # #   #     #   # #   # # #   # #   # #   #   #   # # #     #   #   #     # #     #       #
# ####### # # ### ##### ##### ### # ### # ### ### # ### ### ### # ### ### ### ####### # ### # #######
# #     # # # #   #     #     #   #     #     #   # #   #       # #     #   #   #     # # # #       #
# # ### # ### # ### ####### ### ### ##### ##### ### # ### ####### ##### ####### # # ### # # ####### #
# #   # # #   # #   #     #   # #   #   #     #   # # #   #     #   # # #     # # #     # #         #
# # ### # # ##### ##### # ### # # ### # ##### ### # # ### # ### ### # # # ### # # ####### ###########
#   #   #   #     #   # #     # #   # # #   #     # #   # # # # #   # # # # # # #             #     #
# ### ####### ##### # # ##### # ##### # # # ####### ### # # # # # ### # # # # # ############# ##### #
#   # #     #       #   #   # #   #   # # # #     #   # # # #     #   # # #     #       #     #     #
### # # ### ############# # # ### # ### ### # ### ### # # # ####### ### # ############# # ##### ### #
# # # #   #               # # # # # # # #   # #     # # # #       # #   #     #     #   #   #     # #
# # # ### ### ######### ##### # # # # # # ### # ### # # ### ##### # # ####### # # # # ##### # ### # #
# # #     #   #     #   #   # # #   # # #     #   # # #   # #   # # # #       # # # # #     # # # # #
# # ####### ##### # # ### # # # ##### # ######### ### ### # # # # # # # ####### # # # # ##### # # # #
#   #     # #   # # # # # #           #         #   # # # # # #   #   # #     # # #   # # #     # # #
# ### # # # # # ### # # # ########### ######### ### # # # ### ##### ### # ### # # ##### # # ##### # #
#   # # # #   # #   #   # # #       #     #   # #   #   #   #   #       #   # # #   #   #   #     # #
### # # ####### # ##### # # # ##### ##### # # # # ##### ### # # ############# # ### # ##### # ##### #
#   # #       # #     # #   # #   #   #   # #   #   #   # # # #         #     # # #   #   # #     # #
# ### ####### # ##### # ### # # ##### # ### ##### # # ### # # ######### # ##### # ##### # # ##### ###
# #         # #     #   #   # #       #   # # #   #       # #   #     # #     # #       # # #   #   #
# ########### ##### ##### ### ### ######### # # ########### ### # # # # ### # # ##### ### # # # ### #
#       #   #   #   #     # #   # #         # #   #   #   #   # # # # #   # #   #   #   # #   #   # #
####### # # # # # # # ##### ### # ##### ##### ### # # # # ### # ### ##### # ##### # ### # ####### # #
#   #   # # # # # # #   #   #   #       #   #   # # # # #     #     #     #       # #   #   #   # # #
# # # ### # # # # ##### # # # ############# # # # ### # ########### # ############# # ##### # ### # #
# # #     #   # #         # #   #       #   # # # #   # #       #   #   #       #     #     #     # #
# # # ######### ############### # ##### # ### # # # ### # # ### # ##### # # ##### ######### ####### #
# # # #       #     #         # # #       #   #     #   # # # # # #   # # # #       #     # #       #
# ### # ##### ####### ####### # # ####### # ######### ##### # # # ### # # ### ####### ### # # ##### #
# #   #     #         #     # # #     # # #     #   # #     # # #     # #     #   #   #   #   # #   #
# # ####### ########### ### # # ##### # # # ##### # # # ##### # ##### # ##### # # # ### ####### # ###
#   #       # #       # #   #   #     #   # #     #   # #           # #     # # #   #   #         # #
# ### ####### # ### # # # ####### # ##### # # ######### # ######### # ##### ### ##### ### ######### #
# #   #       #   # #   # #       # #   # # #         # #   #   #   #     #   #     #   # #         #
# # ####### ### ### ##### # # ##### # # ### ######### # ##### # ### ######### ##### ### # ##### #####
# # #     #     #   #   # # # #   # # #   #       # # #       #   #       #       # #   #   #   #   #
# # # ### ### ### ### # # # # # # # # ### ####### # # ####### ### ####### # ### ### # ##### # ### # #
# # # # #   # #   #   #   # # # # # # # #     #   # #       #   #     #     #   #   # #     #   # # #
### # # ### # # ### ####### # # # # # # ### # # ### ####### ### ##### ########### ### # ####### # # #
#   # # #   # # #   #       # # # # #     # # # #         #   #     #             #   #     #   # # #
# # # # # ### # # ### ### ##### # ####### # # # # # ######### ##### ############### ####### # # # # #
# # #   # #   # #   # #   #   # # #   #   # # #   # #     #   #   #   #     #     # #   # # # # # # #
# ##### # # ### ### ### # # # # # # # # ### # ##### # ### # ### ##### # ### # ### # # # # # # ### # #
#       # # # # #       # # #   #   # #   # # #     # # #   #       # #   # #   #   # #   # #     # #
# ####### # # # ########### ####### # # ### ### ##### # ##### ### ### ##### ### ##### # ### # ##### #
#       # #   # #       #   #     # #   #   #       # #     #   #             # #     # #   # #   # #
### ##### ##### # ##### # ### ### ### ### ### ####### ### # ####### ######### # # ### ### ### # ### #
#   #     #     # #   # # #   # #   # # #   # #       #   #       # #       # # #   # #   #   # #   #
# ### ##### ### # ### # # # ### ### # # ### # # ####### ######### # # ##### ### ### # # ### ### # ###
# #   #     #   # #   #   #     #   #   # #   #   #     #     #   # #   # #     #   #   #       #   #
# # ### ### ##### # ####### ##### ##### # ####### # ##### ### # ### ### # ####### ############### # #
# # #     #       #       # #     #             #   #       # #   #   # #       # #             # # #
### # ########### ### ##### # ##### ########### ##### ####### ### ### # ### ### # ####### ##### # # #
#   # #         #     #     #     # #         # #     #         #   # #   # #   #       # #   # # # #
# ##### ####### # ##### ######### # # ####### ### ##### ########### # ### # # # ####### # # ### ### #
# #   #   #   # # #     #     #   # # #     # #   #     #     #   # #   # # # #     #   # # #   #   #
# # # ### ### # ### ##### ### # ##### # ### # # ### ##### ### # # # ##### # # ####### ### # # ### # #
#   #         #           #   #         #   #     #         #   #         # #             #       # #
#####################################################################################################
