#########################################################################################################################
# #     #             #       #         #         #     #         #     #     #       #                           #     #
# # ### # ### ####### # # ##### ### ### ### # ### # ##### ### ##### # # # # ### ##### # ######### ############### # ### #
# #   # # # #     # # # #       #   # #   # # #     #   # # #       # # # #   #     #   #     #   #         #     #   # #
# ### # # # ##### # # ##### ##### ### ### ### ####### # # # ######### ### ### ##### ####### # # ### ####### # ####### # #
#     # #   #   # #   #   # #     #     #   #     #   #   #         #   # # #     # #     # # #     #     # #   #     # #
####### ### ### # # ### # ### ##### ### ### ### # # ####### # ##### ### # # ### ### # ### # # ####### ### # ### # ##### #
#       #       # #     # #   #     #     #   # # # #       #   # #   #   #   #   # # # #   #     #   #   # #   # #   # #
# ####### ####### ####### # ### ### ######### ### # ### ####### # ### ####### ### # # # # ####### # # ##### # ### # ### #
# #   #   #   #   #   #     #   #   #         #   #   #   #   # #   #       #   #     #   #     #   # #   # # #   # #   #
# ### # ### # # ### # ########### ### ######### ##### ##### # # ### ####### ### ########### ### ####### # # # # ### # ###
#   #     # #   #   #   #       #   # #         #     #     #   #         #   #   # #       #   #       #   # #     #   #
### # ##### ##### ##### # ##### # # # ######### # ##### ######### ##### ##### # # # # ####### ### ################# ### #
#   # #   #     # #   # #     # # # #     #   # #       # #       #   # #     # #   # #     #     #       #     #     # #
# ### # # # ### # # # # ##### # # # ##### # # # ######### # ### ### # # # ##### ##### ### # ### ### ##### # ### # ##### #
# # # # # #   # #   # #   #   # # #     # # # #           # # #     # # # #     #   #   # # #   #   #   # # #   #   #   #
# # # # # ##### ##### ### # ### # ##### # # # # ####### ### # ####### # # # ### # # ### # # # ### ##### # # # ##### # # #
# #   # #     # #       #   #   #     # #   # #     # #     # #     # # #   #   # #     # # # #   #     #   #       # # #
# ##### ##### # # ########### ####### # ##### ##### # ####### # ### # # ### ##### ####### # # # ##### ######### ##### # #
# #     # #   #     #   #     #       #     #   #     #       # #     #   # #   # #       # # # #     #   #   #     # # #
# # ##### # ##### ### # # ####### ##### ### ### ##### # # ### # ########### # # # # ##### ### # # ### # # # # ####### ###
# # #     #     # #   #   #     #   #   #     #   #   # # # # #     #   #   # #   #     #     # #   # # #   # #     #   #
# # # ######### ### ####### ### ##### ##### ##### # ##### # # ##### # # # ### ################# # # # # ##### # ### ### #
# # # #       # #   #         # #   #     # #     #   #   #   #   #   #   # #     #             # # # # #     #   #     #
# # # # # ##### # ######### # # # # ##### # # ####### # ### ### # ######### ##### # ############# # ### # ##### # #######
#   #   #     #   #       # # # # # #   # # # #     #   # #     # #   #         # #     #       # # #   #   #   #       #
##### ####### ##### ##### # # # # # # # # ### # # ####### ####### # # ##### ### # ##### ### # # ### # ##### ### ####### #
#   #   #   #       #   # # # #   #   #   #   # #   #       #       #   #   # # #     #   # # #     # #   #   #     #   #
# # ### # ### ####### ### ### ########### # ### ### # # ##### ######### # ### # ##### ### # # ### ### # ##### ### ### # #
# #   # #   # #   #           #       #   # #   # #   #   #   #   #       #   #     #   # # # # # #   #     #   # #   # #
# # # # ### # # # ################### # ### # ### ####### # ### # ######### # ##### ### # ### # # # ##### # ### ### #####
# # # # #   #   #   #     #         # # #   #           # #   # #     #     #       # # #     #   #     # #   # #   #   #
# # # # # # ####### # ### # ####### # # # ####### ##### # ### # ##### ####### ####### # ####### ####### ### # # # ### # #
# # # #   #   #   #   # #   # #     #   # #       #   # #     #   # #   #   # #   #   #         #     #   # # # #     # #
### ######### # ####### ##### # ### ##### ### ##### # ##### ##### # ### # # # # # # # ########### ### ### # # # # ##### #
#   #         #         #     #   # #   #   # #     #     #   #   #       # #   # # #   #         #     # # #   #   #   #
# ### ############### # # # # ### ### # ### ### ######### ##### ### ####### ##### # ##### ##### ######### ##### ##### # #
#   # #           #   # # # # # #     #   #   #   #   #   #   #   # #   #       # # #     #   # #         #   #     # # #
# # # # ####### # # ### ### # # ####### # ### # # # ### ### # ### # # # ####### # # # ##### # # # ######### # ##### # # #
# #   #   # #   # #   #   # # #     # # #   # # # #     #   #     # # # #     # # #     #   #   # #   #     #   # #   # #
# ####### # # ### ### ### # # # # # # # ### # ### # ##### ######### # # # ### # # ##### # # ##### # # # ####### # ##### #
#     # # # #   #   #   #   # # # #   # #   #     #     # #   #     # #     # # #   #   # # #   # # #   #   #   #   #   #
##### # # # ### ### ### ##### ### # ### # ############# # # # # ##### ####### # ### ##### # # # # # ##### # # ##### # ###
# #   #     # #   #     #   #     # #   # #   #       # #   # #     # #       #   #       # # #   # #     # # #     # # #
# # ####### # ### ####### ### ####### ##### # # ##### # # ### ### ### # ######### ######### # ### # # ##### # # ### # # #
# #     #   #   #     #       #     # #     #   #   #   #   #   # #   # #       # #     #   # #   # #   #   # #   # #   #
# ##### # ### ####### ### ##### ### # # ########### ######### # ### ### # # # ### ##### # ### # ### ### # ### # # ##### #
#     # #     #     #   # #   #   # #   # #       #     #   # #     #   # # # #   #   #   #   #   #     #   # # # #   # #
# ### # ####### ### ### # ### ### # ##### # ### # # # # # # # ####### ##### # # ### # ##### ##### ##### ##### # # # # # #
# #   #       #   #   # #       # #   #     #   # # # #   # #   #   # #     # #     #   #   #   # # #   #   # # #   # # #
### ######### # # ### # ### ##### # # # ##### ### ### ##### ### # ### # # ############# # ##### # # # ### # # # ##### # #
#   #     #   # # # #   #   #     # # #     #   #   # #   # #     #   # #             # #   #   #   # # # #   #     #   #
# ### # ### ### # # ### ##### ##### ####### ### ### # # ### ####### ### ########### ### # # # ##### # # # ######### #####
# #   # #   #   # #     #   # #   # #       # # # #   #   #         # # #         # #   # # #       #   #         # #   #
# # ### # ####### # ##### # # # # # # ####### # # ##### # ########### # # ####### # # ##### ########### ######### # # # #
#     # #     #   #     # # # # # # #   #     # #     # #       #     # #     #   #   #   # #             #   #   # # # #
####### ##### # ######### # # ### # ### ### # # # ### # ####### # ### # # ##### ####### # # # ############# # # ### # # #
#       #     # #         #   #   #   #   # # # # #   # #     # # # #   # #     #       #   # #         #   # # #   # # #
# ##### # ##### # ############# # ### ### ### # ### ### ##### # # # ##### # ### # ### # ##### # ### ##### ### # # ### ###
#   #   #   # #   # #     #     # #   # #   # #   #   #       # #       # # #   #   # # #   # #   # #   # # #   # #     #
# # # ##### # # ### # ### # ### ### # # ### # ### # # ####### # ####### # # ####### # ### # # ### ### # # # ##### # ### #
# # #     # # # #     #   # #   #   #     # #   # # #       # #   #     # #         #     # #   # #   #   #     # # #   #
# # ####### # # # ##### # # # ### # ####### # ### # ### ### # # # # ##### ########### ##### ### # # ######### # # ### # #
# #         # # # #     # # #   # # #         #   # # # #   # # # # #       #       #   #     #   #   # #     # #     # #
# ########### # ### # ##### ### # ### ######### ### # # # ### # # # ######### ##### ##### ####### ### # # # ########### #
# #       # #   #   # #     #   #   # #         #   # # #   # # # # #       # #     #   #       #   # #   # #     #   # #
# # ##### # # ### ### # ##### ##### # # ######### ### # ##### # ### # ##### # # ##### # ### # ##### # # ### # ### # # # #
# #   # # # #   #   # #   # #     #   #         # #   #   #   #     #   # #   #   #   #   # #       # #   #   # #   #   #
# ### # # # ### # # ##### # ##### ############# # # # ### # ########### # ####### # ##### ########### ##### ### #########
#     #   # #   # #     # #   #     #           #   #   # #   #         #       # # #   #           #     #     #       #
####### ### # ### ##### # # # # ##### ################# # ### # ######### ##### # # # ############# ##### ##### ### ### #
#     # #   # # # #   # # # # #   #   #     #         # #     # #   #   #   # # #   # #     #     #     #   # #   #   # #
# # # # # ### # # # ### # # ##### # ### ##### ####### # ####### # # # # ### # # ##### # ### # # ####### ### # ### ### # #
# # # # #     # #   #   #   #     # #     #   # #     #       # # #   # #     # #     # #   # #       #   # #     #   # #
# # ### # ##### ### # ##### # ##### ##### # ### # ### ####### # # ##### ####### # # ### # ### ####### ### # ### ####### #
# # #   #     #     #     # # #   #     # #   # #   # #     # #       #       #   #     #           # #   #   # #     # #
# # # ####### # ####### ### # # # ##### # ### # ### # # ### # ##### ##### ### # ################### # # ##### # # ### # #
# # # #     # # # #   # #   #   #     # # #   #   # # # # #   #   # #   # #   #       # #     #     #         #   # # # #
# # # # # ### # # # # # # ####### ### # # # ### # # # # # ##### # ### # # # ######### # # ### # ################### # # #
# #   # #   # #   # # #       # #   # # #   #   # # # # #   #   #     # # #     #       # # # # #       #           # # #
# ######### # ### # # ####### # ### # # # ####### # ### # # # ######### # ##### ##### ### # # ### ##### ####### ### # # #
# #     #   # #   # #       # # #   # # #       # #   # # #   # #   #   # #   #     # #   # #         # #       #   # # #
# # ### # # # ##### ####### # # # # ### ####### # ### # # ##### # # # ### ### ##### ### ### ########### # ########### # #
#   #   # # #       #       #   # # #   #   #       # # # #     # #   # #   #     #     # #     #       #       #   # # #
##### ### # ######### ########### # # ### # # ####### # # # ### # ##### ### # # # ####### # # ### ############# # # # # #
#   #   # #         #           # # #     # #   #     # # # # #   # #     # # # # #       # #   #             # # #   # #
# ##### # ##################### # # ####### ##### ##### # # # ##### # # ### # # ### # ### # ### ############# # # ##### #
#       # #     #     #   #   #   # #     # #   #     #   #   #     # #     # #     #   # #   #     #         #   #     #
# ####### # ### # # # # # # # ##### # ### # # # ##### ####### # ### # ########### ##### ##### # ### # ######### ### ### #
#       # #   #   # #   #   #     # # # # # # #     #         # #   # #   #     #   # #       #   # # # #       #     # #
####### # ### ##### ##### ######### # # # # # ##### ##### ##### # ### # # ### # ### # ########### ### # # ####### ### # #
#   #   #   #   # # #   # #     #   # # # #   #   # #   # #   # #   #   #     #   # #           # #   # #     # # #   # #
# # # ### # ### # # # # # # ### # ### # # ####### # # # # # # # # ############### # # ######### # # ### ##### # # # #####
# # #   # # # #   # # #   # #   # # #   #     #   # # # #   # # # #     #         #   #     #   # #   # #     #   #     #
### ### # # # ### # ### ### # ### # ### ### # # # # # # ##### # ### ### # ######### ### ### # ### ### # # ############# #
#   #   # #     # #   # #   #   # #       # #   # #   # #   # #   # #   # #     #   #   # # # #   # # #             #   #
# ### ### ####### ### ### ##### # ######### ######### # # ### # # # # ### ### # # ### ### # ### # # # ############# # ###
#     #     #   #   #       #   #           #       # # # #   # #   #   # #   # # #   #   #     # # #   #         # #   #
# ##### ### # # ### ######### # ########### # ##### ### # # ####### ### # # ### # # ### ######### # ### # ######### # # #
#     #   #   #   #     #   # # #   #     # # #   #   # # #       #   #     # # # #   #   #     # #   # #   #       # # #
##### ### ####### ### ### # # ### # # ### # # # ##### # # ####### # ######### # ### # ### # ### # # # # ### # ####### # #
#   #   #       #   # #   # # #   #   #   # # #       # #       # # #       # #   # #   #   # # #   # #   # #     #   # #
### ### ####### ### # # ### # # ##### # ### # ### ##### # ##### # # # ##### # ### # ### ### # # ##### ### # ##### # ### #
#     #     #   # #   #   # #   #   # #     #   #       #     # # # # #   # #   # #   #   # # #     # #   #     # # #   #
# ######### # ### ####### # ##### # ########### ############# # # ### # # # # ### ##### # # # # ##### # ##### ### # # # #
# #     #   # #       #   # #     #           #   #           # #     # # # #   #     # # # # #       #     #     # # # #
# # ### # ### # # ### # ### # ############### ### ##### # ############# # # ### ##### # # # # ############# # ####### # #
# #   #   # # # #   # # # #   #             # #   #     # #     #       # #   #   #   # # #       # #       #         # #
# ### ##### # # ### # # # ##### ### ######### # ### ####### ### # ### ### ### ### # ##### ####### # # ################# #
#   #     #   # #   # # #     # # #     #     # #   #     #   #   # # #   #   #   # #     # #   # # # #   #     #       #
# ####### # ### # ### # ##### # # ##### # ##### ### # ### ### ##### # ### # ### ### # ##### # # # # # ### # # ### #######
#     #   # # # #   # # #   # #     # #   #     #   #   #   # #     #   # #   #       #   #   #     #   #   # #   # #   #
# ### # ### # # ### # # # # # ##### # ##### # ### ##### ### # # ### ### # ### # ####### # ############# ### # # ### # # #
#   #   #   #     # # #   # #       #   #   #   #         # #   #     # # #   #     #   #         #   #   # # # #     # #
### ##### ######### # ##### # ####### # ####### ##### ##### ##### ##### ### ######### ########### # # ### ### # # ##### #
#   #               # #   # #     #   #       # #   # # #     #   #   # #   #       #   #       #   # #   #   # #     # #
# ### ##### ########### # # ##### # ######### # # # # # # ##### ### # # # ### ##### ### ### # ####### # ### ### # ##### #
# #   #   # #     #     # # #     #   # #     #   # # # #       #   #   #     #   #     #   # #     # #   # #   # #   # #
# ##### # ### ### # ##### # # ####### # # ######### # # ######### ############# # ####### ##### ### # ### # # ##### # # #
#       #     #     #       #         #             #           #               #                 #       #         #   #
#########################################################################################################################
