###############################
# #           # #             #
# ##### ##### # # ########### #
#       #   # # # #           #
######### ### # # # ######### #
# #     #   # #   # #       # #
# # # ### # # ##### # # ##### #
#   #     # # #     # #       #
# ######### # # ##### #########
# #   #     #   # #   # #     #
# # # # ######### # ### # # # #
#   # #     #     # #   # # # #
##### ##### # # ### # # # # # #
#   # #   # # # #   # # # # # #
# ### # ### # # # ### ### # # #
#     #   #   #   #       # # #
# ####### ######### ####### ###
# #       #     #         #   #
# # ##### ### # ### ######### #
# #     # #   #   # #       # #
# # ### # # ##### # # ##### # #
# # #   # # #   # # #     # # #
# ### ### # # ### # ##### # # #
# #   #   # #   # #   #   # # #
# # ### ### ### # ##### ### # #
# # #       #   # #     # # # #
# # ######### # # # ##### # # #
# #   #       # # # #       # #
# ### # # ####### # # ####### #
#     # #           #         #
###############################
