#############################################################
# #           # #                 #           #     #   #   #
# ##### ##### # # ############# # # ##### ### # ### # # # ###
#       #   # #   #           # #   #     # #   # #   # #   #
######### ### # ### ######### ####### ##### ##### ##### # # #
#   #       # #   # #       #       #     #     #   #   # # #
# ### ##### # ##### ####### ####### ##### # ### # # # ##### #
# #     #   # #     #       #   #   #     #   # # #   #     #
# # ##### # # # ##### ##### # # # ### ##### # ### ##### ### #
# #   #   # #   #     #   # # #   #   #   # #   #       #   #
# ### # ### ##### ### # # ### ##### ##### # ### ##### #######
# #   # #       #   # # # #   #     #   #   # #       #     #
# # ### ####### ### # # # # ##### # # # # ### ######### ### #
#     #   #   # # # #   #   #   # # # # #     #       # #   #
######### # ### # # ######### # ### # # ##### # ### ### # # #
#     #   #       #     #   # #   #   # #   # #   # #   # # #
# ### # # ############# # # # ### # ### # ### ##### # ### ###
# # #   # #         # #   # #   # # #   #     #   # #   #   #
# # ##### # ##### # # ##### # # # ### ### ##### # # ### ### #
# #   #   # #   # #     #   # # # #   # # #     # # #     # #
# # ### ### # ### ####### ##### # # ### # # ##### # # ##### #
# #     #   #   #         #     # # #       #       # #     #
# # ##### ##### ########### ##### # ######### ####### # ### #
# # #   # #   #     #       # #   #   #     # #     # # #   #
# # # ### # # # ### ####### # # ##### # ### ### ### # # #####
# #   #   # # #   #         # # #   #     #       #   #     #
# ### # ### # ### ########### # # # ############# ######### #
# #   #     #     #     #       # #           # #     #     #
# ################# # ### ####### ########### # ##### # #####
#         # #       #     #         #       # #     # #     #
# ##### # # # ################### # ##### # # # ### # ##### #
# #     # # # #                 # #     # #   #   # # #   # #
### ##### # # # ############### ####### # ##### # ### # # # #
#   #   #   #   #   #     #   # #   #   #     # #     # #   #
# ### # ### ##### # # # # # ### # # # ####### ######### ### #
#     # # #     # #   # # #   # # #   #       #     #   #   #
# ##### # ##### # ##### # ### # # ########### # ### # ### ###
# #   # #       # #   # #     # # #         #   #     #     #
# ### # # ####### # # # ####### # # ##### # ############### #
#     # #   #   # # # #         #   #   # #   #           # #
### ### ### ### # ### ############### # ##### # ######### ###
#   #   # #     # #   #               #       #   #   # #   #
##### ### ##### # # # # ##### ############### ### # # # ### #
#     #     #   # # # # #   #           #   #   #   #     # #
# ####### # # ### # # # # ############# # # ############# # #
# #       # #   # # # #   #   #         # #         #   # # #
# # # ######### # # ##### # # # # ####### ####### ### # # # #
# # #       #   # #     # # # # # #       #     #   # #   # #
# ######### # ### # ### # # # # ### ######### # ### # ##### #
# #       # # # # #   #   # # #     #   #     #   #   # #   #
# # ##### # # # # # ####### # ##### # # # ####### ##### # ###
# #     # #     # # #       # #   #   # #   #   #   #   #   #
# ##### # # ##### # # ####### # # ##### ### # # ### # # ### #
# #     # # #     # #       #   #     #     # # #   # # #   #
# # ##### # # ##### ####### ######### ######### # ##### # ###
# # #   # # # #     #       #   #     #   #   #         #   #
# # # ### # # # ##### ####### ### ##### # # # ######### ### #
#   #   # # # #   #   #       #   #     #   #   #       #   #
# ##### # ### ##### ### # ##### ### ########### ######### # #
#       #           #   #           #                     # #
#############################################################
