###############################
#   #                     #   #
### ##### ####### ### ### # # #
# #     # #     # # # #     # #
# ##### # # ### # # # #########
#     # # # # # # # #         #
##### # ### # # # # ######### #
#     #     #   #       # #   #
# ### ####### ######### # # # #
#   #       # #           # # #
# # ####### # # ########### ###
# # #   #   # #   # #     #   #
# # # # ##### ### # # ### ### #
# #   # #     #     #   #     #
# ##### # ############# ##### #
# #   # # #   #         #   # #
# # # # # # # # ######### # # #
# # #   # # #   # #     # #   #
### ##### # ##### # # ### #####
#   #   #   #   #   #   # #   #
# ### # ##### # # ##### # ### #
#   # #     # #   #   # #     #
# # # # ##### ##### # # ##### #
# #   # #   # # #   #     #   #
# ##### # # # # # # ####### ###
#   # #   #   # # # #   #   # #
### # ######### # # # # # ### #
# # #       #   # # # #   #   #
# # ##### # # # # ### ##### # #
#         #   # #           # #
###############################
