#####################################################################################################
# #           # #               #       #       #   #             #           #   #         #       #
# ##### ##### # # ############# # ### # ##### # # ### ### # ####### ##### ### # # # ####### # # ### #
#       #   # # # #           #     # # #     #   #   #   # #           #   # # #   #     # # # #   #
######### # # # # # ######### ####### # # ######### ### ### # ########### # ### ####### # # # # # ###
# #       # # #   # #   #   #       # #   #         # #   # # #     #   # #   #       # # #   # # # #
# # ####### # ##### # # # # ####### # # ### ##### ### ### ### # # ### # ##### ####### ### ##### # # #
#   #       # #     # #   # #   #   # # #   #   #       #       # #   #       #     #     #     #   #
# ### ##### # # ##### ##### # # # ### ### ### # ######### ####### # ######### ##### ##### # ####### #
# #   #   # #   #     #   # # #   #         # #     #   # #   # # # #   #   # #     # #   # #   # # #
# # ### ### ##### ### # # ### ##### ######### ##### # # ### # # # # # # ### # # ### # # ### # # # # #
# # #     # #   #   # # # #   #     #         #       #     # #   #   #   #     #     # # #   # #   #
# # ### # # # # ### # # # # ##### ### ##### ################# ######### # ########### # # ##### # ###
# #   # #     # # # #   #   #   # #   #   # #   #   #         #       # # #   #     # # # #     # # #
# ### ######### # # ######### # ### ##### # # # # # # ####### # ##### ### # # # ### ### # # ##### # #
# # #     #       #     #   # #   #     #   # #   # #   #   #   #   #   # # #   # #   #   #   # # # #
# # ##### ############# # # # ### # ### # ### ##### ##### # ##### ##### # # ##### ### ### ### # # # #
#     #   #           #   # #   # # #   # # # #   #       #     # #     #   #       #       # # #   #
####### # # ##### ### ##### # # # ### ### # # # # ############# # # ##### ### ##### ######### # ### #
#     # # # #   # #     #   # # # #   #     #   #   #           #   #       #   #   #   #     # #   #
# ### # ### # ### ####### ##### # # ######### ##### # ############# ####### # ### # # ### ##### # ###
# # # # #   #   #         #     # #           #   # # #           #       # # #   # # #   #     # # #
# # # # # ##### ########### ##### # ########### # ### # ######### ####### # ### ### # # ### ### # # #
# #     # #   #     #       # #   # #   #   #   #   #       #   #   #   # #   # # #   # #   #   # # #
# ### ### # # # ### ####### # # ### # # ### # ##### ######### # ### # ### ### # # ### # ### ##### # #
#   # #   # # #   #         # # # # # # #   #   # #       #   #   # #     #     #     # #   #     # #
### # # ### # ### ########### # # # # # # ##### # ####### # ##### # # ########### ##### # # # ##### #
#   # #     #     #     #       # # # # # #     #           #   #   #     #   #   #     # # #     # #
# ################# # ### ####### # # # # # ### ############# # ######### # # ##### ##### ####### # #
#   #       #       #     #       # # #   #   # #         # # #       #   # #     #     # #     # # #
### # ### ### ################### # # ####### ### ####### # # ### ### # ### ##### ##### # # ### # # #
#   #   #   # #                 #   #       #   #       # #   # # #   #   # #   # #     # #   #   # #
# ##### ### # # ############### # ######### ### ### ##### # ### # ####### # ### # # ##### ### ##### #
#     #   # #   #   #       # # # #       #   #   # #     # #   #       #   #   # # #     #   #     #
# ### ### # ##### # # # ### # # # ### ### # # ### # # ##### # ######### ##### # # # ### # # ####### #
# #   #   #     # #   # # #   # #     # #   #   #   #   #     #               # #   #   # # #       #
### # # ##### # # ##### # ### # ####### ####### ####### ##### # # ########### ####### ##### # #######
#   # #   #   # # #   # #     # # #             #     #     # # # #         # #           # #       #
# ####### # ##### # ### ####### # # ############# ### ##### # # # # ####### ### ######### # # ##### #
#   #     #     # #   #         #   # #           # # #   # # # # # #     # #   #         # #   #   #
# # # ######### # ### ########### ### # # ######### # ### # ### ### ### # # # ### ##### ### ### # # #
# #   #     #   # #   #   #     # # #   #   #       # #   #   # #   #   # # # # # # #   #   #   # # #
# ##### ### # # # # ### # # # ### # # ##### # ### ### # # ### # # ### ### # # # # # # ### ####### ###
# #   #   #   # # #     #   #     #   #   # #   #     # # # # #   #   # # #   # # #     # #     #   #
# # # ### ##### # # ############### ### # # ### ####### # # # ### # ### # ##### # ##### # # ### ### #
# # # #   #     # #     #         # #   # #   # #       #   #   #   #     #     #   # # #   # #     #
# # # # ### ##### ##### ######### # # ### ### # # # ########### # ##### ### ####### # # ##### ##### #
# # # # # #   # # # #   #       #   # # #     #   # #     #     # #   #     #     # # #   #   #     #
# # ### # ### # # # # ### ##### ##### # ########### # ### # ####### # ##### # ### # # ### # # # #####
# #   # #   # # # # # #   #   #     # #   #       # # #     #     # #   #   # # #   #   # # # #     #
# ### # ### # # # # # ### # # ##### # ### # ### ### # ####### ### # ### ##### # ##### ### # # ##### #
# #   #   #     # # #   # # # #   #   #   # # #     #   #   # #     # # #     #     #   #   # #     #
# # ##### ####### # ### # # # # # ##### ### # ######### # # # ####### # # ##### # # ### ##### # #####
# #     #   #     #       # # # #     #   # #       # #   # #   #       #   # # # #       #   # #   #
# ### # ### # ##### ####### # ##### ### # # ##### # # ##### ### # ####### # # # # ######### ### ### #
# #   #   # # #     #       # #   #     # # #     #   # #   #   #     #   # # # #       #   # # #   #
# # ##### # # # ##### ####### # # ##### # # # ####### # # ### ####### ##### # # ####### # ### # # # #
#   #   # # # #     #       #   #     # #     #   # #   # #         # #     # #   #   #       # # # #
##### # # # # ############# ######### # ####### # # ### # ### ##### # # ##### ### ### ######### # ###
# #   #   # #       #       #   #     # #       # #     #   #   #   #   #       # #   #         #   #
# # ####### ####### # ####### ### ##### # ####### ######### ### # ####### ##### # # ### ########### #
#   #   #         #   #       #   #     #     #           # #   #   #       #   # #   # #     #     #
# ##### # ####### ##### ####### ### ######### ########### # # ##### # ##### ### # # # # # ### # ### #
#     # #     #   #     #       # #   #     #   #   #   # # #     # #     #   # # # # #   #   # #   #
##### # ##### # ### # ### ####### ### # ### ### # # # # # # ##### # ##### ### ### ### ##### ### # ###
#           # #   # # #   # #       # # #   #   # #   # #   #   # #     #   #   #         #   # #   #
############# ### # ### ### # ### ### # # # # ### ##### ####### # ##### ####### ######### ### # #####
#             # # #   # #       #   # # # # # #   #   #         # # #   #     #         #   # #     #
# ############# # ### # ########### # ### ### # ### # ########### # # ### ### ### # ####### # ##### #
# #             #     #   #   #   #       #   #     #             # #   # # #   # # #   #   # #     #
# ### ##### ######### ### # # # # ######### ######### ############# ### # # ### ### # # # ### # ### #
#   # #     #     #     # # #   #   #     #         #   #           #   # #   #   #   #     #   # # #
# # ### # ### # ### ##### # ####### # ### # ####### ### ### ######### # # ### ### ############### # #
# #   # # #   #     # #   # # #     # # # # #     # # #     #         # # #     #         #   #   # #
# ### # ### ######### # ### # # ##### # # ### ### # # ##### # # ######### # ### ######### # # # # # #
# #   #   # #         #     # # #     #   #   # #   # #     # # #   #   # # # #   #   #   # #   # # #
# # ##### # # ##### ######### # # ### ### # ### ##### # ##### ### # # # # # # ### ### # # # ##### # #
# #     #     #   # #         # # # #   #   # #         #   #     #   # #   # #   #   # # #     #   #
# ##### ### ### # ### ### ##### # # ### ##### # ########### ########### ##### # ### # # # ##### #####
#     #   # #   #   #   #       #     # #   # # # #             #     #             # # #   # #     #
##### ### ### ##### ### ############# # # # # # # # ### ######### ### ############### # ### # ##### #
#   #   #     #   #   #   #   #     # #   # #   # #   #   #     # #       #     #     # # #   #   # #
# ##### ####### # # ##### # # # ### ####### # ### ### ### # ### # # ### ### ### # ##### # ### ### # #
# #     #       # #     #   #   # #     #   # #       #   #   #   #   # #   # # # #     #     #   # #
# # ######### ### ### # ######### ##### # ### ######### # ### ####### ### ### # ### ##### ##### ### #
# # #         #   #   #           #   #   # #       #   #   # #     #   # #         #         # #   #
# # ### ####### ### ### ########### # ##### ####### # ####### ### # ### # ################### # # ###
# #   #   #     # #   # #   #       #           #   # #   #   #   #   # #   #         #     #   # # #
# ### ### # ##### ### ### # # ############### ### ### # # # ### ####### ### # ####### # ### ### # # #
# #   #   # # #   #   #   # # #   #         #     #   # #       #       # #   #   #   #   #   # #   #
# # ### ### # # # # ### ### # # # ##### ### ####### ### ####### # ##### # ##### # # ##### ### ##### #
# #   #   # #   # #   #   #   # #     # #     #           #   # #   # # #       # #     # # #   #   #
# ### ### # # ### ### ### ##### ##### # ##### # ########### # ##### # # # # ##### ### # # # ### # ###
#     #   # #   #   #   # #     #   # #   #   #         #   #     # #   # #   #     # # # #   # #   #
# ##### ### ##### # # # # ### # # # # ### ##### ##### ### ####### # # ### ### ##### # # # # # # ### #
# #       # #     # # # #   # #   # #   #       #   # #   #     #   #   #   #     # # # #   # #   # #
# # ##### # # ##### # # ### # ##### ### # ####### # ### ####### ####### ##### ### # # ####### ### # #
# # #     # #   # # # #   # # #     # # # #       #   #   #           #     # #   # #       # #   # #
# ### ##### ### # # # ##### ### ##### # ### ######### ### # ############### ### ### ####### # # ### #
#     #         #   #           #           #             #                     #         #   #     #
#####################################################################################################
