#########################################################################################################################
#       #           #     #     #             #   #     #   #       # #     #   #         # #   #             #         #
####### # # ####### # # # # ### ####### ### ### # # ### # # # ### # # # # # # ### ### ### # # # # ### ####### ### ##### #
#       # #     #   # # #   # # #     # # # #   # # # # # #   #   # #   # # # #   #   #     # #     # #     #     #     #
# ############# # ##### ##### # # ### # # # # ### # # # # ##### ### ### # # # # ### ####### # ####### # # ######### #####
# #         #   #   #   #     # #   # # #   # # # # # # #     # # #   # # # # #   #       # # #   #   # # #       # #   #
# # ##### # # ##### # ### # # # ### # # # ### # # # # # ### ### # ### ### # # ### ##### # ### ### # ##### # ##### # # # #
# # #     # #     #   #   # # # #   #   #   # # # # # #     #   #         # #     #   # #   #     # #   #     #   # # # #
# ### ##### ##### ##### ### ### # ####### ### # # # # ####### # ########### # ##### # ##### ##### # # # ####### # # # # #
#   # #     #     #       #   #   #     # #   # #   #     #   # #     #     #   #   # #     #   # #   # #       # # # # #
### # ### ### ##### ##### ### # ##### ### # ### ##### ### # ##### ### # ######### ### # ### # # # ##### # ######### # # #
# # #   #     #     #   #   #   #   #     #       #   #   #     #   # #         # #     #   # # # #   # #           # # #
# # # # ### ####### # # ##### ### # ############# ##### ####### ### # ######### # # ######### # # # # # ####### ##### # #
#   # #   # #     # # #     #   # #   #       # # #   #       #     #     #       # #   #     # # # # #       # #     # #
# ####### ### ### ### ##### ##### ### # ### # # # # # ### ### ########### # ######### # # ##### # ### ####### # ####### #
#       #   # # #     #   # #     # # #   # #   #   #   # #   #         # # # #   #   # #   # #   #       #   #         #
####### ### # # ####### # # # ##### # ### # ########### ### ### ### ##### # # # # # ### ### # ##### ##### # ########### #
#     #   #       #     # # #     # #     #   #       #   #       # #     #   # # #   #     #     #     # #         #   #
# ####### ####### ### ### # ##### # ######### # ##### ### ####### # # ### ##### # ### ####### ### # ### ########### ### #
#         #     #     #   #     #     #     #   #   #   #       # # # #   #     #   # # #     #   # # #           #   # #
# ######### ### ####### ### ### ##### # ### ##### # # # ####### ### # # ### ####### # # # # ### ### # ######### # ### ###
# #       # #   #       # # #   #     # #         # # #       #     # # #   # #     # #   #   #   # #   #       #   #   #
# ### ### # # ##### ##### # ##### ##### # ######### # ####### ##### # ### ### # ### # ####### ### # # # # # ####### ### #
#     # #   #     #       # #     #     #   # #     #   #   #   #   #   #   # # #   #       # #   #   # # # #     #   # #
####### ######### ##### ### # ##### ####### # # ####### # # ### # ##### ### # # # ######### # ######### # ### ### ### # #
#   #     #     # #   # #   # #         #   #         # # #   # # #   #   #   # #       #   #           #       #   # # #
### # # ### ### # ### # # # # ######### # ########### # ### # # # # # # # # ### ### ##### ### ######### ##### ##### ### #
#   # #     # # #   # # # # #       #   # #   # #     #   # #   # # #   # # #   #   #     #   # #     # #   # #     #   #
# ### ####### # ### # # # ######### # ### # # # # ####### # ##### # ####### # ### ### ##### ### # ### ### # ### # ### # #
# #   #       #     #   #     #     #   #   # #   #     # #     # # #   #   # # #   # #     #   # #   #   # #   # #   # #
# # ### ##### ####### ##### # # ############# # ### ##### ####### # # # # ### # ### # ##### # # # # ### ### # # ### ### #
# #   # #   #     # # #   # # #               # #   #     #       # # #   # # #   # # #   #   # # # #     # # # #   # # #
# ### # # # ##### # # # # ### ################# # # # ##### ####### # ##### # # # # # # # ####### # ##### # # ### ### # #
#   # # # #       #   # #   #   #       #       # # #   #   #     # #   #   # # #   # # #     #   #       # # #   # #   #
# # # # ##### ######### ### # ### # ##### ####### ##### # ### # # # ### ### # ####### # ##### # ########### # # ### # ###
# # # #     #           #   #   # # #   #     #   #     #   # # # #         # #     #   #   #   # #       # # # # #   # #
# ### ##### ############# ##### # # # # ##### ### # ####### ### # ######### # # ### ##### ####### # # ### # # # # # ### #
# #   #     #   #       #     #   #   #     #   # #       #     # #   # #   #     #   # #       #   # #   #   # #   #   #
# # ### ##### ### # ######### # ##### # # ##### # ##### ##### ##### # # # ######### # # # ### ### ### ##### ### # ### # #
# # #     #   #   #         # # #   # # # #     #     # #     #   # # #     # #   # #   #   #     # # #   # #   # #   # #
# # ##### # ### ####### ##### ### # # # ### ##### ##### # ##### # # # ##### # # # # ### ### ####### # # # # # ### # ### #
# #   #   #   #     #   #   # #   # # #     #     #   #   #   # #   #   #     # #   # #   # #   #   #   #   # # # # #   #
# ### # ### # ### ### ### # # # ### ##### ##### # # # ##### # # ####### # ##### ##### ### # # ### # ######### # # ### # #
#   #   #   #     #   #   #   #   #     #     # # # # #     # #   #     # #     #       # # # #   #   #       # #   # # #
# # ##### ######### # # ######### ##### ##### # ### # # ##### # # # ####### ##### # ##### # # # ### ### ####### ### # # #
# #     #     #     # #     #     #   #   #   # #   #   #   # # # #       # #   # #     # # #     #   #     #       # # #
# # ### ##### # ########### # ##### # ### # ### # ####### # # ### ####### # # # # ##### # # ######### ##### ####### # # #
# # #   # #   # #         #   #     #   # #     #   #   # #   #   # #   # # # # # #   #   # #         #   # #     #   # #
# # ### # # ### # ##### # ##### # ##### # # ##### # # ### ##### ### # # # # # # # # # ##### # ####### # ### # ### ##### #
# #   # # # # #   #     # #     # #     # # #   # # #     # #     # # #   # # # # # # #   #   #   #     #   # # # #   # #
# ### # # # # ##### ### ### ##### ##### # # # # ### # ##### # ### # # ##### # # # # ### # # ### # ####### ### # # # # # #
# #   #   #   #   #   # #   #   #     # # # # #     #   #     # # #         # # #   #   #   #   #         #     # # # # #
### ### ##### ### ### ### ##### ##### # # ### ######### ### ### # ########### # ### # ####### ########### # ##### # # # #
#   #   #           # #   #         # # #     #       #   #     #   #         # #   # #     # #     # #   # # #   # #   #
# ### ### ########### # ### # ####### ######### ### # ### ### ##### # ####### # # ### ### # # # ### # # ### # # ####### #
# #   #       #       # #   # #     #         #   # # #   #   #     # #     # # # # # #   # # # # # #     #   #       # #
# ##### ####### ####### ##### # ### ######### ### # ### ### ### ##### ### ### ### # # # ##### # # # ### ### ######### # #
#       #     # #     # #   # #   #   #         # #   # #     # #   #   #   #   #   # # #   #   # #   # #   #         # #
# ####### ### # # ### # # # # # ### # # ######### ### # ##### # # # ### ### ### ### # # # # ##### ### # # ### ######### #
#     # # #     # #   #   # # # #   # #     #       # #   # # # # #   #   #   #   # # # # #         # # # #   #   #     #
##### # # # ##### # ####### # # # ### ##### # ####### ### # # # # ### ### # # ### # # # # ####### # # ### # ### # # #####
#   #   # # #     # #   #   #   # #     #   # # #     #   #   #   #   # #   # #   # # #   #       # #     # #   # # #   #
# # # ### # # ##### # # # ### ### # ##### # # # # ### # ##### ##### ### ### ### ### # ##### ####### ####### # ### # ### #
# #   #   # #     # # #   #   #   #   #   # #   # #   # #   # #   #   #     #   #   #     # # #     #     #   #   #   # #
# ##### ##### ##### # ##### ### ##### # ####### # ##### # # ### # ### # ##### ### ####### # # # ##### ### ##### ##### # #
#   # #       #     # #   # #   #   # # #       #     #   # #   #     # #   #     #   # #   # # #     #   #     #     # #
### # ######### ##### # ### # ### # # # # ########### ##### # ######### ### ####### # # ##### # ### ### ### ##### ##### #
#   #         #     # # #   # # # #   #   #   #       # #   #     #   #             #     #   #     #   # #     #     # #
# ########### ##### # # # ### # # ######### # # ##### # # ####### # ##### ################# # ####### ### ##### ##### # #
#                 #   #   # # # #   #     # # #   # #   # #       #       #             #   #     #   #     #   #     # #
################# ##### ### # # ### # ### # ##### # ### # # # ##### ####### ########### # ### ### # ####### # ####### # #
#     #   #     #   # # #   # #   # # # # #   #   #     # # #   #     # #   # #   #   #   # # #   #         # #     #   #
# ### # # # ####### # # # ### # ### # # # ### # ##### ### # ### ##### # # ### # # # # ##### # # ########### # # ### ### #
#   # # #   #       #     #   #     # #     # # #   #   # #   #     #   # # #   #   #       # # #         # # # # #   # #
# # # # # ### ############# ### ##### ##### # # # # ##### ####### # ### # # # ####### ##### # ### # ##### # # # # ### # #
# # # # # #   #         #   # # #         # # #   #       #     # # #   # #     #   #   #   #     #     # # #   #   # # #
# # # # # # ### ####### # ### # ######### # # ############# ### ### # ### ####### # ##### # ########### ### ##### # # # #
# # #   # #   #   #     #   # #     #     #     #     #   #   #     #   #   #     #   #   #   #       # #   #     # # # #
### ##### ### ### ##### ### # ##### # # ######### # # # # ### # ####### ### # ####### # ##### # ##### # # ### ####### ###
#   #     # #   #     #   # # #     # # #   #     # #   #     # #     #   # # #     #   #   # # #   # #       #     #   #
# ##### ### ### ### # ### # # # ##### ### # # ##### ########### # ### ##### # # # ####### # # # ### # # ####### ### ### #
#     # #     #   # # # # # # #     #     #   #   # #           # # #       # # #   #     #   # #   # # #       # #   # #
# ### # # ####### ### # # # # ##### # ######### # # ############# # ######### ##### # ######### # ### # # ####### ### # #
#   # #   #     #     #   # # #     #     #     # #       #     #         #     #   # #         #   # # # #   #     #   #
### # ##### # ######### ### # # ######### # ##### ####### # ### # ####### # ### # # # # ########### # # # # # # ### ### #
#   #       # #     #   #   #     #   #   #   #       #   # # #   #     # # #   # # # # #           # # #   # #   #     #
# ########### # # # # ### # ##### ### # ##### ####### # # # # ##### ### # # # ### # # # ##### # ##### # ##### ### #######
# #   #     #   # # # #   #     #   #       #   #       # #   #     # # # # # #   # # #     # # #   # # #   #   # #     #
# # # ##### ##### # # ### ##### ### ####### ### # ########### # ##### # # ### # # # # ##### ### # # # # ### ### # ##### #
#   #   #   #     # #   # #     #   #   # # #   #   #     #   #   #   # #     # # # # #   #   #   #   #   #   # #   #   #
####### # ### # ####### ### ##### ### # # # # ### ### ### # ##### # ### ####### # ### # # ### # ######### # # # ### # # #
#   #   # #   # #     #   #   # #     # #   # #   #   # #     # # #     #   #   #   # # # #   # #     #     # #   #   # #
# # # ### # ### # ### ### ### # ####### # ### ##### ### ##### # # # ##### # # ##### # # # # ### ### # ####### ### ##### #
# # #     #   # # #     #     # #       #   #           #   #   # #   #   #       # # # # # #       #   #   #   # # #   #
# ####### ### ### # # ######### # ########### ########### # ##### ### # ######### # # # # # ########### # # ### # # # ###
#         # # #   # # #       #   #         #     #       #       #   # #       # #   # # #     #     #   # #   # #   # #
# ######### # # ### ### ##### # ####### ### ####### ##### ######### ### # ##### # ####### ##### # ### ##### # ### ### # #
# #       # #     #   #   #   #         # # #     #     # #       # #   # # #   #       #     # # # #     # #   #   #   #
# # ##### # ######### ### # ############# # # ### ##### ### ##### # ##### # # ######### # ### # # # ### # # ####### ### #
#   #   #   #       #   # #       #       #   # # #   #     #     #       # # #     # # #   # # #     # # #   #   # #   #
####### ### # ##### # # # ##### ### ##### ##### # # # # ##### ############# # # ### # # ### ### ### ### ##### # # # # ###
#       #   #     #   # #   # # #   #   #       # # # #     # #   #       #   #   # #       #   #   #   #   # # # # #   #
# # ### # ####### ######### # # # ### # ####### # # # ##### # # # # # ### # ##### # ####### # ### ### # # # # # # # #####
# # #   # #     #     #     # #   #   #     # #   # # #     # # #   #   # #   #   #       # # # #   # # # #   # #   #   #
# # ### # ### # ##### # ##### ####### ##### # ##### # # ##### # ####### # ### # ######### # # # ### # ### ##### ##### # #
# #   # #     # #   #   #           # # #   #       # # #   # #       # #   #   #   #     # # #     #   # # #         # #
##### # ####### # ############# ### # # # ######### # # # # # ##### ### ######### # # ####### ####### # # # # ######### #
#     #       # #         #   #   # # # # #     #   # # # #   # #   #   #       # # #       #       # #   #   #   #     #
# ##### ##### # ##### ### # # ### # # # # # # # # ### ### ##### # ### ### ### # # ######### ####### # ######### # # #####
#   #   #   # # #     #   # #     #   #   # # #   # #     #   # # # #       # #   #       #     #   #   #   #   # #     #
# # ##### # ### # ##### ### ########### ##### ##### ####### # # # # ######### ### # # ### ##### # ##### # # # ### ##### #
# # #   # # #   # #   #   # #         #       #       #     #   #         #   #   # # #   #   # #   # #   #   # #     # #
### # # # # # ### # # ### # # ################# ### # # ### ######### ##### ####### # # ### # # ### # ######### ##### # #
#   # #   #   #   # #   # # #   #       #   #   #   # # # #         # #     #       # # #   # #     #         #   #   # #
# ### ######### ### ##### # # # # ##### # # # ### ### # # ######### # # ##### ####### ### ### ####### ####### # # # ### #
#   # # #     # #         # # # #   # #   #     # #   #     #     # # #       #   # #   #   #   #     #     # # #   #   #
# # # # # # # # # ######### ### ### # ########### # ####### # # ### # ######### # # ### # ##### # ### # ### ### ##### # #
# #   #   # # # # #       # #     # #         #   # #       # # #   # #       # # #   #   #     # #   #   # #   #     # #
# ######### # # # # ##### # # ##### ####### # # ##### ####### # # ### ### ### # # # # ##### ##### # ##### # # ####### # #
#           #   #   #       #               # #               # #         #     #   #     #       #       #           # #
#########################################################################################################################
