###################################################
#   #             # #           # #       #     # #
### ########### # # # ### ##### # # # ##### # # # #
# #     #       # #   #   #     #   #     # # #   #
# ##### # ####### ##### ### ######### ### # # ### #
#     # # #     #     # # # #   #   # # #   #   # #
# ##### # # ### ##### # # # # # # # # # ####### # #
#   #   # #   #   #   # # #   #   # #     #     # #
### # ### ### ### # ### # ######### ##### # ##### #
#   #   # #   # # #     #         # # #   # #     #
# # ### # # ### # ####### ######### # # ### # #####
# #   #   #   # #         #       # #   #   #     #
# ### ####### # ######### # ##### # ##### ####### #
# #   #     # #         #   # #   #       #   #   #
# # ####### # # ####### ##### # ########### # # ###
# # #   #   # # # #   #   #   #           # #   # #
# # # # # ### # # # # # ### # ####### ##### ##### #
# #   #   #   # #   # #     #   #   # #   #   #   #
# ####### # ### ##### ####### # # # # # # ### # # #
# #     # # # #     #       # #   # #   #     # # #
# # ### ### # ##### ##### # # ##### ########### # #
#   # #     #     # #     # # #   # #       #   # #
# ### ####### ##### # ### ### ### # ##### # # ### #
# # #     #         # #   #   #   #       # # # # #
# # # # # ####### ### # ### ### ########### # # # #
# #   # # #     #     # #   #   #         #   # # #
# ##### # # ### ### ##### ### # # ### ######### # #
#   #   #   #   #   #   # #   # #   #           # #
### # ####### ### ### # # ##### ### ##### ####### #
# #   #     # #   #   # #   #   #   #   #         #
# ####### # # # ### ### ### # # # ### #############
#   #     # # # # # # # #   # # # #               #
# # # # ##### # # # # # # ### # # # ############# #
# #   #   #   #   # # #   #   # # # #           # #
# ####### # ####### # ##### ##### # ### ####### # #
# #     # # #       #         #   #   # #       # #
# # ### # # # # ##### ####### # ##### ### ##### # #
# # # # # # # # # #   #     #   # #   #   #     # #
# # # # # # ### # # ### # ####### # ### # ####### #
# #   # # #     # #   # # #     #       # #       #
# # ### # ####### ### # # # ### # ####### # ##### #
# # #   #     #     # # #     #     #   # # #     #
# ### ##### # # ### # # ##### ####### # ### #######
# #   #     # # #   # # #   # #   #   #   #       #
# # ### ##### # # ### ### # ### # # ##### ####### #
#   #   #   # # #   #   # # #   # #   # # #   #   #
##### # # # ### ### ### # # # ### # # # # # # # # #
#     # # #   # #     # # #   #   # # # # # #   # #
# ####### ### # # ##### # ##### ##### # # # ##### #
#           #   #         #           #     #     #
###################################################
