#########################################
#   #             #             # #     #
### ########### # # ##### ##### # # # ###
# #     #       # #   #   #     #   #   #
# ##### # ####### ##### ### ########### #
#     # # #     #     # # # #   #   #   #
# # ### # # ### ##### # # # # # # # # # #
# # #   # # # #   #   # # #   #   # # # #
# ### ### # # ### # ### # ######### # ###
#   #   # #     # #     #       # # #   #
### ### # ##### # ####### ##### # # # # #
#     #   #     #       #   # #   # # # #
# ######### ####### ### # # # ### # ### #
# #     # #   #   # #   # # #     #     #
# # # # # # ### # # ### # # ########### #
# # # #   # #   # #   # # #           # #
# # # ##### # ### ### ### ########### # #
# # #     # # # # #   #   #   #     #   #
# # ##### # # # # # ### ### # ##### #####
# # #   #   # #     #   #   #     #     #
# # ### ##### # ##### ### ####### # # # #
# #     #     # #     #   #   # # # # # #
# ##### # ##### # ##### ### # # # ### # #
#       # #     # #     #   #   # #   # #
######### # ##### ### ##### ### # # ### #
#   #     #   # #     #     #   #   # # #
# # # ####### # ####### # ### ####### # #
# #   #     #     #   # #   #   #   #   #
# ##### # ####### # # # ### ### # ### ###
#     # #         # # #   #   #   #   # #
##### # ############# ### ### ##### ### #
#     # #     #       #   # # #   #   # #
# ##### # ### # ##### # ### # # # ### # #
#     # # #     #   # #   # #   #     # #
# ### # # # ####### # ### # ########### #
#   # # # # #     #     # #     #   #   #
### # # # ### ### ##### # # # # # # # # #
#   # #   #   # #     # # # # #   # # # #
# ### ##### ### ##### ### ### ##### # # #
#   #               #         #       # #
#########################################
