#######################################################################
# #     #             #                 #         #       #         # #
# # ### # ### ####### # ########### ### ### # ##### ### # # # ##### # #
# #   # # # #     # # #         #   # #   # #     # # # # # # #   #   #
# ### # # # ##### # # ##### ##### ### ### ### ### # # # # ### # # ### #
#     # #   #   # #   #   # #     #     #   #   #     # #     # #     #
####### ### ### # # ### # ### ##### ### ### ########### ####### #######
#       #       # #     # #   #     #     #   #       #       # #     #
# ####### ####### ####### # ### ### ######### # ##### ### ### # # # # #
# #   #   #   #   #   #     #     # #         # #       # #   # # # # #
# ### # ### # # ### # ########### # # ######### # ##### ### ### # # ###
#   #     # #   #   #   #       # # # #         # #   #     #   # #   #
### # ##### ##### ##### # ##### # # # ######### ### # ####### ####### #
#   # #   #     # #   # #     # # # #     #   #     #   #   # #   #   #
# ### # # # ### # # # # ##### # # ####### # # # ####### # # # # # # ###
# # # # # #   # #   # #   #   # #       # # # #   #     # #   # # #   #
# # # # # ##### ##### ### # ### ### ##### # # ### # ##### ##### # ### #
# #   # #     # #       #   #   #   #   #   # #   # #   # #     #   # #
# ##### ##### # # ########### ### ### # ##### ### # # ### # ####### # #
# #     # #   #     #   #     # #   # #     #   # # #     # #     #   #
# # ##### # ##### ### # # ##### # # # # ####### ### ##### # # ### ### #
# # #     #     # #   #   # #     # # #       #   # #   #   # #     # #
# # # ######### ### ####### # ##### # ##### ##### # # # ##### # ### # #
# # # #       # #   #       #     #   #     #     #   #     # #   # # #
# # # # # ##### # ### ########### ##### ### # ##### ####### ##### ### #
#   #   #     #   #           #   #   # #   # #   # #   # #     # #   #
##### ####### ############### # ### # # # ### # # # # # # ##### # # ###
#   #   #   #         #     #     # # # # #   # #   # # #   #   #     #
# ##### # ### ####### # ### ####### # # # # ### ##### # ### # ####### #
#     # #   # #   #     #           #   # # # # #     #     #     #   #
# ### # ### # # # ##################### ### # # ##### ##### ##### # ###
#   # # #   #   #   #     #         # # #   # #       # #     #   #   #
##### # # # ####### # ### # ####### # # # ### ### ##### # ##### #######
#     #   #   #   #   # #   # #     #   # #       #   #   #   #       #
# # ######### # # ##### ##### # ### ##### ### ##### # ##### # ##### # #
# # #         # # #           #   # #   #   # #     #     # #     # # #
# ### ######### # # ####### ##### ### # ### ### ######### # ##### ### #
#   # #       # # # #     #     #     #   #   #   #   #   #   # #   # #
# # # ####### # # # ### # ##### ####### # ### # # # ### ##### # ### # #
# #   #   #   # #   #   # #   #       # #   # # # #     #     #   # # #
# ##### # # # # ##### ### # # ##### # # ### # ### # ####### ##### # # #
#     # #   # #     #   # # #     # # # #   #     #     #   #     # # #
##### # ########### ### # # ##### # ### # ############# # ##### ### # #
# #   #     #   #       # # # #   # #   # #   #       # # #   #       #
# # ##### # # # # ######### # # ### # ##### # # ##### # # # # ####### #
# #     # # # # # # #       #   #   # #     #   #   #   # # # #     # #
# ##### # # # # # # # ####### ### # # # ######### # ##### # # # ### # #
#     # # #   # #   # #   #   #   # #   #         #   #   # #   # # # #
# ### # ####### # ### # # # ##### # ##### ### ####### # # # ##### # ###
# #   #       #   #   # # #       # #   #   # # #   # # # #     # #   #
# # ######### # ### ### # ######### # # ### # # # # # # ####### # ### #
# #   #   #   # # #   # #         #   # # # # # # #   #         # #   #
# ### # ### ### # ### # ####### # ##### # # # # # ####### ####### # # #
# #   # #   #   #   # # #     # # #     #   # #         # #       # # #
# ### # # ##### # # # ### ### # # # ##### ### ######### # # ### ### # #
#   #   #     #   # #       # # # #     # #   #   #     #   # # #   # #
### ### ##### ### ########### # ####### # # ### # # ######### # # ### #
#   # # #     #   #   #       # #       # #     # #       #     # #   #
# ### # # ####### # # # ####### # ####### ####### ####### # ##### # ###
#   # # #   #   # # #   #     #   #           #   #   #   #   #   #   #
# # # # ### # # ### ##### ### # ### ######### # ### # # ####### ##### #
# # #     # # #   # #     # #   #   #       # # #   # #         # #   #
# # ####### # ### # # ##### ##### ### ##### ### ### ############# # ###
# #         # # # # #     #     #   # #   #   #   #     #         # # #
# ########### # # # ##### # # # ### # # ##### ### # # ### ##### # # # #
# #       #   # # #   # # # # #   # # #       #   # #   #   #   # #   #
# # ##### # ### # ### # # ### ### ### # ####### ##### # ### # ####### #
# #   # # #   # # #   # # #   # #     #       #     # # #   #       # #
# ### # # ### # # # ### # # ### ############# ##### # # # ####### ### #
#     #       #     #       #                       # #         #     #
#######################################################################
