#############################################################################################################################################
# #       #             #     #         #                 #           #         #     #     #             #         #                 #     #
# # ##### ##### # ##### # # # ### ##### ########### ##### ##### # ### # # ##### # ### # ### # ########### # # ##### ######### # ##### ### ###
#   #   #     # # #   # # # #     #   #   #   #     #   # #   # # #   # # # #   # #   # #   # #   #   # #   # #   # #         # #   #   #   #
####### ##### ### # # # ### ####### # ### # # # ##### # # # # ### # ##### # # ### ##### # # # # # # # # ##### # # # # ### ##### # # ### ### #
#       #   #     # # #   #   #   # #   #   # #   # # #   # #   # #   #   #   #       # # # # # # # #     #   # # #   #   #   # # #   #     #
# ### # # # ######### ### ### # # # ### ##### # # # # ##### ### # ### # ### ### ##### # # ### # # # ####### ##### ### ##### # ### ### ##### #
# #   #   #     #       # #   # # #   #   #   # # # # #       # # # # # #   #   #     # #   #   #   #       #   #     #     #     #   #     #
### ### ####### # ##### # # ### # ### ### # ### # # # # ##### # # # # # # ####### ##### ### ####### # ####### # ##### # ########### # ##### #
#   #   #     #   #   # #   #   #   # #   #   # # #   # #   # #   #     # #     # #   # #       #   # #     # #     # # #           # #   # #
# # ##### ### ####### # ##### ##### # # # ### ### # ### # ### # ######### # # # # # # # # ####### ### # ### # ##### ### # ########### # # ###
# # #     # # #     # # #     # #   # # #   #     # # #   #   # #       # # # # #   #   #   #     #   # # #   #   #     # #     #     # #   #
# ### ##### # # ### # # # ##### # ### # ########### # ### # ##### ##### # ### # ##### ##### # ##### # # # ##### # ####### # ### ####### ### #
#     #     #     # # # #     #   #   # #           #   # #       #   # #   # #     # #     #     # # #     #   # #   #   # #   #       #   #
# ######### ####### # # ### # # ####### # ############# # ######### # # ### # ##### ### ### # ##### # ##### # ### # # # ### # # # ####### # #
# #       # #       # #   # # #         #       #       #     #   # # #   #   # #   #   #   # #     #   # #   # # # # #     # # #   # #   # #
# # ### # # # ####### ### ### ######### ####### # # ######### ### # # ### ##### # ### ####### # ####### # ##### # # ######### # ### # # ### #
# # #   #   # #         #     #   #     #     # # # #   #   #     # #   # #   #   # #     #   # #   #       #   # #       #   #   #   # #   #
# ### ##### # # ### ########### ### ##### # # # ### # # # # ##### # ### # # ### ### # ### # ### # # ######### # # # ### ### ##### ### # ### #
#     #   # # # #   #         #     #   # # # #   #   # # # #     #   # # #   # #     # # #   # # #       #   #   # # #   #   #     # #   # #
####### # ### # # ### ##### ### ##### ### # ##### ##### # # # ####### # # # # # # ##### # # ### # ####### # ####### # ### ### ####### ### ###
#   #   #   # # # #   # #   #   # #   #   #     # #     # #   #     # #   # #   #       #   #   #       #   #     # #   # #   #     #   #   #
# # # ##### # ### # ### # ### ### # # # ##### ### # ##### ##### ### # ##### ########### ##### # ####### ##### # ### ### # # # # ### # ##### #
# #   #   # #   #   #   #     #   # # #     #   # #         #   # # #   # # #         # #     # #       #     #         # # # #   #   #     #
# ##### # # ### # ### ######### ### # ##### ### # ######### # ### # ### # # ##### ### # # ##### # ######### ############# # ##### ##### ### #
#   #   # #   # # #     #       #   #         # #         # #   #   #   # #     #   #   #     # # #   #   # #   #     #   #     # # #   # # #
# # ### ##### # # ##### # # # ### ############# ######### ##### # ### ### ##### ##### ####### ### # # # # # # ### ### # # ##### # # # ### # #
# #   # #       # #   #   # # #   #     #     #         #       #     #       #     # #     #       #   # #   #   #   # # #   #     # # #   #
##### # # ####### # # ##### ### ##### ### ### ####### ################# ##### ##### # # ### ############# ##### ### ### # ### ####### # # ###
#   # # # #   #     #     #   # #     #   #     #     #     #     #   # #   #   #   # #   #     # #   # # #     # #     #   #     #   # #   #
# # # # # # # ########### # # # # # ### # ##### # ##### # # # # # # # ### # ### # ### ##### # # # # # # # # ##### ######### ##### # ### ### #
# #   #   # #   # #     # # #     # #   # #   # # #   # # # # # # # #     #     # #       # # #   # # #     #             #     # # #     # #
# ##### ### ### # # ### # ########### ### # # # # # # # # ### # # # ############# ####### ### ##### # ####### # ##### ######### # # ##### # #
# #     #   #   # #   #   #       #   #   # # #   # # # #     # #   #     #     # #     #     #     #   #     #     # #         # # #   #   #
# ### ### ### ### ### ##### ##### # ### ### # ### # # # ####### ### # ### # ### # # ### ### ### ####### # ##### ### ### ######### # # # ### #
#   #   #   # # #   # #     #   #   #   #   # #   # #     #     #   # # #   # # #   #   #   #   #   #   # #   #   #   # #         #   #   # #
# # # ### ### # # # # ### ### ####### ### ### ##### ####### ######### # ##### # ##### ### ### ### # # ##### # ### ### # # ############### ###
# # # #   #   # # # #     # #     #   # # # #     #   #   #   #       #       #     # #   #   #   # # #     #   #   #     #   #         #   #
### # # ### ### # # ####### # # ### ### # # ##### # ### # ### # ######### ### ### ### # ### ####### # # # ##### ##### ##### # # ####### # # #
#   # #   #   #   #       #   #   #     #   #   #   #   #     # #       #   # #   #   # #   #       # # #   #   #   #   #   # # #   #   # # #
# ### ### ### # ######### # ##### ##### ### # # ##### ######### ##### # ##### # ### ##### ##### ##### ##### # ### # ### # ### # ### # ### # #
# # # # #   # #       # #   #   #     #   # # # #   #     #     #     #   #   #     #     #   #     #     # #     #   # # #     #   # #   # #
# # # # ### # ####### # ####### # ####### # # # # ####### # ##### ####### # ######### ##### # ##### ##### # ######### # # ####### # # ##### #
# # # # #   # #     # #         #       # #   # #       #   #     #   #     #       #   #   # #         # # # #       # #       # # # #   # #
# # # # # ### # ### # # ### ######### # # ##### ####### ####### ### # ####### ##### # # ### # # ####### # # # # ####### ####### # ### # # # #
# #     # # # # #   # # #   #     # # # # #   # #       #     #     #         #   #   # #   #   #     # #   #   #       #   #   #   #   # # #
# # ##### # # # # # # # ##### # # # # # # ### # # ##### # ### ##### ########### # # ### # ####### ##### ##### ### ####### # # ##### ##### # #
# #   #   # # # # # # #     # # # # # # #     #   #   # # # # #   #   #   #     # # #   # #       #     #     #   #       #   #   #     #   #
# ##### ### # ### # # # ### # # # # # # ##### ##### # # # # # # # ##### # # ##### # # ### ####### # ##### ######### # ######### # # ####### #
#     # #   #   # # # #   #   # #   # # #   #   #   # #   # #   #       # # #   # # #   # #     #   #   #   #       # #         # # #       #
# ### # ### ### # ### ####### # # ### # # ##### ### # ##### ############# # # ### ### # # # ### # ### # ### # # ##### # ######### # # ##### #
# # #         # # #   #     # # # #   # # #   #   # #     #             # # #   #   # # #   # # # #   #   # # # #     # #     #   # # #   # #
# # ########### # # ### ### ### ### ### # # # ### # ##### # ######### ### # # # ### # # ### # # # # ####### # # ### ### ### # # ### # # # ###
# #   #         #   #   # #   #   # #     # #     #   #   #     #   #     # # #   # # #   #   # #   #       # #   # #   #   # # #     # #   #
# # ### ######### ### ### ### ### # ####### ####### # # ####### # ######### # ### # # ### ##### ### # ####### ### # # ### ##### # ##### ### #
#   #   #     #       #     #   # # #       #     # # # #   #   #     #     #   # # # # #     # #   # #     # #   # # #   #   # #   #     # #
# ### ### ### ######### ### ### # # # ####### # ### # # ### # ##### # # ### ##### # # # ##### # ### # # ##### # ### # ### # # # ##### ##### #
# #   #     #   #   #   # #   #   #   # #     #     # #     #   #   # #   #     # # #       # #   # # #     # #   # # #   # #   #   # # #   #
# # # # ####### # # # ### # ##### ##### # ######### # ######### # ### ### ##### # # ### ##### # # # # ##### # ### ### # ### ##### # # # # # #
# # # #   #   # # # # #   # #   # #       #       # #     #     # #     # #     # #   # #     # # # # #   #     # #   #   # #   # # #   # # #
### ### ### # # # # # # ### # # # # ####### ##### ##### # # ##### ##### ### ##### ### ### ##### # ### # # ####### # ### # # # # # # ### # # #
#   #   #   #   # #   # #   # #   #       # #     #   # # #     #     #   # #       #     #     #   #   #   #   # #   # # #   #   #     # # #
# ### ### ### ####### # # ### ######### ### # ##### # ### ##### # ### ### # # # ### ####### ####### ####### # # # ### # # ##### ######### ###
#     # # #   #     #   # #   # #     # #   #   #   #     #   # #   # # #   # # #         #       #       # # # #     # # #   #     #   #   #
# ##### # ##### ### ##### # ### # # ### # ##### # ####### # # # ##### # ##### # ######### ### ##### ##### # # # # ####### # # ##### # # ### #
# #     # #   #   #     # # #     #     # #   # # #   #   # # # #     #     # #       #     # #   # #   # #   # #   #     # # #   #   # #   #
# # ##### # # ### ##### # # ########### # # ### # # ### ### # # # ##### ### # ####### ##### ### # # # ### ##### ### # ##### # ### ##### # # #
# #   #   # #   # #   # #   #         # # #       #   # #   # #   #   #   #       #   #   #     #   #     # #   # # #   #   #   # #     # # #
# ### # ### ### # # # # ### # ####### ### ########### # # ### ##### # ############# ### # ### ####### ##### # ### # ### # ##### # # ##### # #
#   # #     # #   # # #   #   #     #   #       #     # #   #       #         #   #   # #   # #   #       # # #   #     # #     #   #     # #
### # ####### ##### # ### ####### # ### # ##### ### # # ### ### ############# # # ### # ### # # # ####### # # # # ##### # ##### ##### ##### #
#   #         #   # #   #     #   #   # # #   # #   # #     # # #   #   #       #   # # # # # # #       #   # # # #   # #     #       #   # #
# ### ### ### # # # ######### # ##### # # # ### # ########### # # # # # ########### # # # # # # ####### ### # # # # # # ##### ######### ### #
#   # # #   #   # #     #     # #     # #   #   # #           # # #   # #   #     #   # # # # #   #     #   # # #   #     #   #     #       #
### # # ### ##### # ### # ##### ### ### ##### ### # ####### ### # ##### # # ### # ### # # # ##### # ##### ### # ########### ### # # # #######
#   #   #   #   # #   # # #       #   #     #   # #     # #     # #   # # #   # #   # #   # #     # #     #   #         #   #   # # # #     #
# ### ### ### ### ##### # # ##### # ####### # # # ##### # ####### # ### # ### # # ### ### # # ##### # ##### ########### # ##### # ### # ### #
# #   #   #       #   # # # #     # #       # # #     # #     #   # #   #   # # #   #   # # #   # # # #     #   #       # #   # #     #   # #
# # ### ### ####### # # # ### ##### # ####### # ### # # ##### # ### # ### ### # ### # ### # ### # # # # ##### # ######### # # # ####### # ###
# #   # # # #       #   # #   #   # # #       #   # #     #   # #   #     #   #   #   #   #     # # # #       #         #   # #   #   # #   #
# ### # # # ### ### ##### # ### # # # ### ####### ####### # ### # # ####### ### ####### ######### # # ################# ### # ### # # ##### #
#   # # # #   # #   #     # #   # # #   #     #   #     #   #   # #   #   # #   #     #     # #   # # #     #     #   #   # # #     #     # #
### ### # ### ### # # ##### # ### # ### ####### # # ### ##### ### ### # # # ##### ### ##### # # # # ### # # ### # # # ### # # ########### # #
#   #   # #   #   # #   #   #   # # #   #     # # # # # #     #   # # # # #     #   # #     #   # #     # #     # # # #   # #       #   #   #
# ### ### # ### ####### # # ### # # # ### ### # ### # # # ####### # # # # ##### ### # # ##### ### ####### ######### # # ### ##### # # # #####
#     #     #   #       # # #   # # # #   # # # #   # #   #     #   # # #       # # #   #     #   #     #   #     # #   #   #   # #   #     #
####### ####### # ######### # ### # # # ### # # # ### ##### # # ##### # ####### # # ##### ##### # ### # ### # ### # ##### ### # ########### #
#   #   #     # # #   #     # # # # # # #   # # #         # # #   #   # #     #   #   #   #     #     # #   # # #   #   # # # #     #     # #
# # # ### # # # # # # # # ### # # ### # ### # # ######### ### ### # ### # ### ####### ##### ######### ### ### # ##### # # # # ##### # ### # #
# # # #   # #   # # # # #   #   #   #   #   # #     #   #   # #   #   #   # #   #     #   #   #     # #   #   #     # #   # #   #     #   # #
### # ##### ##### # ### ### ### ### ##### # # ### # # # ### # # ### # ##### ### # ##### # ### # ##### # # # ### # ### ##### ### ####### ### #
#   #     # #     #       #   # # #       # # #   #   # #   # #   # #         #   #     #     #       # # #   # #   # #     # #       #   # #
# ####### # # ############### # # ####### # # # ####### # ### ### ### # ##### ##### # ### ############# # ### # ### # # ### # ####### ### # #
# #   #     # #       #       #     #     # #   #       #     # #   # # #   # #   # # # # #             #   # # # # #   # #       # # #     #
# # # # ##### # # ### # ########### # # ##### ################# ### ### # # # # # # # # # # ############### # # # # ##### ####### # # ##### #
# # #   # #   # # #   # #           # # #     #   #           #   #     # #   # # # # #   # #     #       # # #   #             # # #   # # #
# # ##### # ##### # ### # ##### ##### # # ##### # # ####### # # ######### ##### # ### ##### # ### ### ##### # ### ####### ##### # # ### # # #
# #   #   #     # #     # #   # #     # # # #   #   #       #   #     #   #     #     #   # #   #     #   # # #   #     # #     #     # #   #
# ### # ####### # ####### # # ### ####### # # ####### ##### ##### ### # ##### ##### ### # # ### ####### # # # ##### ### # # ##### ##### #####
#     #       # #         # #     #   #   # # #     # #   # #       #         #     #   # #   # #     # #   #       # # # #       #   #     #
# ######### ### ##### ##### ####### # # ### # # ### # # # # # ################# ##### ### ### # # ### # ############# # ########### # # ### #
#         #   #     # #     #       #     # #   #   # # #   # # #     #     #   #     # #     #   # # # # #             #           # # #   #
######### ### ##### ### ##### ########### # ##### ### ####### # # ### # # ### ### ##### ####### ### # # # # ############# ########### ### # #
#       # #     #   #   #     #   #     # #     #   #           # #   # #       # #           # #   # #   # #           #     #     # #   # #
# ####### # ### # ### # # ##### # # ### # ##### ### ############# # ############# # ######### # # ### ### # ### ####### ##### # ##### # ### #
#   #   # #   # #   # # # #   # #   # # #       # #     #         #               #   #     # # #   #   # #   #   #   # #   # #       #   # #
# # # # # # # ##### # ### # # # ##### # ####### # # ##### ########################### # # ### # ### ### # ### ### # ### # # # # ######### # #
# #   #   # #     # # #     # #       # #     #   # #     #         #       #     #   # # #   #     # #   # #     # #   # #   # #         # #
# ############# # # # # ##### ####### # # ### ### # # ##### ##### ### ### # # # # # ##### # ####### # ##### ####### # ### ##### # ### ##### #
# #           # # # # # #   #   #   # # #   # #   # #     #   # #   # # # # # # #   #   #       #   #               # #   #     #   #     # #
# # ######### # ### # # # # ##### # # # ### ### ### ##### ### # ### # # # ### # ##### # ####### # ### ####### ####### # ##### ### ####### ###
# #   #   #   # #   # # # #       #   #   #       # #   # # # #   #   # #   # #       #       # #   # #     # #       #     #   # #     #   #
# # # # # # ### # ### # # ############### ####### # ### # # # ### ##### ### # ############### ##### # # ### ### ########### ### # # ### ### #
# # # # # # #   # #     #         #   #   #   #   #   # # #       #       #   #     #   #     #       #   #     #         # #   # # #       #
# ### ### # # # # ### ########### ### # # # # ### ### # # ####### ##### # ####### # ### # ##### ######### ########### ### # # ##### # #######
#     #   #   # #   #     #     #     # # # #   #   #   #       #       # #     # # #   #   #     #     #           # #     #     # # #     #
####### ####### ### ####### # ####### # ### ### ####### ####### ######### ### # # # # ##### # ##### # # ########### # ########### # # # ### #
#     #   #       # #       #         #   #   #   #   #   #     #             # # #   #     #   #   # #       #   # #       #   # # # # # # #
# # ### # # ##### # # ################### ### ### # # # ### ### ############### # ##### ####### # ### ######### # # ####### # # # # ### # # #
# # #   #   #   # # #       #     #   #     # # # # #   #   #   #       #     # # #   #         # # #           # #         # # # #   #   # #
# # # ####### # ### ####### ##### # # # ##### # # # ##### ####### ##### # ##### # # # ########### # ############# ############# # ### ### # #
# #   #       #       #   #     #   # #   #   # #   #     #   #   # #   #       #   #   #         #   #         #         #     #   #   # # #
# ##### ############# # # ##### ##### ### # ### ##### ### # # # ### # ######### # ### ### ########### # ####### ##### ### # # ##### ### # # #
#   #   #         #     # #   #       # #         #   #   # # #     # #   #   # # #   #   #     #     #   #       #   #   # #     #   #   # #
### # ### ##### ### ####### # ####### # ########### ####### # ##### # # # # # # ### # # ### ##### # ##### # ##### # ### ####### # ### ##### #
#   # #       # #   #       #     #   #   #         #       # #     # # #   # #     # # #   #     #       #     # # # # #       #   #       #
# ### # ####### # ### ######### ### ### # # ##### ### ####### # ##### # ##### ######### ### # ################# # # # # # # ####### ####### #
# #   # #     #   #   #       #   #   # # #   #   #   #     # # #   # #   # # #       # #   # #       #         # # #     # #   #   #       #
# # ##### ### # ### ### ######### ### ### ### ##### ### ### # # ### # ### # # # ##### # # # # ####### # ########### # ####### # ### # #######
# #     # #   #   #   #     #       # #   # # #     # # # # # #   # #   #   #   #     # # # #         #     #       # # #   # #   # # #     #
# ##### # # # ####### # ### # ####### # # # # # ##### # # # # ### # ### ### ##### ### # # ##### ########### # ####### # # # # ### ### # ### #
#     #   # # #       # # # # #     #   # # # #   #   # # # #     #   #       #   # # # #       #   #       # #         # #   # #   #   # # #
##### ##### # # ####### # # # # ### ##### # # ### ### # # # ####### # ######### ### # # # ####### # # ##### # ########### ##### ### ##### # #
#   # # #   # #     #     # #   #   #   # # #     #   #   # #     # #     #     #     # #     #   # # #   # #       #     # #     #   #   # #
# ### # # ### ##### # ##### ##### # # # # # ####### ##### # # # # # ### ### ##### ##### ####### ### # # # # ####### # ##### # # # # # # # # #
# #   # #   # #   # # #   #     # #   # #     #   #       #   # # #   #   #     #   #   #       #   #   # #     # #   # #     # # # # # #   #
# # ### ### ### # # ### # # ### # ##### ##### # # # ######### # # ####### ##### ### # ### ####### ##### # ##### # ##### # ##### # # ### #####
#   #   #   #   # #     # # # # # #   #     # # # #     #   # # # #       #   # #   #     # #   #     # # #   #       #   #     # #   #     #
# ##### # ### ### ####### # # # # # # ####### # # ####### # ### # # ##### ### # ########### # # ##### ### # ######### ##### ##### ### ##### #
#       #       #           #   #   #           #         #     #   #         #               #           #                 #       #       #
#############################################################################################################################################
