#######################################################################
#   #             #             # #       #     #         #     #     #
### ########### # # ##### ##### # # # ##### # # ##### ### ### # ### ###
# #     #       # #   #   #     #   #     # # #   #   # #     #   #   #
# ##### # ####### ##### ### ######### ### # # ### # ### ######### # # #
#     # # #     #     # # # #   #   # # #   #   #   #   #         # # #
# # ### # # ### ##### # # # # # # # # # ####### ##### # # ########### #
# # #   # # #   # #   # # #   #   # #     #     #     #   #   # #     #
# # # ### ### # # # ### # ######### ##### # ##### ######### # # # # ###
# # #   # #   # # #     #         # # #   # #   # #       # # #   #   #
# # ### # # ### # ######### ##### # # # ### # ### # ### # # # ####### #
# #   #   # #   #           #   # # #   #   #     # #   #   #       # #
# ### ##### # ########### ### # # # ##### ### ##### # ############# # #
# #   #     #           # #   # # #       # # #   # # #           #   #
# # ### ### ########### # # ### ########### # # # # # ####### ####### #
# # #   # #   #     #   # #   #   #           # #   #   #   # #     # #
# # # ### ### # ##### ### # ##### # ################### # # # # ### # #
# #   #     # #     # #     #     #     # #             # # #   #   # #
# ##### ### # ### # # ### ### ### ##### # # ### ####### # # ##### ### #
#       #   #   # # #   #   #   # #   # # # # #   #     # #     #   # #
######### ##### # # ### ### ### ### # # # # # ### ##### # ##### ### # #
#   #   #   #   # #   # #   # # #   #   # #   # #     # # #   # #   # #
# # # # ### # ##### ### # ### # # ####### ### # ##### ### ### # # ### #
# #   # #   #     #     #     # #   #       #       #         # #     #
# ##### # ####### # ########### ### # ### # ####### ########### # #####
#     #   #     # #     #         # #   # # #         #     #   #     #
##### ##### ### # ##### # ####### # ##### ### ######### ### # ####### #
#   #   #   #   #     #   #   #   # #   # #   #     #   # # #     #   #
# # ### ##### ####### ##### # # ### # # # # ##### ### ### # ##### # ###
# # # #     # #   #   #     #   #   # #   #   #   #   #   #       # # #
# # # ##### # # # # ### ####### # ### ### ### # # # ### ########### # #
# #       # #   # #   # #     # # #     #   #   # # #           #   # #
# # ####### # ### ### ### ### ### # ### ######### # # ####### # # ### #
# # #     # # #   # # #   # #     # # #     #     # #   #   # # # #   #
# # # ### # ### # # # # ### ####### # ##### # ##### ### # # # ### # # #
# # #   #   #   # # # # #       #         # #   #   #   # # #   # # # #
# ##### ##### ### # # # # ### # ######### # # ### ### ##### ### # ### #
# #     #     # # # # # #   # # #     #   #   #   #         # # #   # #
# # ####### ### # # # # ##### # # ### # ####### ### ####### # # ### # #
#           # #     # #   #   #   #   #   #   # #   #   #     #   # # #
# ########### # ##### ### # ####### ### ### # # ##### # ##### # ### # #
# #   #     #   # #     #   #     # # # #   # #   #   #   #   #   #   #
### # # ### # ### # ### ##### # # # # # # ### ### # ##### ####### ### #
#   #   #   #     #   #   #   # # # # # # # # #   #   # # #   #   # # #
# ####### ####### ### ### # ### ### # # # # # # ### # # # # # # # # # #
# #     #   # #   #   #   # # # #   #   # # #   #   # #     #   #   # #
# # ### ### # # ### ####### # # # ####### # ##### ### ############# # #
# #   # #   #   #   #       # # # #       #       # #         #     # #
# ### ### ### ### ### ####### # # # # ##### ####### ######### ####### #
#   #     # # #   #   #       # # # # #   #       #       #   #     # #
### # ##### # # ### ### ### ### # ### # # ####### # ### ### # # ### # #
#   # #       #   #     #   #   #     # # #     # # #   #   # # #   # #
# ### ####### ### ####### ### ######### # # ### # # # ### ### # # ### #
# #         # #     #   #   #           #   # # #   # #   #   # #   # #
# ######### # # ##### # ### ########### ##### # ##### # ### ### ### # #
#         # # #       #   # #     #   #   #   #     # #   # #   # #   #
# ####### # # ########### # ### # # ##### # # # ##### ### ### ### #####
# #   # # # # #           #     # #   #   # #   #     #   #   #       #
# # # # # # ### ####### ######### ### # ######### ##### # # ### ##### #
#   #   # #     #     # #       # #   #     #   # #     # # # #     # #
####### # ####### ### ### ##### # # # ##### # # # # ### ### # # ### # #
#       # #     #   #     #   #   # #   # #   # # #   # #   #     # # #
# ####### # ### ### ####### # ##### ### # ##### # ### # # ####### # # #
#   #   #   # #     #       #       # # #     #   #   # #       # # # #
### # # ##### ####### ####### # ##### # # ######### ### ####### ### ###
# # # #             #   #   # # # #     #         #   #       #   #   #
# # # ##### ####### ### # # ### # # ######### ### ### ########### ### #
#   # #   #   #     #   # # #   # # #       #   # # #       #   #     #
# ##### # ### # ######### # # ### # # ##### ### # # ####### # # ##### #
#       #     #           #   #       #         #         #   #       #
#######################################################################
