#############################################################
# #     #             # #   #           #           #       #
# # ### # ### ####### # # # # ##### ### ### ######### ##### #
# #   # # # #     # # #   #     #   # #   #             #   #
# ### # # # ##### # # ##### ##### ### ### ### ########### # #
#     # #   #   # #   #   # #     #     #   # #     #   # # #
####### ### ### # # ### # ### ######### ### ### ### # # # # #
#       #       # #     # #   #           #   # # #   # # # #
# ####### ####### ####### # ### # # ######### # # ##### # ###
# #   #   #   #   #   #     #   # # #         # #     # #   #
# ### # ### # # ### # ########### # # ######### ### # # ### #
#   #     # #   #   #   #       # # # #         #   # #   # #
### # ##### ##### ##### # ##### # ### ######### # ####### # #
#   # #   #     # #   # #     # #   #     #   # #       #   #
# ### # # # ### # # # # ##### # # # ##### # # # ##### ##### #
# # # # # #   # #   # #   #   # # #     # # # #     #       #
# # # # # ##### ##### ### # ### # ##### # # # # ### ##### ###
# #   # #     # #       #   #   # #   # #   # #   # #   # # #
# ##### ##### # # ########### ### ### # ##### ### # # # # # #
# #     # #   #     #   #     #     # #     #   # #   # # # #
# # ##### # ##### ### # # ######### # # ### ### ### ### # # #
# # #     #     # #   #   #       # # # #     #   #   # # # #
# # # ######### ### ####### ### # # # # ### ##### # ### # # #
# # # #       # #   #       #   # #   #   # #     # #   #   #
# # # # # ##### # ####### ### ### ### ### # # ##### # ##### #
#   #   #     #   #     #   # #   #     # # # #   # #   #   #
##### ####### ####### # ##### # ######### ### # # # ### # ###
#   #   #   #         #   #   #   #       #   # # # #   # # #
# ##### # # # ########### # ##### # ##### # ### # # # ### # #
#     # # # # #   #         #       # #   # #   # # #   #   #
# ### # ### # # # ################### # ### # ##### ### ### #
# #   # #   #   #   #     #         # # #   #         # #   #
# # # # # # ####### # ### # ####### # # # ### ######### #####
# # # #   #   #   #   # #   # #     #   # #       #   #     #
### ######### # # ##### ##### # ### ##### ### ##### # ##### #
#   #         # #   #       # #   # #   #   # #     #     # #
# ### ######### ### # ##### # ### ### # ### ### ######### # #
#   # #     #   #   # # #   #   #     #   #   #   #   #   # #
# # # # # # ### ### # # # ##### ####### # ### # # # ### ### #
# #   # # #   #   #   #   #           # #   # # # #     #   #
# ##### # ### ### ##### ### ######### # ### # ### # ####### #
#     # # # # #   #   #     #   #     # #   #     #     #   #
##### # # # # # ### ######### ### ##### # ############# # # #
# #   # # #   # #           #   #   #   # #   #       # # # #
# # ##### ### # # ######### # # ### # ##### # # ##### # # ###
# #     #   #   # #     #   # #     # #     #   #   #   #   #
# ##### # # ##### # ### # ### ####### # ######### # ##### # #
# #   # # #     #   #   #   #       #   #     #   #     # # #
# # # # ####### ######### # ####### ####### # # # ### ### # #
#   # #       #         # #       # #     # #   #   # #   # #
##### ####### # ####### # # ####### ### # ### ##### ### ### #
#   #     #   # #       # #     #   #   #   # #   #   # #   #
# # # # ### ### # ####### ##### # ### ##### ### # # # # # # #
# # # # #   #   # #   # #     #   # #   #       # # #   # # #
# # ### # ##### # # # # ##### ##### # # ######### # ##### ###
# #   # #     # #   # #   #   #       #   # #     #     #   #
# ### # ##### ####### # # # ####### ##### # # ############# #
# #     #     #       # # # #     # #   # # # #           # #
# ####### ##### ####### ### ### # ### # # # # # ######### # #
#               #               #     #   #     #           #
#############################################################
