###############################################################################################################
# #     #             # #     #         #           #                   #   #     #     #         # #         #
# # ### # ### ####### # # # ### ### ### ### ##### # # ############### # # # ##### # ### # ### ### # # # ##### #
# #   # # # #     # # #   #     #   # #   #     # # # #           #   # # #       # # #   #   # # #   #     # #
# ### # # # ##### # # ##### ##### ### ### ##### # ### ####### # ### ### # ####### # # ##### ### # # ##### # # #
#     # #   #   # #   #   # #     #   # #   #   #     #     # # #   # # #   #     #     # # # #   # #   # # # #
####### ### ### # # ### # ### ##### # # ### ### ####### ### # ### ### # ### # ######### # # # # ##### # # # # #
#       #       # #     # #   #     #     #   # #   #   #   # #   #   #     # #           # #   #     # # # # #
# ####### ####### ####### # ### # # ######### # # # # ### ### # ### ####### ### ########### # ##### ### ### # #
# #   #   #   #   #   #     #   # # #         #   #   #       # #           #   #   #       # #     # #     # #
# ### # ### # # ### # ########### ### ########### ############# ############# ### ### ####### ### ### ####### #
#   #     # #   #   #   #       #   # #         # #   #       #     #   #       #   #     # # #   #           #
### # ##### ##### ##### # ##### ### # ######### # # # # ##### ##### # # # ##### ### ##### # # # ### ###########
#   # #   #     # #   # #     # #   #     #   #   # #   #   # #   # # #   #   #       #   #     #     #       #
# ### # # # ### # # # # ##### # # ####### # # # ### ####### # # # # # ##### # ####### # ############# ### ### #
# # # # # #   # #   # #   #   # #       # # # #   #   #   #     #   # # #   #       # #   #       # #   # # # #
# # # # # ##### ##### ### # ### # ### # # # # ### ### # # ########### # # ######### ##### # ##### # ### # # # #
# #   # #     # #       #   #   # #   # #   # #   # #   #   #           # #       #     #   #   # #     #   # #
# ##### ##### # # ########### ##### # ####### ### # ####### # ####### ### ### ### ##### ### # # # ### ##### # #
# #     # #   #     #   #     #     # #     #   #     #   #   # #   # #   #   #     # #   #   # #   #     # # #
# # ##### # ##### ### # # ##### ####### ### ### ##### # # ##### # # ### ### # ##### # ### ######### ##### ### #
# # #     #     # #   #   #               #   #   # #   #       # #     #   # #   #   # #     #     #   #   # #
# # # ######### ### ################### ### ##### # ########### # ####### ##### # ### # ##### # ##### # ### # #
# # # #       # #   #       #         # #   #     #   #       # # #       #     #   #       #   #     #   #   #
# # # # # ##### # ### ### # # ####### # # # # ####### # # ##### # ##### ### ####### ####### ##### # ######### #
#   #   #     #   #     # # #   #   # # # # # #   #   # #     # #     #         # # #   #         # #       # #
##### ####### ########### # ### ### # # # ### # # # # # ##### # ##### # ####### # # # # ############# ##### # #
#   #   #   #         #   # #   #   # # # #   # #   # #   # #     #   #   #   # # #   #     #             # # #
# ##### # # # ####### # ### # ### ### ### # ### ##### ### # ####### ##### # # # # ######### # ############# # #
# #   # # # # #   #     #     #       #   # # #     #   # #   #     #     # # #     #     # # #       #   # # #
# # # # ### # # # ################### # ### # # ### ##### ### # # ######### # ##### ### # # # ##### # # # # # #
#   # # #   #   #   #     #         #   #   # # # #     # #   # # #   #     #   # #   # # # #     # # # #   # #
# ### # # # ####### # ### # ####### ### # ### # # ##### # # # # ### # # ####### # ### # ### ##### # # # ### # #
# #   #   #   #   #   # #   # #     #   # #       #   #     # #     # #   # #   #   # # #     #   # # # #   # #
### ######### ### ##### ##### # ### ##### ### ##### # ####### ####### ### # # ##### # # # ##### ### # # # ### #
#   #         #       #       #   # #   #   # #     #     #   #     # #   # # #   # # # #     #   # # # #   # #
# ### ######### ##### ####### ### ### # ### ### ######### # ####### # # ### # # # # # # ##### ### # # # ##### #
#   # #   #         #           #     #   #   #   #   #   # #   #   # #     # # # #     #   #   #   # #     # #
# # # ### # ####### ##### ##### ####### # ### # # # ### ### # # # ### ##### # # # ##### # ### ####### ##### # #
# #   #   #     #   #   # #   #       # #   # # # #     #     #   #   #     #   #     # #   # #           # # #
# ##### ####### # ##### # # # ####### # ### # ### # ##### ######### ### ############# # ### # # ########### # #
#     # #       #     #   # # #     # # #   #     #     #   #       #   #     #       #   # #   #   #       # #
##### # # ########### # ### # # ### ### # ############# ##### ##### # ### ##### ######### # ##### ### ####### #
# #   #           #   #   # #   # # #   # #   #       # #   #     # # #   #     #       #   #       #       # #
# # ############# # ####### ##### # # ##### # # ##### # # # # ### ### # # # ####### # # ### ####### ####### # #
# #     #     #   #       #       # # #     #   #   #   # # #   #       # # #     # # #   #       #   # #   # #
# ##### # # ### ######### ### ##### # # ########### ##### # ### ########### # ### ### ### ####### # # # # ### #
#     # # #     #       # #   #     #   #           #     # # #     # #     # #       #   #     #   # # #     #
# ### # ####### # ##### # # ### ######### ##### ##### # ### # ##### # # ##### # ####### ### ######### # #######
# #   #       # #   # #   # # #           #     #   # #   # #     #   #   #   #   #   #   #     #     #     # #
# ########### # ### # ### # # ########### ### ### # # ### # ### # ### ### # # ##### # ### # ### # ##### ### # #
#         #   #   # #   # #       #     #   #   # #     # #   # #     #   # #   #   #   # # #   # #     #   # #
##### # ### ####### # ### ####### # # ##### ##### ####### ### # ####### ### ### # ##### # ### # # # ### # ### #
#     # #   #       #     #     # # #     # #         #   # # #   #     #   #   # #   # #     # # # #   #   # #
# ##### # ##### ##### ##### ### # ##### # # # ######### ### # ##### ######### ### # ### ### ##### ### ##### # #
# #     #     #     #   #   # #   #     # #   #         #   # #   # #         #   #   #   # #   #     # #   # #
# # ######### # ### # ### ### ##### ##### ##### ######### # # # # # # # ####### ##### ### ### # ####### # ### #
# #   # #     # # # # #   #         #   #     #         # #   # # # # # #     # #   #   #     #       # # #   #
# ### # # ##### # # # # ##### ####### ##### ########### # ##### # # ### # ### # # # ### ######### ### # # ### #
#   # # #   #     # # #   #   #   #         #           # #     #   #   #   #   # #   #       #   #     #   # #
# # # # ### # ##### ##### # ### # ##### ##### ########### # ######### # ### ##### ### # ### ### ### ####### # #
# # #     # # #   #   #   #     #     # # #   #         #   # #       # #   #       #   #   #   #     #     # #
# # ####### # # # ### # ### ##### ### # # # ### ####### ##### # ### ##### ### ##### ##### ### ######### ##### #
# #         # # #     # #   #   # #   #   # #     #   #       # # #     # #   #     #   # # #         #       #
# ########### # ####### # ### # ### ##### # ##### # # ### # ### # ##### # ##### ##### # # # ######### ####### #
# #       # # #   #   # # # # #     #     #     #   # #   # #   # #   # #     #     # #   #     #   #   #     #
# # ##### # # ### # # # # # # ####### ######### ##### # ### # ### # # # ##### ##### # ##### # ### # # # # #####
# #   # # # #   #   #   #   #   #   #         # # #   #   # # #     # #     #   #   #   #   # #   #   # # #   #
# ### # # # ### ############### # # ######### # # # ##### ### ####### ##### ### # ##### # ### # ### ##### # ###
#     #   #   #   #             # #         # # # #   #   #   #   #     #   #   # #   #   #   # #   #     #   #
####### ### ##### # ### ############### # ### # # ### # ### ### # # ### # ### ### # # ##### ### # ### ####### #
#     # # #     # #   #       #       # #     # #     #     #   # # # # #       # # #     #   # # # #         #
# # # # # # ### # ##### ##### # ##### # ####### ##### ####### ### # # # ####### # # ##### ##### # # ######### #
# # # # # # # #   #   # #   # #   # # #   # #   #   # #     #   # # #   #     #   # #   #     # # #       #   #
# # ### # # # ##### # ### # # ### # # ### # # ### # # # ### ### # # # ### ### ##### # ####### # # # ##### # ###
# # #   # # #   #   #     # # #     # #     #     # #   #   #   # # #   # #         #       #   # #     # #   #
# # # ### # # # # ######### # # ##### ############# ##### ### ### # ### # ########### # ### ##### ####### ### #
# # # #   # # #   # #   #   #   #     #     #     # #   #     # #   #   # #     #     #   #     #     #   # # #
# # # # ### # ##### # # # ### ### ##### ### # ### # # # ####### # ####### # ### ##### ### ##### ##### # # # # #
# #   #   # # #     # #   # # # #         # #   # # # #     #     #     # #   #     #   # # #       #   #   # #
# ####### # # # ### # ##### # # ########### # ### # # ##### ##### # ### # ### ##### # ### # # ########### ### #
# #     # # # # # #   #     # #         #   # #   #   #   # #   # #   # #   # #   # # #   #   # #     #   #   #
# # ### # # # # # ####### ### # # ##### # ### # # ####### # # # ##### # ### # # ### ### ### ### # ### # ### ###
#   #   # #   #   #       #   # # #   # #     # #   #     # # # #     #   # # #   #   # #   #   #   # #   #   #
##### ### ####### # ### ### ##### # ### ####### ### ### # # # # # ####### # # ### ### # ### ### # ### # ##### #
#   #   #   #     #   #     #     #           #   #     # #   # # #     #   #   #   # #   #     # #   # #     #
# ##### # # # ####### ####### ################### ########### # # ### # ### ### # ### ### # ##### # ### # #####
#       # # # #     #   #     #             #   #   #       # # #   # #   #   #   #   #   # #   # #     # #   #
# ####### # # # ####### # # ### ########### # # ### # ##### ### # # # ### # ##### # ### ##### # # ####### # # #
#       # #   # #       # # #   #   #     #   # #   # #   #   # # # #   # # #     # #         #         #   # #
####### # ##### # ######### # ### # # ######### # ### # ##### # # # ##### # # ##### ##### ################### #
#   #   # #                 # #   # #         # #   # #       # # # #     # #   # #     # #   #   #     #     #
# # # ### ######### ######### # ### # ####### # ### # ### ##### # # # ##### ### # ##### ### # # # # ### # #####
# # #   #       # # #       # #   # #   #   #       #   #       # # #         #     # #     # # # # # # #   # #
### ### ####### # # # ##### # ### # ##### # ########### ######### # ############### # ####### # # # # # ### # #
#   #   #     # #   # #   # # #   # #     #           #   #   #   # #     #       #       #   # #   # #   #   #
# ### ### ##### ##### # # # # # ### # ############### ### # ### ### # ### # ### ######### # # # ##### ### ### #
#     # #             # # # # # # #   #             # #   # #   #   # #   # # #           # # #     #   # #   #
# ##### # ############### # # # # ##### ### ######### # ### # ### # # # ### # ############# ####### # # # # ###
#     #   # #     #     # #   # #     # # #     #     # #   # #   # # #   # #   #         #     #     # # #   #
##### ### # # ### # ### # ### # ##### # # ##### # ##### # ### # ##### ### # # ### ##### ####### # ####### ### #
#   #   #   # # #   #   # #   # #   # #     # #   #     #     # #     #   # #     #   #     #   # #     # #   #
### ### ##### # ##### ### # ### # # # ##### # ##### # ### ##### # ##### ### ##### # ####### # ### # ### # # ###
#     #     # #     # #   #   #   # #       #   #   #   #   #   #   # # #   #   #   #       #     # #     # # #
# ######### # ### # # # ##### ##### # ####### # ####### ##### ##### # # # ### # ##### # ########### ##### # # #
# #     #   #   # #   #       #   # #     #   #       # #   # #     # # # #   #     # # #         #     # #   #
# # ### # ### # # ############# # # ##### # ######### # # # # # ##### # # ### ##### # ### ####### ##### # ### #
# #   #   #   # # #       #     # # #     #   # #     #   # # #   #   # # #   #     #           #     # # #   #
# ### ######### # ### ### # ##### # # ####### # # ######### # ### ### # # # ### ################# ### # ### ###
#               #     #     #       #         #             #         #     #                     #   #       #
###############################################################################################################
