#########################################################################################################################
# #       #             #     #         #                 #           #         #   #     #     #       #     #   #     #
# # ##### ##### # ##### # # # ### ##### ########### ##### ##### # ### # # ##### # # ### # ### ### ### # # ### # # # ### #
#   #   #     # # #   # # # #     #   #   #   #     #   # #   # # #   # # # #   # #   # #     #   #   #   # #   #   # # #
####### ##### ### # ### ### ####### # ### # # # ##### # # # # ### # ##### # # ### ### # ####### ### ####### ######### # #
#           #     #   #   #   #     #   #   # #   # # #   # #   # #   #   #   #     #   #         # #   #   #         # #
# # ####### ######### ### ### ##### # ####### # # # # ##### ### # ### # ### ### ### # ### ######### # # # # # ### ### # #
# # #     #   #   #   # # #   #   # #     #   # # # # #       # # # # # #   #     # # #   #     #   # # # #     #   # # #
# # ##### ### # # # # # # # ### # ####### # ### # # # # ##### # # # # # # ####### # ### ##### # # ### # # ######### ### #
# #   #   #   # #   # # #   #   #       # #   # # #   # #   # #   #     # #     # #   # #     # #   # # # #   #   #   # #
# ### # ### ### ##### # ##### ### ##### # ### ### # ### # ### # ######### # # # # ### # # ##### ### # # # ### # # ### # #
#   # #     #   #   # #   # #   # #   #     #     # # #   #   # #       # # # # #   #     #     #   # # #     # #     # #
### # ### ### # # # # # # # # # ### # # ########### # ### # ##### ##### # ### # ##### ########### ### # ##### # ##### # #
# # #   #   # # # # # # # #   # #   # # #           #   # #       #   # #   # #     #   #       # #   # #   # # #     # #
# # ### ### # # ### # # # ##### # ### # # ############# # ######### # # ### # ##### ### # ##### # # ### # # # # ####### #
# #   #   # # #   #     #     #   #   # #       #       #     #   # # #   #   # #   #   # #   #   # #   # # # #         #
# ### ### # ##### ########### ### # ### ####### # # ######### ### # # ### ##### # ### ### ### # ### # ##### # ###########
#     #   # #   # #   #   # #   # # # #   #   # # # #   #   #     # #   # #   #   # # # #   #   #   #   #   #   #       #
# ##### ### # # # # # # # # ### ### # ### # ### ### # # # # ##### # ### # # ### ### # # ### ##### ##### # # ### # ### # #
#   #   #   # #   # #   # #   #   # #   # #   #   #   # # # #     #   # # #   # #   #   #   #       #   # # #   #   # # #
### # ### ### ##### ##### # ##### # # ### # # ### ##### # # # ####### # # # # # # # # ### ### ####### ### ### ####### # #
#   #   # # #       #   # # #   #   #     # #   # #     # #   #     # #   # #   # # # #   #   #   #   # #   # #       # #
# ##### # # # ######### # # # # ##### ######### # # ##### ##### ### # ##### ##### ### # ### ##### # ### # # # ### ##### #
#     # # #   #       # # #   #   #             # #         #   # # #   # # #     #   # #   #     #   # # # #     #   # #
####### # ### # ##### # # # ##### # ############# ######### # ### # ### # # ##### # ### # ##### # ### # # # ####### ### #
#       #   #   #     # # # #   #     #     #   #         # #   #   #   # #     #     # # #     # # # #   #           # #
# ######### ##### ##### # ### # ####### ### # # ######### ##### # ### ### ##### ####### # # ##### # # ########### ### # #
# #     #   #     #   # #     #           #   #     #   #       #     #       #     #   #   #   #   #   #       #   #   #
# # ### ### ##### # # # ######### ############# ### # ################# ##### ##### # ####### ### ##### # ##### #########
#     #   #     #   #   #       # # #           #     #     #     #   # #   #   #   # #           #   # #     # #       #
# ####### ##### ######### ##### # # # ### ####### ##### # # # # # # # ### # ### # ### # ########### # # ### ### # ##### #
#   #   # #   #   #       #   # #   # #   #   #   #   # # # # # # # #     #     # #       #       # # #   # #   # #     #
# ### # # # ##### # ####### ### ##### # ### # # ### # # # ### # # # ############# ####### ### ##### # ### # # ### # ### #
# #   #   #     #   # #   #   # #     #   # # # # # # # #     # #   #     #     # #     # #   #     #   #   #     # #   #
# # ### ####### ##### # # # # # # ##### ### # # # # # # ####### ### # ### # ### # # ### # # ### ####### # ##### ### #####
# # #   #     #       # #   #   #   #   #   # #   # #     #     #   # # #   # # #   #   #   #   #   #   # #   # #   #   #
# # ##### ### ##### # # ######### # ### # ### ##### ####### ######### # ##### # ##### ### ### ##### # ##### # ### ### # #
# # #   #   #     # # # #     #   #   # # # #     #   #   #   #       #       #     # #   #   #     # #     #   #     # #
### # # ### ##### # # # ### # ####### # # # ##### # ### # ### # ######### ### ### ### # ### ### # ### # # ##### ##### # #
#   # #   # #   # # # # #   #         # #   #   #   #   #     # #       #   # #   #   # #   #   #   # # #   #   #   # # #
# ### ### # # # # ### # # ########### ##### # # ##### ######### ##### # ##### # ### ##### ######### # ##### # ### # ### #
#     # #   # # #   #     #   # #     #   # # # #   #     #     #     #   #   #     #     #         #     # #     #   # #
# ##### ##### ##### ####### # # # ##### # # # # # # ##### # ##### ####### # ######### ##### ####### ##### # ######### # #
#     #     #     #     #   #   #   #   # #   # # #     #   #     #   #     #       #   # #   #   # #   # # # #       # #
##### # # ### # ####### # # ####### # ### ##### ####### ####### ### # ####### ##### # # # # # # # # ### # # # # ####### #
#     # #     #   #     # # #       # #       # #       #     #     #         #   #   # # # # # #   #   #   #   #       #
# ####### ####### # ##### ### ####### # ####### # ##### # ### ##### ########### # # ### # # # ### ### ####### ##### ### #
#   #   #   #     # #     #   #       # #     #   #   # # # # #   #   #   #     # # #   # # #   # #     #     #     # # #
### # # ##### ##### # ### # ### ####### # ### ##### # # # # # # # ##### # # ##### # # ### # ### # ### # # ##### ##### # #
#   # #     #     # # # #   #   #     #     #     # # #   # #   #       # # #   # # #   # # #   #   # # #   #     # #   #
# ### ##### ##### # # # ##### ### # ##### ### ### ### ##### ############# # ### # ### # # # # ##### ### ### ##### # # ###
#   # #   # #     # #       #   # # #   # #   # #         #             # # #   #   # # #   #   # #       # #     # # # #
### # ### # # ##### ### ####### # # # # ### ### ######### # ######### ### # # # ### # # ### ### # # ####### # ##### # # #
# # #   #   # #     # # #       # # # # #   #         #   #     #   #     # # #   # # #   #   # #   #       # #     #   #
# # ### # ### # ##### # # ####### ### # # ### # ### ### ####### # ######### # ##### # ### ##### # ### ####### # # ##### #
# #   # #     #   # #   #     #     # #   #   # #   #   #   #   #     #     #     # # # #     # # # # # #     # #       #
# ### # ######### # # ####### # ### # ##### ### ##### ### # # ##### # # ### ##### # # # ##### # # # # # # # #############
#     #   #       #   #     # # #   #     #   #     #     # #   #   # #   #     # # #       # # #   # #   #   #         #
# ####### # ####### ### ### # ### # ##### ### ##### ##### ##### # ### ### ##### # # ### ##### # ### # ##### # # ####### #
#     #   # #     # #   #   #     # #   # #   #   #     # #     # #     # #     # #   # #     # #   # #   # #   #       #
##### # # # # ##### ### # ######### # # # # ### # # ##### # ##### ##### ### ##### ### ### ##### ##### # # ####### ##### #
# #     # # # #     #   #     #   # # #   # # # #   #     #     #     #   # #   #   #     #         #   #   #   # #     #
# # ####### # # ##### ####### # # # # ##### # # ##### ######### # ### ### # # # # # ####### ####### ####### # # # # #####
# #   #     # # #     #   # # # #   # #   #   #   #   #       # #   # # #   # # # #   #     #     #       # # # # #     #
# ### # ##### # # ##### # # # # ##### # # ### ### # ### # ### # ##### # ##### # # ### # ####### # ####### # # # # ##### #
# #   # # #   # # #     # # # # #   #   #   # #   #   # # #   # #     # #     # #   # #         #     #   #   # # #     #
# # ### # # # # # # ##### # # # # ##### ### # # # ### # # ### # # ##### # ##### ### # ############### # ####### # #######
#   #   #   #   # # #   # #   #   #   #   # # # #   # # #   # #   #     # #   #     #                 #     #   # #     #
##### ##### ##### # ### # ### ### # # ##### # # ##### ##### # ##### ### # # # ##################### ####### # ### # ### #
#     #   # #     #     #   #   # # #     # # #             # #   #   # # # #       #     # #     # #     # # #   # #   #
# ### # # # ##### ##### ### # ### # ##### # # ############### ### # # ### # ####### # ### # # ### # # ### # # # # # # # #
# #   # # #         # # # # # #   #   # #   #   #   #   #   #     # #   # # # #       #     # #   #   #   # # # #   # # #
# ##### # ######### # # # # ### ##### # ####### ### # # # # ##### # ### # # # # ############# # ########### # # ##### # #
#     # #     #       #   #     #     #       # #   # #   # #   # # #   #   #       #         #             # #   # # # #
# ### # ##### ########### ####### ####### ### # # # # ##### # # ### # # ##### ####### ################### ### ### # # ###
# #   # #   #           # #     # #     # #   # # # # #   # # #     # # #     # #     #   #     #   #     #   #     #   #
# # ### ### ######### # # # ### # # ### # ##### # ### # ### # ####### # # ##### # ##### # # # ### # # ##### ####### ### #
# #   #   #       #   # #   # # #   #   #   #   # #   # #   # #   #   # #     # #     # # # #   # #   #     #   #     # #
# ### ### ##### # # # ####### # ##### ### # # ### # ### # ### # # # ######### # ##### # ### ### # ##### ##### # ####### #
#   #   #   #   # # # #           #   #   #   #   # #   #     # # #                 # #   #   #   #   #       #         #
### # ##### # # ### # # ########### # ####### # ### ### ####### ################### # # # ### ####### ################# #
# # #     #   # #   # # # #     #   # #     #   #   #         #     #       #   #   # # #               #       #   #   #
# # ##### ##### # ##### # # ### # ### # ### ##### ### ######### # ### ##### # # ### # ####### ######### # ### # # # # ###
#   #   #   #   #     # # #   # #   # # # # #     #     #     # #   #   # #   #   # #       # #   #   # # # # # # #   # #
# ### # # ### ####### # # ### # ### ### # # # ####### # # ### # ### ### # ####### ### ##### ### # # ### # # # ### ##### #
#   # # #     #     #   #   # #     #   # #   #     # #   #   #   #   # #           # #     #   # #     #   # #   # #   #
### # # ####### # ####### ### ##### # ### ##### # # ### ### ##### ### # # ######### ### ### # ### ######### # # ### # # #
# #   #   #     # #     #   # #   # #         # # #   #   #         # # # #       #     #   # # #           # #   #   # #
# ####### ####### # # ### # # # ### ######### ### ### ### ########### # ### ##### # ######### # ############# ### # ### #
# #   #   #     #   #     # # #         #   #   # #   # # #     #     #       #   # #         #             # #   # #   #
# # # # ### ### ### ##### # # ######### # # ### # # ### # # ### # ### ##### ### # ### ######### ### ######### # ### # ###
# # #   #   # #   # #   # # # #   #   #   # #   # #   #   # # # #   # #   # #   # #   #     #   #   #     #   #   # #   #
# # ##### ### ### # # # ### # # # # ### ##### ### ### ### # # # ### # # # ### ### # ### ### # ### ### ### # # ### # ### #
# # #     #     # # # #     # # # #     #   #     # #   # # #   #   # # # #   #   # #   # # # #   #   # #   #   # # #   #
# # ##### # ### # ### ####### # # ####### # ####### ### ### # ### # ### # # ### ### # # # # # # ### ### ####### # # # ###
# # #     #   # #   #   #   #   # #     # #           #     # #   # #   #   # # # # # # #     # #   #       #   # # #   #
# # # ####### # ### ### # # ##### # ### # # ######### ####### ### # # ####### # # # # # # ####### ####### # # ### # ### #
# # #   #     # # #   #   #     #   #   # #   #     #   #     #   # #   # #       # # # # #     #     #   # # #   # #   #
# # ### # ##### # ### ##### ### ##### ### ### ##### ### # ##### ### ### # # ##### # # # ### ### ##### # ### # # ##### # #
# #   # #   #       #       # #     # #   # # #   #     #       #   #   #   #   # # # #     #   # #   #   # # #   #   # #
# ### # ### ### ############# ##### # # ### # # # ### ########### ### ### ### # # # # ####### # # # ### # ### ### # #####
# #   #   #   # #       #         # #       #   #   #       #   #   # #   #   # # # #     #   # # # # # #   # # # # #   #
# # ##### # # ### ### # # # ##### # ############### ####### # ##### # # ### ### ### ####### ### # # # # ### # # # # # # #
# # #     # #     # # # # # #     # #             #   #   #   #   # # # #     # #   #       #   # # #     #   # # #   # #
# # # ##### ####### # # # # ####### # ########### ### # ##### # # # # # # ##### # ### ####### ### # ##### ##### # # ### #
# # # #   #   #     # # # #   #   # #         # #   # # #     # # # # # #   #   #     #     #     #     #       # #   # #
# # # ### ### ##### # ### ### # # # ######### # ### # # # ##### # # # ##### # # ####### ######### ##### ######### ##### #
# # # #     #       # #   # #   #     #     # #   #   # #   #   #   #       # #       #     #     #   # #       #       #
# # # # ######### ### # ### ########### ### # # ####### ### # ############### ######### ### # ##### # # # ##### ####### #
# # # # #       # #   # #         #     # # # # #         # #   #         #   #       #   # # #     # # # #   # #       #
# # # # # # ##### # ### # ##### # # ##### # # # # ####### # ### ### ##### # # # ##### ### # # ### ##### # ### # # #######
# #   #   # #     #     #     # # # #     #   #         # # # #   #     # # # # #   #     #       #   #       # #       #
# ##### ### # ########### ##### # # ##### # ####### ##### # # ### # ##### # ### # # ############### # ######### ####### #
# #   # # #   #         # #     # # #   #   #   #   #   #     #   # #     #   #   # #   #           #         #     #   #
# # # # # ##### ##### # ### ### ### # # ### # # ### # # ####### ##### ### ### ##### # # # ########### ####### # ### # ###
# # # # #   #     #   #   # # # #   # #   # # #   # # # #     # #   # #     # #     # # #     #   #   #     # # #   #   #
# # # # # # ##### # ##### # # # # ### ### ### ### # # # # ### # # # # # ##### # ####### ##### # # ##### ### # # # ##### #
# # # #   #     # # #   # # #   #   #   #   # #   # # #   # # # # #   # # #   # #       #   # # # #   #   # #   # #   # #
# # # ######### ### # # # # # ##### ### ### # # ##### ##### # # # ##### # # ### ##### # ### # # # # # ### # ####### # # #
#   #               # #     #     #       #   #             #     #       #           #     #   #   #     #         #   #
#########################################################################################################################
