###################################################################################################################################
# #       #             #     #         #                 #           #         #     #   #           #     # #       #       #   #
# # ##### ##### # ##### # # # ### ##### ########### ##### ##### # ### # # ##### # # # ### # ####### # ### # # # # ##### ### ### # #
#   #   #     # # #   # # # #     #   #   #   #     #   # #   # # #   # # # #   # # #   # # #   #   #     # #   #     # #   #   # #
##### # ##### ### ### # ### ####### ##### # # # ##### # # # # ### # ##### # # ### # ### # # # # # ### ##### ### ##### # # ### ### #
#     #     #     #   #   #   #   #     #   # #   # # #   # #   # #   #   #   # # # # # # # # # # #   #   #   #     # # #       # #
# ####### # ####### ##### ### # # # ### ##### # # # # ##### ### # ### # ### ### # # # # # # ### # ##### # ### ### ### # ######### #
#       # #   #   #     # #   # #     #   #   # # # # #       # # # # # #   #     # #     # #   # #     #   # #   #   #   #       #
# ####### ### # # # # ### # ### ######### # ### # # # # ##### # # # # # # ######### ##### # # ### # ####### # ##### # ### # ##### #
# #       #   # #   #   #   #   #   #   # #   # # #   # #   # #   #     # #     #   #   # #   #   #   #     #       #   # #     # #
# # ####### ### ####### ##### ### # # # # ### ### # ### # ### # ######### # # # # ### # # ### # ##### # ############### # ##### # #
# # #   #   #       # #     # #   # # #     #     # # #   #   # #       # # # # #     # # #   #     # #   #     #     # #     # # #
### # # # ######### # ### # # ### # # ############# # ### # ##### ##### # ### # ####### ### ##### ### ### # # ### ### # ##### # ###
#   # # #     #   #     # # # #   # #   #           #   # #       #   # #   # #     #   #   #   #   # #   # #       #       # #   #
# ### ####### # # ##### # ### # ####### # ############# # ######### # # ### # ##### # # # ### # ### # # ##################### ### #
#   #           #   #   #   # #       # #       #       #     #   # # #   #   # #   # # # # # #     # #           #           #   #
# # ############### ####### # # ##### # ####### # # ######### ### # # ### ##### # ### # # # # ##### # ########### # ########### # #
# #           #   #   #     # # #     #       # # # #   #   #     # #   # #   #   #   # #   #   #   #     #   # #   #       #   # #
# ########### # # ### # ##### ### ### ##### ### ### # # # # ##### # ### # # ### ##### # ### ### ######### # # # ######### ### #####
# #       #   # # # # #           #   #   #   #   #   # # # #     #   # # #   # #     #   # # #         #   #   #       # #   #   #
# # ### ### ### # # # ####### ######### # ### ### ##### # # # ####### # # # # # # # ##### # # ####### # ####### # ##### # # ### # #
# #   # #   #   #   #       # #         #   #   # #     # #   #     # #   # #   # # #   # #   #     # # #     #   #       #   # # #
# ### # # ### # ########### ### ########### # # # # ##### ##### ### # ##### ##### ### # # ### # ### # ### # ####### ######### # # #
#     # #   # #         #   #   #         # # # # #         #   # # #   # # #       # # #   #   #   #   # #   #     #   #   #   # #
# ######### # ######### # ### ####### ### # ### # ######### # ### # ### # # ##### # # # ### ##### ##### # ### # ##### # # # ##### #
# #   #   # # #   #   # #   #       #   # # #   #         # #   #   #   # #     # #   #   # #     #   # #   # #   #   #   #     # #
### # # # # # # # # # # ### ####### # # ### # # ######### ##### # ### ### ##### ######### ### ####### # # ### # ### ########### # #
#   #   # # #   # # # #   #   #     # # #   # # #       #       #     #       #     #     #   #       #   #   # #   #         # # #
# ####### # ##### # # ### ### # ##### # # ### # ### # ################# ##### ##### # # ### ##### ######### ### # ######### # # # #
# # #     #     #   #   # #   # # #   # #     # #   # #     #     #   # #   #   #   # # #   #     #   #     #   #   #     # #   # #
# # # ######### ##### ### # ### # # ### # ##### # ##### # # # # # # # ### # ### # ### ### ### ### # # # ##### ##### # ### ### ### #
# #             #     #   #   # # # #   # #   #   #   # # # # # # # #     #     # #       #   #   # # #     #   #   #   #   #     #
# ####### ########### # # ### # # # # ### # # ### # # # # ### # # # ############# ####### ### ##### # ### # # ### ### ##### ##### #
#     # # #   #     # # # #   # #   # #   # # #   # # # #     # #   #     #     # #     #     #     #   # #   #   #   #     #   # #
##### # # # # # ### ### # # ### ##### # ### # # ### # # ####### ### # ### # ### # # ### ### ### ####### # ##### ### ### ##### # ###
#     #   # # # # #     # # #       #   #   # #   # #     #     #   # # #   # # #   #   #   #   #   #   # #   #   #   #     # #   #
# ##### ### # # # ####### # # ##### ### # ### ##### ####### ######### # ##### # ##### ### ### ### ### ##### # ### ### ##### # ### #
# #   # #   # # #         # #   # #   # # # #     #   #   #   #       #       #     # #   #   # #   # #     #   #         #   #   #
# # # # # ### # ########### ### # ### ### # ##### # ### # ### # ######### ### ### ### # ### ### # # # # # ##### ####### ####### # #
#   # # # # # #             #     # #   #   #   #   #   #     # #       #   # #   #   # #   #   # # # # #   #   #   #   #     # # #
# ### # # # # ### ############### # ### ### # # ##### ######### ##### # ##### # ### ##### ### # # # # ##### # ### # ##### ### # # #
# # # # # # #   # #   #         #     #   # # # #   #     #     #     #   #   #     #     #   #   # #     # #     #   #   # # # # #
# # # ### # ### # # ### ##### # ####### ### # # # ####### # ##### ####### # ######### ##### ####### ##### # ######### # ### # # # #
#   #       #   # #   # # #   #       #   #   # #       #   #     #   #     #       #   #   #     #     # # # #       # #     # # #
### ######### ### ### # # # # ####### ### ##### ####### ####### ### # ####### ##### # # # ####### ### ### # # # ####### # ##### # #
#   #     #   # #   #     # # #     #         # #       #     #     #         #   #   # #           #   #   #   #       #       # #
# ### # ### ### ### ####### ### ### ######### # # ##### # ### ##### ########### # # ### ######### ##### ##### ### ### ########### #
#   # #   # #     #   #     #     #   #       #   #   # # # # #   #   #   #     # # #   #     #   #     #     # # #   # #         #
### ##### # # ### ### # ### # ####### # ########### ### # # # # # ##### # # ##### # # ### ### # ### ### # ##### # # ### # #########
# #     # # #   #     #   # #   #   # #         #     #   # #   #       # # #   # # #   # # #     # #   #   #     #   # #   #     #
# ##### # # ### ######### ### ### # # ######### ### # ##### ############# # # # # ### # # # ####### # ##### # ####### # ### # ### #
#   #   # #   # #         #   #   #   #       #   # #     #             # # # # #   # # #   # #     #     # #       # # #   #   # #
# # # ### ### # ### # ##### ### ### ####### ##### # ### # # ######### ### # # ##### # # ### # # ########### ######### # # ####### #
# #   #     # #   # # #     # # #   #     #       # #   # #     #   #     # #     # # #   #   #     #       #         #   #       #
# ##### ### # ### # # # ##### # ##### ### ##### ##### ### ##### # ######### # # ### # ### ##### ### # ####### ########### # ##### #
#   #   #   #   #   # # #     # #   #   #     #     # # # # #   #     #     # #   # # # #     # #   # #   #   #         #   #     #
### # ### ##### # ##### # # ### # # ### ##### ##### # # # # # ##### # # ### ##### # # # ##### ### # # # # # # # ####### ###########
#   #   #     # # #   # # # #   # #   # #   # #     # # #   #   #   # #   #     # # #       # #   # # # #   #   #     #   #       #
# ##### ##### # ### # # ### # ### ### # # # # ### ### # # ##### # ### ### ##### # # ### ##### # ### # ##### ##### ### ### # ##### #
#     #     # #   # # #   # #     # #   # # #   #     #   #     # #     # #     # #   # #     # #   # #   #     #   # #   #     # #
##### ####### ### # # ### # ####### ####### ### ####### ### ##### ##### ### ##### ### ### ##### # ### # # ######### # # ### ##### #
#   #   #       #   #     # #   #   #         #     # #   #     #     #   # #       #     #     # # #   #   #   #   #   #   #     #
# # ### # ##### ########### # # # # # ### ######### # ### ##### # ### ### # # # ### ####### ### # # ####### # # # ### ### ### ### #
# #   #   #   #       #       #   #   #   #   #     #   # #   # #   # # #   # #   # #   #     # #         # # # #   # #     # #   #
# ### ####### ####### # ######### ##### # # # # ##### # # ### # ##### # ##### ### # # # ####### ######### # # # # # ### ##### # ###
# # # #             # #   #     #   #   # # # # #   # # #     # #     #     #   # #   #       #       #   #   # # # #   #   # #   #
# # # ##### ######### ### # ### ### # ##### # # # ### # ##### # # ##### ### ### # # ######### # ##### # ####### ### # ### # # ### #
# # #     # #   #   # #   # #   #   # #     # # # #   #     # #   #   # # #   # # # #       # # #     #     #   #   #   # #   #   #
# # ##### # # # # # # # ### ### # ### # ##### # # # ####### # ##### ### # # ### # ### ##### # ### ######### # ### ##### # ##### ###
# #     #   # #   #   #   #   # #   #   #     # # # #   #   # # #         #   # #       #   #     #   #   # # #   #   # # #       #
# # ####### # ############# # # ######### ##### # # ### # ### # # ########### # ##### ### ######### # # # # # # ### # # # ### #####
# #         # #           # # #         # #     #   #   #     #     #   #     # #   # #   # #       # # # # # # #   #   #   # #   #
# ####### ### # ######### # # ######### # # ##### ### ############### # # ##### # # ### ### # ##### # # ### # # # ######### ### # #
# #     #   # #   #   #   # #   #   #     #   #   #                 # # # #     # # #   # #   #   # #   #   # # #   #   # #     # #
# # ### ### # # # # ### ##### # # # # ####### # ##### ##### ####### # # # # ##### # # ### # ##### # ##### ### # ### # # # ####### #
#   #   # # # # # #   # #   # # # #   #       #     #   # # #     #   # # #   #   #   #   #     # # #     #   #   #   # #     #   #
# ### ### # # ### # # # # # ### # ##### ########### ### # # # ### ##### # ### # ####### # ##### # # # ##### ##### ##### # ### # # #
# #   #   # #     # # #   #   # # #   # # #     # #   #   # #   #   #   #   # #   #   # # #     # # # #     #   #         #   # # #
# # ### # # ####### # ####### # # ### # # # # # # ### ### # ####### # ##### # ### # ### # # ##### # # # ##### # ########### ### ###
# # #   #         # #       #   #     # # # # # #   #   # #       # # #   # # #   #     #         # # #       #         #   # #   #
# # # ######### ### ### # ####### ##### # # # # ### ### # ####### # # # # # # # ### ############# # # ################# ### # ### #
# # # #   #     #   # # # #     # #     #   # #       # # #   #   # # # # # # # #   #       # #   #   #     #     #   #   # #   # #
# # ### # ### ### ### # ### # ### # ######### # ####### ### # # ### # # # # # # # ### ##### # # ####### ### ##### # # ### # # ### #
# # #   #   #   # #   #     #     # #         # #           # # #       #   # # # #     #   #   #     #   #       # # #   #   #   #
# # # ##### ##### # ############### # ### ####### ########### # ####### ##### # # # ##### ### ### ### # # # ####### # # ####### # #
# #   #   #       # #         # #   #   # #           #     # #     #   #     # # #   #   # # #     # # # # #     # #   #     # # #
# ##### # ######### # ##### # # # ##### ### ########### ### # ### # # ### ##### ##### # ### # # ##### # # # # ### # ##### ### # # #
#     # #   #     # # #   # #   #     # #   #   #   #   # # #   # # # #   #   #       # #   # # #     # # # # # #   #     #   # # #
##### ### # ### # # # # ### ### ##### # # ### ### # # ### # ### ### # # ### # ######### # # # ### ##### # ### # ##### ##### ### ###
#     #   #     # #     #   #   #   # #       #   #   #   # #       # #     #       #   # # #   #   #   # #   #       # #   # #   #
# ##### ######### # ##### ### ##### # ####### # ####### ### ##### ##### ########### # ##### ### # # # ### # ### ####### # ### # # #
# #     #       # #   #   # #       #     # # # #     #   #     # #     #         # # #       # # #     # #   # #     #   #     # #
# ##### # ##### # # ### ### # ########### # # # # ### # # ##### ### ##### ####### ### # ####### ######### ### # # ### # ######### #
#       #   # # # # #   #     #   #   #   #   #   #   # #     # #     #   #   #       #                     # # # # # #         # #
########### # # # # # ######### # # # # ### ####### ####### ### # ##### ### # # ######### ################# # # # # # ######### # #
# #         # # # # #           #   # #   # # #   #   #     #   # #     #   # # # #     #     #       #   # # # #   #       #     #
# # ### ##### # # # ################# ### # # # # ### # ##### # # # ####### ### # # ### ### ### ##### ### # # # # ####### # ##### #
# #   #   #   # # #     #     # #       # #   # #   # #     # # # #     #   #     #   # #   #   #   # #   # # #   #     # #     # #
# ### ### ### # # ##### ### # # # ##### # ##### ### # # ### # # # ##### # ### ##### ### # ### ### # # # ### # ##### ### # ##### ###
#   # # #   # # #   # #     # # # # #   #   #   #   # #   # # # #   # # #       #   #   # #   #   # # # #   #       # # #     #   #
# ### # ### # # ### # ####### # # # # ##### # ### # # ### # # ##### # # ######### ### ##### ### ### # # # ########### # ######### #
# #   #   # #     # #     #     # #   #   # #   # # #   # # #       # #     #     # #     #   #   #   # # #             #         #
# # ### # # ### ### # ### # ##### # ### # # ### # ##### ### ######### ##### # ##### ##### ### ### ##### # # ############# ####### #
# #     # #   # #   #   # # #   # #     # #   # #     #   #               #   #         #   #   #     # # # #           #     #   #
# ####### ### ### ####### # # # # ####### # ### ##### ### ##### # ####### ##### ### ##### ### ##### # # # # ### ####### ##### # ###
#       #   #   #       #   # # # #       #     # #     #     # #       # #   #   # #   #     #   # # # # #   #   #   # #   # # # #
# ######### ### ####### ### # # # # ##### ####### # ######### ######### # # # ### ### # ####### # ### # # ### ### # ### # # # # # #
#   #     # # #       #   # # # # # #   #         # #     #   #         #   #   #     #       # #     #   # #     # #   # #   # # #
# # # # ### # # ##### ### ### # # ### # ##### ##### # # ### ### ############### ### ### # ##### ####### ### ####### # ### ##### # #
# #   #   # # #     #   # #   # # #   # #     #   #   # #   #     #       #   #   # #   # #     #   #               # #   #   # # #
####### # # # ##### ##### # ### # # ### ####### # ##### # ### ### ##### # # # ### ### ### # ##### # # ####### ####### # ##### # # #
#     # # # #     #   #   # #   #   #   #       #       # #     # #   # #   #   #   # #   #     # # # #     # #       #     #   # #
# ### ### # # ### ### # ### # ####### ### ##### ####### # ##### # # # ### ##### ### # # ####### # ### # ### ### ########### # ### #
#   #   # # # #     # # #   # #     # #   #     #   #   # #   # #   #   # #       # # # #   #   # #   #   #     #         # #   # #
# # ### # # ### ##### # ### # ### # # # # ##### # # ### # # # ######### ### ####### # # # ### ### # ##### ########### ### # ### # #
# # #   # #   # #     #     #   # #   # # #   # # #   # # # #         #   # #     #   # #   # #     #   #           # #     # # # #
# # ### # ### # # ############# # # ### # # # ### ### ### # ######### ### # # ### ##### ### # # ##### ############# # ####### # # #
# #   #   #   # #             # # # #   # # #   #   #     #       # #   # #     # #         # # #     #           # #       #   # #
##### ### # ### ####### # ##### # ### ##### ### ### ############# # ### # # ##### # ######### # # ##### # ####### # ####### # ### #
#     #   # #       #   # #     #   #     #   #   # #           # #   #   #   #   # # #       #   #   # #   #   # #         #     #
# ######### # # ### # ### # ####### ##### # ### ### # ##### ### # # ####### ### ### # # ######### # # # ### ### # ############### #
#         # # # #   # #   #   #         #   #   #   # #     # # # # #       #   #   # # #         # #   # #   #   #   #           #
# ####### # ### ##### ####### # ####### ##### # # ##### ##### # # # # ####### # # ### # ########### ##### ### # ##### # ###########
#   # #   # #   #     #     #   #   #       # # # #     #     #   # #   #   # # #   # #       #     #     # # #       # #         #
### # # # # # ### ### # ### ##### ### ####### # # ### ### ######### ### # # # # ### # ####### # ##### ### # # # ##### # ### # ### #
#   # # # #   #   #   #   #     #     # #     # #     # #       #     # # #   #   # #       #   #       #   # # #   # #   # # #   #
# ### # # # ### ######### # ### # ##### # ############# # ### ### ### # # ######### # ################# ### # ### # ##### ### #####
# #   # # # #   #     #   #   # # #     #     #     #     # # #   #   # # #   #   # #           #       # # #   # # #   #   #     #
# # # # ### # ### ### # ##### ### ### # ##### # # ### ##### # # ### ### # # # # # # ######### # # ####### # ### # # # # ### ##### #
#   # #     #       #       #         #     #   #           #     #     #   #   #             #   #           #   #   #           #
###################################################################################################################################
