#####################################################################################################
#   #                   #         #           #           #         #       #     # #         #     #
### ##### ####### # ### ##### ### # ######### ####### ##### # ##### ##### # # ### # # # ##### # ### #
# #     # #     # #   #       #     #     #   #     #     # #     #       # # # # #   #   #   #   # #
# ##### # # ### ##### ### ########### ##### ### ### ##### # ##### ######### # # # ####### # ####### #
#   # # # # # # #     #   #     #   # #     #   # #   #   # #   #   #     #   # #         #   #   # #
# # # # ### # # # ######### ### # # # # ##### ### ### # # # ### ### # # ####### ############# # # # #
# #   #     #   #       #   #   # #   #   #   #         # #     #   # #     #       #       #   # # #
# ########### ### ##### # ### ### ####### # # ################# # ##### # # # ### # # # ### ##### # #
# #         # # # #   #     # #         # # #   #       #       #     # # # # # # # # #   #   # #   #
# # ####### # # # # ####### # ######### # ##### # ##### # ########### ### ### # # # ##### ### # ### #
#   # #     # # # # #     # #         # #   #   # #   # # #   #   # #   #   # # # #   #   # #   # # #
# ### # ##### # # # # ### ########### # ### # ### # # # # # # # # # ### ### # # # ### # ### ### # # #
# #   # #     #     #   #           # #   # #   #   # # #   # # # #   #   #     #   #   #         # #
# ### # # ############# ########### # ### # ### ### ### ##### # # ### ### ####### # ####### ##### # #
#   # # # #   #         #         # #   # #       # #       #   #   #   #   #   # #   #   # #   # # #
### # # # # # # ######### ######### # # # ### ##### # ##### ####### ### ### # # ##### # # # # # ### #
#   # # # # #   # #                 # # #   # #   # #   #   #   #   #   #   # # #   # # # # # #     #
# ### # # # ##### # ################# # ### # # # # ### ##### # # ### ### ### # # # # # # ### #######
#     # #   #     # #       #       # #   # # # #   #   #     # # #   #   #   #   # #   #     #     #
####### ##### ##### # ##### # ### # ##### # # # ##### # # ##### # ### # # # ####### ######### ### ###
#       #   #       # # #   #   # #       #   # # #   # #   #   # #   # # # #     # #   #   #   #   #
# ####### # # ####### # # ##### # ### ######### # # # ##### # ### # ### ### # ##### # # # # ### ### #
# #   #   # # #   #   # #   # # # #   #     #   # # # #   # #       #   #     #     # #   #   #     #
# # # # ### # # # # ### ### # # # # ### ### # ### # ### # # ######### # # ##### # ### ####### ##### #
# # #   # # #   #   #     # #   # #   #   #   #   #     # # #         # #   #   # #   #       #     #
# # ##### # ######### ##### # ### ####### ##### # ####### # # ##### ####### # ##### ### ####### #####
#   #     #     #   #       #   #     #         #   #   #   # #   # #       #       #   #     # #   #
# ### ### ##### # # # ######### ##### # ########### ### ##### # # ### ############### ### ### # # ###
# #     #     # # #   #   #         #   #         # #       #   #   # #       #     #       # # #   #
# ####### ##### # ##### # # ############# ####### # # ########### # # ##### ### ### ######### # ### #
#   #   #     #   #     # # #   #         # #     #   #   #     # # # #     #   #   # #       # #   #
### # # ### # ##### # ##### ### # ######### # ##### ### # # ### # # # # ##### ### # # # ####### # # #
# #   #   # #   #   # #     #   # #         #   #   #   #   # # # # # #     # #   #   #     #   # # #
# ####### ##### # ### # ##### # # ### ##### ### ##### ####### # ### # ### # # # ########### ### # # #
#       #     #   #   # # #   # #   # #       #       #       #   # #   # #   #           #   # # # #
####### ##### ### # # # # # # # ### ### ################### # ### # ### ##### ######### # ### # # # #
#     #     #   # # # # #   # #   #   # #           #       # #   #   #     #     #     #   # # # # #
# ### ### # ### ### # # ##### ####### # # ##### ### ### ### ### ##### ##### ##### # ######### # # # #
# #       #   # #   # # #   # #       #   #   # #     # #   #   #   #     # #     #   #   #   #   # #
# ##### ####### # ##### # # # # ####### ### # # ##### # # ### ### # # # # # ######### # # # ####### #
#   # # #   #   # #       # # # #     # #   # #   # #   # #   #   # # # # #   #     #   # #   #     #
# # # # # # # ### # ####### # # ### ### # ####### # ##### # ##### # # # ##### # ### ### # ### #######
# # #   # #   #     #     #   #   #       #     # #       # #     # # #     # #   #   # #   #       #
# # ##### ########### ### ####### # ####### ### # # ####### ### ### # ##### # # # ### ### # ####### #
# # #   # #           # #   #     # # #     #   # # #   #   #   #   # #   #   # # # # #   # #       #
# # # # # # ########### ### # ##### # # ##### ### # ### # ### ### ### # ######### # # # ##### ##### #
# #   #   #     #           #     #   #   # #     # #   #     # # # # #           #     #   # #   # #
# ######### ### ##### ########### ####### # ####### # # ####### # # # ######### ######### # # # # # #
# #   #       #     # #     #     #   #   #       #   # #         # #           #       # #   # #   #
# # # # ########### # # ### # ##### # # ### ### ####### # ######### ########### # ##### # ##### #####
# # #   #   #       # # # #   # #   # #   #   #       # # #                     # #   #   #   # #   #
# ##### # ### ####### # # ##### # # # ### ### ### ##### # ######### ############# # # ##### # # ### #
#     # #   #   #   #   # #       # #   #   #   #     # #   #     #     #         # #     # #   #   #
##### # ### ### # # ##### # ####### ### ### ### ##### # ### # ### ### ### ######### ####### ##### # #
#   # #   #   #   #     #     #   #   #   # # # #   #   # #   # #   # #   #   #     #     #   #   # #
# ### ### ### ####### # ##### # # ### ### # # # ### ##### ##### ### ### ##### # # # # ### ### ### # #
#     # #   #   #   # # #   # # #   # # # # #     #           #   #   #     #   # # #   #   # #   # #
# ##### ### # # # # ### # # # # ### # # # # ##### ######### # # ##### ##### ##### ##### ### # # ### #
#     #     # # # #   # # # # #   #   # # #   # #           # # #   #   #   #   #         #   #   # #
##### ### ##### # ### # # # # ### ##### # ### # ############# # # # ### # ### # ########### ##### ###
#   #   #       # #   #   # #   # #           #           #   # # #     #     #     #     #     #   #
# ##### ####### # # ####### ### # ### ######### ### ####### ### # ####### ######### # ### ##### ### #
#     # #   #   # # #       # # #   #   #     #   # #       #   #   #   #   #     # #   #     #     #
# ### # # ### ### # ### ##### # ### # ### ### ### # # ####### ##### # ##### # ##### ### ##### ##### #
#   #   #   # #   # #   #   #   # # # #   # # #   # #   #     #   # # #     #   #     #     #   # # #
### ####### # # ### # ### # # ### # # # ### # ### # ### # # ### # # # # ####### # ### ##### ### # # #
#   #       # #   # #   # # # #   # # # #   #   # #     # # #   # # # # #       #   # #     #   # # #
# ##### # # # ### # ### # # # ### # ### # ##### ####### ### # ### # # # ##### # ### ### ##### ### # #
# #   # # # # # # # #   # #       #       #     #     #     # # #   # # #   # #   #     #   # #   # #
# # # # # ### # # # # ### ########### ##### ##### ### ##### # # ##### # # # # ### ######### # # ### #
#   # # #       # # # #   #   #     # #     #   # # # #     # #   #       # # # #     #     # #     #
##### # ######### # # # ### # # ### # # ### # # # # # ####### # ### ####### # # ##### # ### # ### ###
#     #   #     # #   # #   #   # # # #   # # #     #     #   #     # #   #   #       # #   #   #   #
# ######### ### # ##### # ####### # # ### ### ####### ### # ####### # # # ##### ####### ####### #####
# #         #     #     # #       # #   # #   # #   #   # # #     #   # # # #   #       #     #     #
# ### # ################# # ####### ##### # ### # # ##### # # ### ##### # # # ####### ### ### ##### #
#   # #     #   #         #       # #   #   #   # #       #   # #       # #           #   #   #   # #
### # ##### # # # ############### # # # ### # # # ############# ######### ########### # ### ### # # #
# # # #     # # #       #       # #   #   #   # #     #             #   #   #     #   # #       #   #
# # ### ##### # ##### # # ##### # ####### ########### # ##### ##### ### ### ### # # ### ########### #
# # #   #     #     # #       # #         #         # #   # # #   # #     #   # # # # #     #     # #
# # # ### ######### ########### ##### ##### ####### # ### # # # ### # ####### # ### # ##### ##### # #
#   #       #   # #           #     #       #     # # #   # # #       #       #       #     #   # # #
# ######### # # # ########### ##### ######### # ### # # ### # ##### ### ####### ####### # ### # # # #
# #     #   # #   #     #     #     #     #   # #   # # #   #     # #   #       #   #   # #   # #   #
# ### # ### # ### # ##### ##### ######### # ### # ### # ### ##### # # ### ####### # # ##### ### # ###
#     #   #   #     #     #         #     # #   #     #   #     # # # #         # # #       #   #   #
######### # ######### ##### ####### # ### # # ### ####### # ### # ### # ####### # # ######### ##### #
#     #   # #     #   #   # #   #   # # # # #     #       # #   # #   # #     #   #   #     #     # #
# ### # ##### ### # ##### # # ### ### # # # ####### ####### # ### # ### # ### ####### ### # ##### ###
# #   # #     # #   #     # # #   #   #   #     #   #       # # # #   # #   #     #       # #   #   #
# # # # # ##### ##### # ### # # ### ####### ##### ### ####### # # ### ##### ##### ######### # ##### #
# # # #   # #         # #   # #   #         #     #   #     # # #   #     #     #       #     #     #
### ####### # ####### ### ### ### ##### ##### ##### # ### ### # ### ##### # ### ####### # ##### ### #
#   #       #     # #   # #     #     # #   #   #   # #   #   #   #       #   #   #     # #     #   #
# ### # # ####### # ### # # # # ##### # ### ### # ### # ### ##### ########### ### # ####### ##### ###
# #   # # #   #   #   #   # # # #     #     #   # #   #     #   #       #     #   # #     # #   # # #
# # ### ### # # ### # ####### # # ########### ##### ### ##### # # ##### ####### ### # ### # # # # # #
#     #     #       #         # #                   #         #   #             #     #     # #     #
#####################################################################################################
