#######################################################################
#   #             #       #     #   #     #       #     #     #       #
### # ### ####### # ##### # ### # # # ### # ### ### # ### # # # # #####
# # # # # #     # #   # #   #   # #   # #     #     # #   # # # #     #
# # # # # # ### # ### # ##### ### ##### ########### # # ### # ### ### #
#   # # # # # # # #     #   #   #     #     #     # # # # # #   #   # #
# ### # # # # # # # ##### # # # ##### # ### # ### ### # # # ### ##### #
#   #   #     # # # #   # # # #     #   #   #   #   #     # # #       #
### ########### # ### # # # # # ######### ##### ### ####### # ####### #
# #             #     #   # # # #     #   #     # #     #   #       # #
# ######################### ### # ### # ### ##### ##### # ##### ##### #
#     #       #   #       #   #     # #   # #   #       # #     #   # #
# ### # ### # # # ### ### ### ##### # # ### # # # ####### ### ### # # #
# #   # # # #   #   # # #   #     # #   #   # # #   #       # #   #   #
### # # # # ####### # # # ####### # ##### ### # ### ####### # # #######
#   # # # # #       # #   #       #   #   #   # # # #   #   # #   #   #
# ##### # # # ####### ### # ####### ### ### ### # # # # # ### ### # ###
# #       # #       #   # #     #   #   #   # #   #   #   #     # #   #
# # ####### ####### # # ####### # ### ##### # ### ######### ### # ### #
#     #     #     # # #     #   #   # #     # #   #     #   # # #   # #
# ##### ####### # # ##### # # ### ### # ##### # ### ### # # # # ### # #
# #     # #     # # #     # #   # #   #   #       #   #   # #   # #   #
# # ##### # # ### # # ######### ### ##### ####### ### ##### ### # ### #
# # #       # #   #   #   #   #   #     #       #   #     #   #     # #
### # ####### ####### # # # # ### ##### ####### ######### ### ##### # #
#   #       #         # #   #   #       #     #       #   # #     # # #
# ############### ##### ##### # ######### ### ####### # ### ##### ### #
#               #   #   #   # #   #         #         #   #     #     #
# ############# ### # ### # # ##### ##### # ######### ### # ###########
#   # #         #   #   # # #       #   # # #     #   # # #           #
### # # ######### ##### # ########### # ### # # # # ### # ##### ##### #
#     # #   # #   #     # #         # #     # # # #   # #     # #   # #
# ##### # # # # ### ##### # ##### # # ######### ##### # ##### ### # # #
#   #   # # #   #   #     # #     # #       #   #   #     # #     #   #
### # ### # ##### ### ##### # ############# # ### # ##### # ######### #
#   #   # #     #   #     # #             # #     #       #   #       #
# ##### # ##### ### ##### # ########### # # # ############### # #######
#     # #     #   #     #   #   #       # # #         #     # #     # #
# ##### ##### # ####### # ### # # ####### # ######### # ### # ##### # #
# #     # #   #         #   # #   #       # #       # #   #   # #   # #
### ### # # ############# ### ### ######### ### ### # ### ### # # ### #
#   #     # #     # #     #   #   #       #   # #   #     # # # #     #
# ### ##### # # # # # ##### # ##### ##### ### # ########### # # ##### #
# #     #   # # #   #     # # #     #   #   # #       #       #   #   #
# ####### ##### ### ##### # ### ##### # # ### # ### ### ######### # ###
#       # #     #   #     #   #   # # # # #   #   #               #   #
# ##### # # ### ##### ####### ### # # # # # ##### ############### ### #
# #   # # #   # #   # # #   #   #   # #   #   # # #             #   # #
# # # # # ### ### # # # # # # # ### # ####### # # # ########### ##### #
# # #   #   # #   #     # # # # #   #   #     #   #   #       # #   # #
# # ####### # # ######### # # ### ##### # ##### ##### # ### ### # # # #
# # #       # #     #     # # #   #   # # #         # # #   #   # #   #
### # ####### # ##### ##### # # ### # # # ########### ### ### # # #####
#   #       #   #   #   # # #     # #   #   #         #   #   # # #   #
# ######### ##### # ### # # ##### # ### ### # ######### ### ##### # # #
#       #   #   # #     # #   #   # # #   #   #         #   #     # # #
# ### # # ### # # ####### ### ##### # ### ##### ######### ### ##### # #
#   # # # #   # # #         #       #   #       #       #   # #     # #
### # # # # ### # ####### ########### ### ####### ##### # # # # #######
#   # # #   #   # #     #   #         #   #       #   # # # # #       #
# ### # ##### ### # ### ### # ####### # ### ######### # ### # # ##### #
#   # #   #   #   # #       # # #     # # #   #     # # #   # #     # #
# ### ### # ##### # ####### # # # ### # # ### # ### # # # ### ##### # #
# #   #   # #     #       # # # #   # #   # #   # # #   #   #     # # #
### ### ### # ##### ##### ### # ### # ### # ##### # # ##### ##### # # #
#   #     #   #   # #   #   #     # #   # #   #   # #         #   # # #
# ############# # # # # ### ### ### ##### # # # # # # ####### # ##### #
# #     #       #   # #   #   # #   #   #   #   # # # #   #   #     # #
# # ### # ############### ### # # ### # ######### # ### # ######### # #
#     #                     #   #     #           #     #             #
#######################################################################
