#################################################################################
# #     #             # #               #           #                 #         #
# # ### # ### ####### # # ######### ### ### # ### ### ############# # ### # ### #
# #   # # # #     # # #         #   # #   # #   # #   #       #     #   # # # # #
# ### # # # ##### # # ##### ##### ### ### ### # # # ### # ### # ####### ### # # #
#     # #   #   # #   #   # #     #     #   # # # # #   # # # # #     #     # # #
####### ### ### # # ### # ### ######### ### ### # # ##### # # # ### # ####### # #
#       #       # #     # #   # #         #   # # #       #   # #   # #       # #
# ####### ####### ####### # ### # # ######### # ####### ####### # ##### # ##### #
# #   #   #   #   #   #     #     # #         #         #       # #     # #   # #
# ### # ### # # ### # ############# # ######### ######### ####### # ##### # # # #
#   #     # #   #   #   #       #   # #             #   # #   #         #   # # #
### # ##### ##### ##### # ##### # # # ############# # # # ### # ####### ##### # #
#   # #   #     # #   # #     # # # #     #   #   # # # #   # #   #   #   #   # #
# ### # # # ### # # # # ##### # # # ##### # # # # # # # ### # # ### # ##### ### #
# # # # # #   # #   # #   #   # # #   # # # # # #   # # # # #   #   #     #     #
# # # # # ##### ##### ### # ### # ### # # # # # ##### # # # ##### ####### ##### #
# #   # #     # #       #   #   #   #   #   # #   #   #   #           # #     # #
# ##### ##### # # ########### ##### ### ##### ### ### ### ########### # ##### # #
# #     # #   #     #   #     #     #   #   #   #   # # #     # #   #     #   # #
# # ##### # ##### ### # # ##### ##### ### # ### ### # # ##### # # # ##### # ### #
# # #     #     # #   #   #     #     #   #   #   # # #     #   # #     # # #   #
# # # ######### ### ####### ##### ##### ### ##### # # # ### ### # ##### ### ### #
# # # #       # #   #     #   # #     # #   #     #   # # #     #   # #   #   # #
# # # # # ##### # ##### # ### # ##### # # # # ######### # ######### # ### ### # #
#   #   #     #   #     #     #     # # # # # #   #     #       #   #   # #   # #
##### ####### ####### ######### ### # ### ### # # # ##### ##### # ##### # # ### #
#   #   #   #       #   #     #   # # #   #   # #   #     #     #   #   # # #   #
# # ### # # # ##### ### # # ### # ### # # # ### ####### # ######### # ### # #####
# #   # # # # #   #     # #     #       # # # # #     # #   #       #     #     #
# ### # ### # # # ##################### ### # # ### # ##### # # ##### ######### #
# #   # #   #   #   #     #         # # #   # # #   #       # # #   #         # #
# ### # # # ####### # ### # ####### # # # ### # # ######### # # # # ######### # #
#   # #   #   #   #   # #   # #     #   # #       #   #     # # # # #     # #   #
### ######### # # ##### ##### # ### ##### ### ##### # ####### # # # # ### # ### #
#   #         # #   # #       #   # #   #   # #     #     #   # # #     # # #   #
# ### ######### ### # # # ####### ### # ### ### ######### # ### # ####### # # ###
#   # #   #     # #   # # #     #     #   #   #   #   #   #   # # #       #   # #
# # # # ### ### # ### # # # ### ####### # ### # # # ### ##### ### # ####### ### #
# #   # #   #   #     # #   #         # # # # # # #     #     #   # #     #     #
# ##### # ### ######### ##### ####### # # # # ### # ##### # ### ### # # ####### #
#     # # # # #   #   # #   #   #     # #   #     #     # #     #   # # #       #
##### # # # # # # # # # # # ### ####### # ############# # ####### ### ### #######
# #   #   # # # #   # # # #   # #   #   # #   #       # #   #   # #       #     #
# # ##### # # # ##### # # ### # # # # ##### # # ##### # ### # ### # ####### ### #
# #     #   #   #   #   #   # #   # # #     #   #   #   #     #   #   #   # # # #
# ##### ### ####### ##### # # ##### # # ######### # ########### ##### # # # # # #
#   # # #         #   #   # #     # #   #   #   # #             #   # # # # #   #
# # # # ######### # # ### # ####### ##### ### # # ##### ######### # # # # # #####
# #   #       # # # #   # # #     #     #   # #   #   # #   #     # #   # #     #
# ### ####### # # # ### ### # ### # ### ### # ####### # # # # # ######### ##### #
#   # #   #   # #   # #     #   #   #   #   # #   #   # # # # #       #   #     #
# # # # ### ### ##### ##### ### ##### ### # # # # # # # # # # ##### ### ### #####
# # #   #   #   #         #   # #   # #   # # # #   # #   # # #   #     #   #   #
# # ### # ##### # ####### # ### # # # # ### # # ######### # # # ######### ### # #
# #   # #     #   # #   #   #   # #   # #   #   #       # # # #         #     # #
##### # ##### # ### # # ##### ### ##### # ##### # ##### ### # ####### # ####### #
#     # #     # #   # #     # # # #     # #     # #   #   # #     #   #   #     #
# ##### # ##### ### # ##### # # # # # ##### ##### # ##### # ##### # ##### # ### #
#   # # #   #       # # #   # #   # #     # #   # #       # #   #   #   # # # # #
# # # # ### # ####### # # ### # ### ##### # # # # ### ##### # # ####### # # # # #
# # #     # # #       #   #   # #       #   # # #   #       # #   #     #   # # #
# # ####### # # ####### ### ### ####### ####### ### ######### ### # # ####### # #
# #         # # #   #   #   # #     #   #         #   # #       # # #       # # #
# ############# ### # ##### # ##### # ### ####### ### # # ####### # ### ### # # #
# #       #     #   #       #   #   #     #       #   #   #     # #   #   # # # #
# # ##### # # ### # ######### # # ################# ### ### ### # ### ### # # # #
# #   # # # #   # #           # # #     #     #   # #   #   # # #   # #   #   # #
# ### # # # ### # ### ######### # ### # # ### # # # # ### ### # ### # # ####### #
#     #   #   # #   # #     #   #     # # # #   # # # #   #   #     # #         #
####### ##### # # # # # ### ########### # # ##### # ### ### ####### # ###########
#     # #     # # # # # # #         #   # #     # #   #   #         # #         #
# # # # ####### # # ### # ##### ### # ### ##### # ### ### # ######### ### ##### #
# # # # #       # # #   #     # #   #   # #     #   # #   #     #   #   # # #   #
# # ### # ######### # ####### # # ##### # # ### ### # # ####### ### ### # # # ###
# # #   #         #   #       # #   #   # #   #   #   # #           # # # # # # #
# # # ####### ### # ### ####### ##### ### ### ### ##### ##### ##### # # # # # # #
# # # #     #   # # #         # #     #     # #         #   # #   #   #   # #   #
# # # # ### ##### # ######### # # ######### # ########### # ### # ######### ### #
# #     #         #           #             #             #     #               #
#################################################################################
