#############################################################################################################################################
#   #             #             # #       #     #         #     #       #         #     #           #   #                   #     #         #
### ########### # # ##### ##### # # # ##### # # ##### ### ### # ##### # # ####### ### # # ####### # # # # ######### ####### # ##### ####### #
# #     #       # #   #   #     #   #     # # #   #   # #     #   #   # #     #       # #   #   # #   #   #     # #   #     #   #   #   #   #
# ##### # ####### ##### ### ######### ### # # ### # ### ######### # ### ##### ########### ### # ### ####### ### # ### ### ##### # ##### # ###
#     # # #     #     # # # #   #   # # #   #   #   #   #         # #       #   #         #   #   #         # # #   #   # #   #   #     #   #
# ##### # # ### ##### # # # # # # # # # ####### ##### # # ######### # ##### ### # ######### ##### ########### # ### ### # # # ### ### # ### #
#   #   # #   # # #   # # #   #   # #     #     #     #   #   # #   # #   #   #   #       #   # # #   #   #         # # #   #   # #   #   # #
### # ### ### # # # ### # ######### ##### # ##### ######### # # # # ### # ### # ### ##### ### # # # # # # ######### # # ####### # # # ##### #
#   #   # #   #   #     #     #   # # #   # #   # #       # # #   #   # #   # #     #   #   # #     #   #   #   #     # #       # # # #     #
# # ### # # ############# # # # # # # # ### # ### # ### # # # ####### # ### # ####### # ### # ############# # # ##### # # ####### # ### ### #
# #   #   # #             # #   # # #   #   #     # #   #   #       #     # #   #     # #   #         #   #   #   #   # #   #   #   #   #   #
# ### ##### # ############# ##### # ##### ### ##### # ############# ####### ### # ### ### ########### # # ####### # ### ### # ### ### ### ###
#   #       #   #           # #   #       # # #     # #           #       #   # #   #   #     #   #   # #       # #   # # # #     #   #   # #
# # ########### # ########### # ########### # # ##### ####### ### ####### ### # ### ### ##### # ### ### ##### # # ##### # # # ##### ### ### #
# #   #       # #     #   # #   # #           #     #   #   #   #   #   #     # #   #       #   #   #   # #   # #       #   #     #   #     #
# ### # ##### # ##### # # # # ### # ################### # # # # ##### # ####### # ### ### ### ### ### ### # ############# ####### ### ##### #
#   #       #     #   # # #   #   #     #               # # # #   #   #       # #   #   # #   #   # # #   # #       #     #     #   # # #   #
# ######### ####### ### # # ### # ##### # ##### ####### # # ##### # ### ##### # # ##### ### ### ### # ### # # ### # # ##### ### ##### # # ###
# #   #   #     #   #   # #     # #   # #   # #   #     # #     #     #     # # # #   # #   # #   # #     # #   # # # #     # # #     #   # #
# # # # # # ##### ### ### ######### # # ### # ### ##### # ##### # ######### # # ### # # # ### ### # ##### # ### # ### ##### # # # ##### ### #
# # #   # # #   #     # #       #   #   # #   # #     # # #   # # #     #   # #   # # # #     #   #   #   #     #   #   #   # #   #   #     #
# # ##### ### # ##### # ####### # ####### ### # ##### ### ### # # # ### # # ##### # # # # ##### ### ### ######### # ### # ### ####### ##### #
# #   # #     # #   #         # #   #     #   # #   #         # # # # # # # #     # # #   #     #     # #   #   # #   # # #   #         #   #
##### # ####### # # ########### ### # # ### ### # # ########### # # # # # ### ##### # # ### ##### ### # # # # # ### # # # # # ##### ##### ###
#     #       #   #       #     # # # #   #   #   #   #     #   # # # #   #   #     # # # #   # # # #   # # # #   # # #   # #       #     # #
# ##### # ############### # ### # # ##### ### # ### ### ### # ##### # ### # ### ##### # # ### # # # ##### # # ### ### ##### ######### ##### #
#     # # #     #         # # #   # #       # # #   #   # # #     # #   # # # #   #   # # #   # #       # # # # # #     #   #   #   # #     #
# ### # ### ### # ######### # # ### # ####### ### ### ### # ##### # ### # # # # # ### # # # ### # ####### # # # # # ### # # # # # # # # ### #
# #   #       #             #   #   # #     #   # #   #   #       #   #   # #   #   # #   #   #   #     # #   #     #   # #   #   #   # # # #
### ################### ####### # ### # ### ### # # ### ############# # ### ### ### # ### ### ### # ### # ##### ####### # ############# # # #
#   #     #       # #   #     # # # #   # #     # # #   #             #   #   # # # #   #   #   # # #     #     #     # # # #         # #   #
# # # ### # ##### # # ### ### ### # # ### ####### # ### # ### ########### ### # # # ### ####### ### ####### ##### ### ### # # ### ### # ### #
# # # # #     #   # # #   # #     # #       #     # #   # #   #       #     # #   # # #       #   #       #   #   #   #   # #   #   # #   # #
# ### # ####### ### # # ### ####### ####### ### ### # ### # # # ##### ####### ##### # ####### ### ####### ##### ### ### ### ### ### # ### # #
#   #   #       #     # #       #           #   #   #     # # #   # #       #   #   #   #   #   #       # #     #   #   #     # #   #     # #
### ### # ##### ##### # # ### # ####### ##### ### ######### # ### # ####### ### # ### # ### ### ####### # # ##### # # ####### # # ######### #
#     # #     # #   # # #   # # #     # #     #   #         # # #     #   #   #   #   #       #     #   # # #   # # # #     # # #     #   # #
# # ### ##### ### # # # ##### # # ### # # ##### ### ######### # ##### # ##### ##### ######### ##### # ### # # # # ### # ### # # ##### # # # #
# # #   #   #   # # # #   #   #   #   #   #   # #       # #   #   #     #   # #     #     #   #   #   #     # # #   # # #   #       # # #   #
# # # ##### ### # # # ### # ####### ### ### # # ####### # # ##### # ##### # # # # ##### # # ### ####### ##### ##### # # # ########### ### ###
# # #   #   # # # # # # #   #     # # # #   # #   #     # #       # #     # #   #   #   # #   #     # #     #     # #   #     #     #   # # #
# ##### # # # # # # # # ####### # # # # # ### ### # ##### ####### # # ##### ####### # ### ### # # # # ##### ### ### ######### # ### ### # # #
#   #   # #   #   # #           # # # # # # # #   #   #       #   # # #   #   #     # # #   # # # #       #     #   #       #   # #     # # #
### # ### ### ##### ########### ### # # # # # # ##### # ##### # ### # # # ### # ##### # # ### # # ########### ### # ### ### ##### ####### # #
#   # #   #   #   # #         # #   #   # # #   #   # #     #   #   #   #   #   #   # # # #   # # #           #   # #   #   #           # # #
# ### # ### ##### # # ####### # # ####### # ##### # # ##### ##### ######### ##### # # # # # ##### # ########### ### # ### ### # ######### # #
#     #   #       #   #       # # #       #       # #     #     # #     # #   #   #   #   #     #             # # # # #   #   # #         # #
# ####### ####### ##### ####### # # # ##### ##### # ##### ####### # # # # ### # ####### ####### ######### ##### # # # # ### ### # ######### #
#         #       #     #   #   # # # #     #     # #   #       # # # #     # #   #       #   #   #     # #     # #   # #     # #           #
########### ####### ##### # # ### ### # ##### ##### # # ####### # ### ##### # # # ####### # ##### # ### ### ##### ##### # ### ############# #
#     #     #       #     # #   #     # #   #     # # #         #     # #   # # #     #   # #   #   #   #   #           #   # #             #
# ##### ##### ####### # ### ### ####### # ####### # # ### ############# # ### ####### ### # # # ##### ### ######### ######### # #############
#       #   # # #   # # #   #   #     # #       # # #   # #           #   # #       #   # # # #   #   #     #     #   #       #       #     #
# ####### # # # # # # # # ### ### ### # ### ### # # ### # # ### ##### # ### ####### ### # # # ### # ####### # ### ### # ### ######### ### # #
# #   #   #   #   #   # # #   #     # #   # #   # #     # #   #   # # #     #     #   # #   #   #   #     #   # #   #   # # #       #   # # #
# # ### ####### ####### # # ######### ### ### # # ########### ### # # ##### # ### ### # ### ### ####### # # ### ### ##### # # # ### ### ### #
# #   # #     #   #   # # # #         # #     # #             #   #   #       #     # # #   # # #       # # #     # #       # #   # #   #   #
# ### # ### ##### ### # ### ### ##### # ####### ############### ### ### ######### ### # # ### # # ### ### # ### # # ##### ### ### # # ### # #
#   # #   # #   #   # #     #   #   # #       # #           #   # # #   #   #   # #   # #     # # #   #   #     # # #   #   # #   # #     # #
### # ### # # # ### # ####### ### # # ####### # ### ### ### # ### # # ### # # # ### ### # ##### # # ##### ######### # # # ### # ########### #
# # # #   #   #     #         #   # #         #   #   # #   #   #   # #   # # #     #   # #     # # #   #     #     # # # #   #       #     #
# # # # ########### ##### # ##### ########### ### ##### # ##### ##### # ### # ####### # ### ##### # # # ##### # ##### # ### ####### ### #####
#   # #     #     # #   # # #     #         #   #     # #   # #       #   # # # #   # #   # #   # #   # #       #     #     #     # #   #   #
# ### ##### # ### # # # ### # # ### # ######### ##### # ### # ########### # # # # # # ### # # # ####### # ####### ########### # # # # ##### #
# #   #   # # #   #   #     # #     #       #   #   #   # # #     # #     #   #   #     #   # #         # #       #           # # #   #     #
# # # # # # # # ##### ##### ####### ####### # ##### ##### # # # # # # ######### ######### ### ########### # ################# # # ####### # #
# # #   # #   #   #   #   # #     # #     # #       #     # # # # # #   #       # #     # #         #   # # #               # # #   #   # # #
# # ####### ##### ##### # ### ### # ### # # ####### # # ### ### # # ### ##### ### # ### # ####### # # # # # ### # ######### # # ### # # # # #
#   #     # #   #   #   # #   # # #     # #       # # #   # #   #     #     #   # # # # #       # # # # # #   # #   #       # # # #   #   # #
### # ### ### # ### # ### # ### # ############### # # ### # # ##### ####### ### # # # # ####### ### ### # ### # ### # ######### # ######### #
# # # # #     #   # #   #   #   #   #   #     #   # # # #   # # #   #       #     # # #       #   #   #     # # #   #   #       #       #   #
# # # # ######### # ### ##### # ### # # # ### # ### # # ##### # # ### ####### ##### # ####### ### ### # ##### ### ##### # ######### # ### ###
#   # #               #   #   #   #   # # # # #     # #     # #     # #   # # #   #   #     #   #     # #     #   #   # # #   #     # #   # #
# ### # ################# # ##### ##### # # # ####### # ### # # ##### # # # # # # ### # # ##### # ####### ##### ### # # # # ### # ### # ### #
#   # #   #   #     #     # #       # # # # #         #   #   # #     # # # # # #   # # # #   # # #     #   #       # #   # #   #   # #     #
##### ### ### # ### # ##### # ##### # # # # ########### # ####### ##### # # # # # # # ### # # # ### ### ### # ####### ##### # ##### # ##### #
#     # # #   #   #   #   # #     #   #   #         #   #       #       # #   # # # #     # #   #   # #   # # #     #     #   #     #   # # #
# ##### # # ##### ##### ### ##### ### ######### ### # ######### ######### ##### # ####### # ### # ### ### # # # ######### ##### ####### # # #
# #     # #     # # #   #     #   # # #       #   # #         #     #   #     # # #       # # # #   #   #   # #         #   #   #         # #
# ##### # ### ### # # # # ##### ### # ### ### ### # ####### ### ##### # ##### # # # ####### # # ### ### ##### # ### # ##### # ####### ##### #
# #     #   # #   # # #   #     #   # #   # # #   # #   #   #   #   # #       # #     #     # #   #       # # # #   # #     #       # #     #
# # ####### # # ### # ##### ##### # # # ### # # ### # # ##### ### # # # ####### ####### ##### ### ####### # # ### # ### ########### ### #####
# #     #     # #     # #   #     #     #   # # # #   #       #   #   # #   #   # #     #       # #     # # #     # #   #         #   # #   #
# ### # # ##### # ##### # ### ########### # # # # ######### ### # ##### # # # ### # ### ####### # ### ### # ##### ### ### ####### ### # ### #
#   # # # # #   # #     # #       #   #   # # # #           #   # #   # # # #     # #   #     #       #   #     # #   #   # #     #   # #   #
# # ### # # # ### ##### # # ####### # ##### # # # ########### ### # # # # # ### ### # ### ### ####### # ####### # # ### ### # ##### # # # # #
# #   # #   #   #     # # # #       #   #   # # #   #     #   # # # # # # # #   #   #   # # #     #   #       # # #     #   #     # # # # # #
# ### # ### ### ##### # # ### ######### # ### # ### # # ### ### # # # ### # # ### ####### # ##### ########### # # ######### ##### # # # # ###
#   # # #   # # #   # # #   # # #     # #   # # #     # #   #     # #     #     # #       #     #   #   #     # #     #         # # # # #   #
##### # # ### # # # # # ### # # # ### # ### # # ######### ####### # ############# # ####### ####### # # # ##### ##### ### ### ### # ### ### #
#     #       # # # #     # # # # # # #   #   #         #       # #   #           # #   #   #     #   # #   #       #   # # # #   #         #
# ########### # # ####### # # # # # # ### # ### ####### ####### # ### # ### ####### # # # # # # # ##### ### # ######### # # # # # ######### #
#         #   # #   #     #   # # # #   # # #       #     #   # #   # # #   #       # # # #   # #   # #     #     #     # #   # # #   #     #
# ####### # ### # # # ######### # # ### # # # ####### ### # # # ### # # # ### ####### ### ##### ### # ####### ### # ##### ##### # # # ##### #
#     #   # # # # # #       #   # #       # #   #   #   #   # #   # # # # # #   #   # #     #   #     #     # # # # #     #     # # #     # #
##### # ### # # ### ####### # # # ######### ### # # ### ##### ### ### # # # ### # # # # ##### ### ##### # # # # # # # # ### ####### ##### ###
#     #   #   #   # #   #   # # #   #     #   # # # #   #   #   #     # # #   # # # #   #   #   # #     # # #   #     # #   #   #   #   #   #
######### ####### # # # # ##### ### # ### ### # # # # ##### ### ####### # # # # # # ##### # ### ### ##### ##### ######### ### # # ### ##### #
#         #   #   # # #   #   #   #     # #   # # #   #     # #   # #   #   # #   #     # #   #     #   #     # #         #   #   #   #     #
# ####### # # # ### # ##### # # # ##### # ### ### ##### ### # ### # # ################# # ### ### ### ##### # # # ####### # ######### # ### #
#     #   # # # # #   #     # # # #   # #   #     #   #   # #   # # #                 #   # #   # #   #   # #   #     #   # #     #   #   # #
##### ##### # # # # ### ##### # ### # # ### ####### # # # # ### # # ############### # ##### ### # # # # # # ######### # ### # ### # ##### # #
#     #     #   #   #   #       #   # #   # #       # # # #     # #       # #       # #     #   #   # # # #         # #   #   # # # #   # # #
# ##### ######### ### # # ####### ### ### # # ### ##### # ####### # ##### # # ######### # # # ######### # # ######### ######### # # # # # ###
# #   # #     #   # # # #   # #   # #   # # #   #       #         #   #     #     #     # # #     #     # # #       # #           #   # #   #
# # # # ##### # ### # # ### # # ### ### ### ### ##################### ########### # ##### # ##### # ##### ### ##### # # ######### ### # ### #
#   # #     # #   # # #   # # # #           #   #   #         #       #     #     # #   # # #   # #     #     #     #   #       #   # # #   #
# ### ##### # ### # # ### # # # ##### ######### # # # ### ##### ### # # ### # ### # # # # ### # # ##### ####### ##### ### ##### ### ### # # #
# #       # #   # #   #   # # #     #   #     #   # #   # #     #   # # # #   #   # # # #     #   #   #   #   #     #   # #   #   #   # # # #
### ### ### # # # # ### ### # ##### ##### ### ##### ##### # ##### ##### # ##### ### # # ########### # ### # ####### # ### # # ### ### # # ###
#   #   #   # # # # #   # # #   # #   #     # #   #     # #   #   #     #   #   # # # #             #     #     #   # #   # #   #   #   #   #
# ### ### ### # # # # ### # # # # ### # ##### # # ##### # ### # ### ####### # ### # ### ################### # # # ##### ### ####### ### ### #
#   #   # #   # # # #   # #   # # #   #   #   # #     # # #   #   #   #     #     #     #         #       # # # #       #       #   #   #   #
### ##### # # ### ##### # ##### # # ##### # ### ### ### # # ##### ### # ######### ####### ### ##### ##### # # # ############### # ####### # #
#   #     # #   #       #     #   #       #   #   #   # #       #   # #     #     #       #   #     #   # # # #     #           # #   #   # #
# # # ##### ### ######### ####### ########### ### ### # ########### # ### # # ##### ####### # # ##### # # # # ####### # ### ##### # # # ### #
# # # #   # #   #       #       # #   #     #   # # # #       #     #   # # # #         #   # # #   # #   # #         #   # #     # #   #   #
# ### # # # # # # ##### # ##### # # # # ### ### # # # ####### # ### ### # # # ######### # ##### # ### ### # ############# # # ##### ##### ###
#   #   # # # # # #   #       #     # #   # #   # # #       #   # # # # # #           # #     # # #   #   #     #       # # # # #   #   # # #
# # ##### # # ### # # ################### # # ### # # ##### ##### # # # ### ######### ####### # # # ########### # # ##### ### # # # ### # # #
# #   #   # #       # #         #     #   #   # #   #     # #         #   #   #     #       #     #     #     # # #   #   #   # # #   #   # #
# # ### ####### ####### ####### # ### # ####### ### ##### # # ########### # ### ### ####### ########### # # # # ##### # ### ### # ### # ### #
# #     #     #   #     # #     # # #   #     #     #     # #   #   #     # #   # # #     #     #       # # # #       # #   #   # #   #     #
# ####### ### ##### ##### # ##### # ######### # ##### ##### ### # # # ####### ### # # ### ##### # ##### # # ######### # # ### ### # #########
# #       # #     # #     # #     #           #   # # #     #   # # #       # #   #   # # #     # #     # #     #   # #   # #     #         #
# # # ##### ##### # ##### # # # ### ##### ####### # # ### ### ### # ####### # # # ##### # ##### # # ##### ### ### # # ##### # ############# #
# # #   #         #     # # # #   #   # #       #   #   #   # #   # #   #   # # #     # #     #   #     #   #     #   #     #     #     # # #
# ### # ####### ####### # # ### # ### # ####### ### ### ##### # ### # # # ### # ##### # ##### ############# ############# ####### # ### # # #
#   # #       #         # #   # # #   #     #   #   # #       #   #   # #   # # #     #   # # #           #     #       # #         #     # #
### # ####### ########### ### # # # ### # ### ### ### ################# ### # # ### ### # # # # ######### ##### ##### # # # ######### ##### #
# # # #     #   # #       #   # # #   # #   #     #       #           #   #   #   #     # # #   #       #   #   #   # #   # #     #   #     #
# # # # ##### # # # ### # # ##### ### ##### ####### ##### ### ####### # # ####### ####### # ####### ### ### # ### # # ##### # ### ##### ### #
#   #   #   # # #   #   # #       # # #     #           #   #     # #   # #       # #   #   #       # #   #   #   #   #     #   #     #   # #
# ### ### # ### # ### ############# # # ### ########### ### ##### # ##### # ### ### # # ### ### ##### ### ##### ####### ####### ##### # # ###
#   # #   #     # #   #             # # # # #   #       # #       #     # # #   #   # #   #   # #       # #   #           #     # #   # #   #
### # # ######### # # # ######### # # # # # # # # ####### ######### ### # ### ### # # # # ### # # ####### # # ############# ##### # ####### #
# # # #   #       # # # #   # #   # #   #   # # # # #             # #   #     #   # # # # #   # # #     #   # #         #   #     # #   #   #
# # ##### # ####### ### # # # # ######### ### # # # # ######### ### # ######### ##### # ### ### # # ### ##### # ####### # ### # ### # # # # #
#         #       #       #   #               #   #           #     #                 #         #     #         #         #   #       #   # #
#############################################################################################################################################
