#############################################################################################################################################
#   #                   #         #       #               #         #             #       # #     #     #           #   #         #   #     #
### ##### ####### ##### # ####### # # ### # ##### ######### ### ##### ####### ### # ### # # # # ### # ### ### ##### # # ####### # # # # #####
# #     # #     # #     #   #   #   # #   #   # #         #   #       #   #   #   #   # #   # #     #     #   #   #   #         # # #   #   #
# ##### # # ### # # ### ### ### ##### ####### # ######### ### ######### ### ### ##### # ##### ############# ### # ############### # ##### # #
#     # # # # # # # #     # #     # #     #   # #       #   # #         #   #   #   # #     # #   # #       #   # #       #       # #     # #
### # # ### # # # # # ##### # ### # ##### # ### # # ### # # # ### ####### ### ##### # ##### # # # # # ####### # ### ##### # ####### # ##### #
#   # #     #   # # # #   # # # # #   #   #   #   # #   # # #     #       #         # # #   # # # # #   #     # #   #     # #     #       # #
# ### ####### ### # ### # # # # # ### # # ### ##### # ### ####### # ############### # # # ### # # # ### # ### ### ### ### # ##### # ####### #
# #         # #   #     #   # # #     # #   # #   # #   #   #     #           #     #   #   #   #     # # # #     # # #   # #   #   #   #   #
# ######### # # ########### # # ##### # ### # # # # ### ### # ############### ### ##### ### ####### ### # # ####### # # ### # # ##### # # # #
#   #       # # #   #     #   #       # #   #   #   # #   #   #     #     # #   # # #   # #   #   # #   #   #       # # # # # #     # #   # #
# # ######### # ### # ### ########### # # ########### ### ##### ### # # # # ### # # # ### # # ### # # ##### # # # ### # # # # ##### # ##### #
# #     #     #     #   #           # # #         #   #   #     # # # # #   #   #   #     # #     # # #   # # # # #   #   #   #   #   # #   #
# ##### # ############# ########### # # ######### # # # ### ##### # # # ### # ########### # ####### # # ### # # ### ##### ####### ##### # ###
# #   # # #   #         #         # # # #     # # # # #     #   #   # #   # #     #       #         # #     # #   #   #     #           #   #
# ### # # # # # ######### ######### # # # ### # # # # ####### ### ####### # ##### # ##### ########### ##### ##### ### ####### # ####### ### #
#     # # # #   # #                 # # #   # #   # # #   #       #       #     #   #   #   # #     #     #     #   #     #   #   # #   #   #
# ##### # # ##### # ################# # ### # ### # ### # # ######### # ####### ##### # ### # # ### ##### ##### ### ##### # ##### # # ### ###
# #   # #   #     # #       # #     # #     #   #   #   # #   #     # # #     # #     #   #   # # #       #   #   #     #   # #   # #   #   #
### # # ##### ##### # ##### # # # ### ######### # ### ### ### # ### # # # ### ### ####### # ### # ########### ### ### # ##### # ### ### ### #
#   #   #   #       # # #   # # #     #       # # #   #     # # # #   # # #       # #     # #   #               #     #   #   # #         # #
# ####### # # ####### # # ### # ####### # ### # # # ### ### # # # ##### # ######### # ####### ##### ####### ############# # # # ##### ##### #
# #   #   # # #   #   # #   # # #       #   # # # # # #   # #   #       #     #   #   #       #   #     #   #         #   # # #     #   #   #
# # # # ### # # # # ### ### # # ######### # # # # # # ### ### ########### ### ### # ### ####### # ##### # ### # ####### ### # ##### ##### ###
# # #   # # #   #   #     # #   #       # # # # # # #   #   # #         # #   #   #   #       # # #     # #   #         #   #     # #     # #
# # ##### # ######### ##### # ### ##### ### # # ### # ##### # # ####### # # ### ##### ####### # # ####### # ############# ####### # # ##### #
#   # #   #     #   #       #     # #       # #     #     #   #       # # # #       # #     #   #     #   # #   # #         # #   #   #     #
# ### # # ##### # # # ############# # ############# ### # ########### # ### ####### # # ### ######### # ### # # # # ####### # # ####### #####
# #     #     # # #   #     #           #         #     #           # #     #   #   # #   #     #     #   # # # # # #       #   #     #     #
# ####### ### # # ##### ### # ########### ####### ### ############# # ####### # # # # ### ##### # ##### # # # # # # # ####### ##### ### ### #
#   #   # #   #   # #   # # # # #         # #     #   #   #     #   # #       # # # #   # #   # #   #   # #   # #   # #     #     #       # #
### # # ### ####### # # # # # # # ######### # ##### ### # # ### # ### # ####### # ##### # # # # # # # ### ##### # ### # ### ##### ######### #
# #   #   #           # #   #   # #         #   #   #   #   # # # #   #   #   # #     # # # #   # # # # #     # # #   # # #     #   #       #
# ####### ##### ####### ####### # ### # ### ### ##### ####### # ### ##### # # # ##### # # ### ### # # # ### ### ### ### # ##### ### # ##### #
#       #     #   #     #   #   #   # # #     #       #       #   # #   #   # #       # #   #   # # #     #     #   #   #       #   #   # # #
# ##### ##### ### # ### # # # ##### ### ### ############### # ### # # # # ### ####### # ### ### ### ##### ####### ### # ######### ##### # # #
#     #     #   # # #   # #       #   #   # #             # # #   #   # #   #       # #   #   #     #   # # #     # # #     #     #     #   #
####### ### ### # # ##### ########### # # ### ####### ### # ### ##### # ####### ### ##### ### ####### ### # # ### # # ##### # ##### ##### ###
#       #     # # #   #   #   #       # #           # #     #   #   # #       #   #     #   # #       #   #   #   # #     #     #   #       #
# ##### ####### # ### # ##### # ############# ####### # ##### ### # # ##### # ### ##### ### # ##### ### ### ### ### # ######### # # ####### #
#   #   #   #   # # #         # #       #   # #       #   #   #   # # #   # # #   #   #   # #     #     #     # # #   #     #     # #     # #
# # # ### # # ### # ######### # ### ### # # ### ######### # ##### # ### # ### # ##### ### # ##### # ########### # # ### ### # ####### ### ###
# # #   # #   #     #     #   #   # # # # #   #         # # #     # #   #     #         #     #   #             # #   #   # #   #     # #   #
# # ##### ########### ### ####### # # # # ### ######### ### ### ### # ############### ####### # ################# ### ### # # ### ##### ### #
# # #   # #           # #   #     # # # # # #   #       #   #   #   # #     #         #     #   #           #       # #   # # #   #       # #
# # # # # # ########### ### # ##### # # # # ### # ##### # ### ### ### # ### # ######### ### ##### ####### ### # ##### # ### ### ### ####### #
# #   #   #     #           #     # #     # #   # # #   #     # # #   #   #   # #     # # # #       #   # #   #       # # #     #   #   #   #
# ######### ### ##### ########### # ####### # ### # # ######### # # # ### ##### # # ### # # ####### ### # # ########### # ####### # # # # ###
# #     #     #     # #     #     #   #     # #   # # # #         # # #       #   # #   # #     # #     #   #   #     # #         # # # #   #
# # ##### ######### # # ### # ##### # # ##### # ### # # # ########### # ##### ### # # ### ##### # ##### ##### # # ### # ### ####### # # # # #
# #       # #       # # # #   #   # # #         #   # # # #           # #   #   # # #     #     # #     #     # #   # #   #     # # # # # # #
# ##### ### # ####### # # ##### ### # # ######### ### # # ######### ##### # ### ### ### ### ##### # ######### # ##### ### ### # # # # # # # #
#     #     #   #   #   # #       # # #   #     #   #   #   #     #       #   #   # #   #   #     #   #       # #     # #   # # #   # # # # #
##### ##### ### # # ##### # ##### # # ##### ### # # ### ### # ### ### ####### ### # # ### ### # # ### # # ##### # ### # ### # # ### # # ### #
#   # #   # # #   #     #     #   # #   #   # # # #   #   #   # #   #     # # # #   # # # #   # # # # # # #     #   #   #   # #   # # #     #
# ### # # # # ####### # ##### # ### ### # ### # ### ##### ##### ### ##### # # # ### # # # ##### # # # ### # ##### # ##### ### ### # # ##### #
#     # #   #   #   # # #   # # #   # #       #   #     #     #   #   #   # # #     # # #     # #   #     #   #   # #     #     # # #     # #
# ##### ##### # # # ### # # # # # ### ########### # ### ##### # ##### ### # # ####### # ##### # ############# ##### # ########### # ##### ###
#     #       # # #   # # # # # #   # #           #   #   #   # #   #   #   #       #   #   # #             #     # # #           # #   #   #
##### ######### # ### # # # ### ### # # ####### ####### # # ### # # ### ### ####### ### # # # ######### ### ##### # # ### ######### # ##### #
#   #   #   #   # #   #   # #   #   # #   #     #     # # # #   # #     # # #     #     # # #         #   #         #   # #         #   #   #
# ##### # ### ### # ####### # ### ### ### # ##### ### # # # ### # ####### # # ########### # ### ##### # ############### # # ########### # ###
#     # #       # # #       # #   #   # # # #   # # # # #       #   #     # #       #     #   # #   # # #     #       #   # #       #   #   #
# ### # # ####### # ### ##### # ### # # # # # # # # # ####### ##### # ##### # ### ### ####### ### # # # # ### # ##### ##### # ##### # # ### #
#   #   # #   #   # #   #     #   # #   # # # #     #     #   #   # #       #   #   # #           # # # # # # #   # #     #   #   #   # #   #
### ##### ### # ### # ### ### ### # ### # ### ####### ### # ### # # # ############# # ############# # ### # # ### # # ##### ##### ##### # # #
#   #   #   # #   # #   # # #     #   # #       #   #   # # #   # # # #     #       #         #   # #   # # #   # # #     # #   #     # # # #
# ##### ### # ### # ### # # ####### # # ######### # ##### # # ### # # # ### # ##### ######### # # # ### # # ### # # ##### # # # # # ### # ###
# #   #     #   # # #   # # #     # # # #       # #       # # # #   #   #   # #   # # #     # # #       #     #     #     # # # # #     #   #
# # # # ####### # # # ### # # # ### # # # ##### # ######### # # ######### ### # # # # # # ### ######### # ########### ##### # # ####### ### #
#   # # #       # # # #   #   #     # # #   # # #   #   #   # #             #   # # #   #   #     #   # # #       #   #     # #       #   # #
##### # # ####### # # # ############# # ### # # ### # # # ### # ########### # ### # ##### # ##### # # # # # ##### # ### ##### ####### ### # #
#     #   #     # #   # #           # # #   # #     # # # #   #     # #   # #   # #     # #     #   # # # #   #   #   #   #   #     # #   # #
# ######### ### # ##### # ######### # # # ### ####### # # # ####### # # # # ### # ##### ### ### ##### # # ### ### # # ### # ### ### # ##### #
# #         #     #   # # #       #   # # #         # #   # #     #   # # #   # #   # #   # #     #   # # # #   # # #     #   #   # #       #
# ### # ########### # # # ##### # ##### # # ######### ##### # ### ##### # ### # ### # ### ### ### # ##### # ### # ### ####### ### # ####### #
#   # #     #   #   # # #     # #   # # # #         #     #   # #       # #   #   # #   # #   #   #       #   # #   #     #   #   #     #   #
### # ##### # # # # ### ##### # # # # # # ##### ### # ######### ######### ### ##### # # # # ### ########### # # ### ##### # ### # ##### # ###
# # # #     # # # #   #   #   # # #   # #     #   #   #           #     #   #       # # #   # # #     #   # # #   # #   # # #   # #   # #   #
# # ### ##### # ##### ### # ### # ### # ##### ### ##### ##### ### ##### ### ######### # ##### # # ### # # # ##### # # # ### # ##### # ##### #
# # #   #     #     #       #   # #   #   # #   #     #   # # # #         #   #     # #     #   #   # # #   #     # # #     #       #   #   #
# # # ### ######### ########### # ####### # ### ##### ### # # # ##### ####### # ##### # ##### ### # # # # ### ##### # ########### ##### # ###
#   #             #           # #       # #   # #     #   # # #       #       # #     #   #   #   # # # # #   #   #   #         # #   #   # #
# ############### ########### # ####### # ### # ####### ### # ##### ### ####### # ####### # ### ### # # ### ### # ##### ####### # ### ##### #
# #     #         #     #     #       #       #       # #   #     # #   # #       # #     #   #   # # #   #     #       #   #   #     #     #
# ### # ### ####### ##### ####### ################### # ### ##### # # ### # ####### # ####### ### # # ### ############### # # ####### ##### #
#     #   #         #     #     # #         #         #   #     # # # # #   #   #   #         # # # #   #     #       #   # #   #   # #     #
######### # ######### ##### # ### # ####### # ### ####### # ### # ### # # ### # # # ########### # # ### ### # # ##### ### ##### # ### # ### #
#     #   # #     #   #     #     # #     # #   # #       #   # # #   # #   # # # # #       # #   # #     # #   #   #   #     # #   #   # # #
# ### # ##### ### # ### ########### # ##### ### ### ####### ### # # ### ### # # ### # # ### # # ### ##### # ##### # ### ### # # ### ##### # #
# #   # #     # #   #   #   #     # #   #       #   # #   # #   # #   #     # #   # # # # # # # # #     #   #     #         # #   #     #   #
### # # # ##### ######### # # ### # # # # ####### ### # # # # ### ### ##### # ### # # # # # # # # ##### ##### ############### ### ### ### ###
#   # #   #           #   #   # # # # #   # #     #     #   #   #   #     #   #   #   # #   # # #     #   #   #         # #   # #   #   #   #
# ######### ######### # ####### # # ##### # # ##### ########### ### ##### ##### ##### # # ### # # ### ### ### # ####### # # ### ### ### ### #
# #     # #       #     # #     # #     # # #   # #   #       #   #       # #   #   # # # #   #   #     #   # # # #     #     #   #   #   # #
# # # # # # ##### ####### # ### # ##### # # ### # ### # # ####### ######### # ### # ### # ### ##### ####### ### # # ######### ### ### # ### #
# # # # #       #     #       #   #   # #   #   #   #   # #       #         #   # #     #   #   #   # #   #   # # #         # #   #   #   # #
# # # # ##### ##### # ########### # # # ##### ### ### ##### ####### ### # ##### # ######### # ### ### # # # # # # ######### # # ### ##### # #
#   # #     # #   # # #         #   #   #     #   #   #   # #   #   #   # #     #   #     # # #       # # # # # #         # #   #   #     # #
##### ##### ### # ### # ####### ######### ##### ### ### # # # # # ### ##### ##### # # ### # # # ####### # ### # # ### ##### ##### ### ##### #
#     #   #     #   # # #     #   #       #   #       # # #   #   # #     # #     # #   # # # # #       #     # #   # #     #     #     #   #
# ##### ##### ##### # # # ####### # ####### # # ####### # ##### ### ##### # # ##### # ### # # # # ########### # ##### # ##### ######### # ###
# #   #       #   #   # #     #   #   #     #   #       #     #   #     #   #     # # #   # # # # #           #     #   #   #   #     #     #
# # ### ####### # # ### # ### # ##### # ####### # ########### ### ##### ######### # # # ### # # # # ############### ### # # # # # ### ##### #
# #       #     # # #   # #   #   #   #   #   # #   #   #   # #           #       # # #     # # # # #     #       #   #   # # #     #     # #
# # ####### ##### ### ##### # ### # ####### # ##### # ### # # ########### ######### ### ##### # # # # ### ##### # ### ##### ####### ##### # #
# #   #   # #   #   # #     #   #   #       #       #     #             #     #   #   #     #   # #   # #       #   #   # #     # #     # # #
# ### # # # # # ### # # ####### ##### ################################# ##### # # # # ##### # ### ##### ##### ######### # ##### # # ##### # #
#   # # #   # #   #   #   #     # #             #           #         #   # # # # # # #   # #   #     #     # #         #     # #   #     # #
# # ### ##### ######### # ##### # # ########### # ######### ### ######### # # # # # # # # # ### ##### # ##### # ######### # ### ### # ##### #
# #     # #           # #     #   # #         #   #   #     #   #       # #     # # # # # # #     # # #       #       # # #   #   # # #     #
# ####### # ##### ### # ##### ##### ######### ##### # # ##### # # ### # # ####### ### # ### ##### # # ##### ######### # # ### ### ### # #####
# #       # #   #   # #   # #             #   #   # #   #     # # # # # # #     #     #   #   #     #     #       #   #     #       # #   # #
# # # ##### # # ### ##### # ############# # # # # # ##### ### ### # # ### # ### ####### # ### ########### ##### ### ############### # ### # #
# # #     #   #   #           #       #     # # # # #   # # #     # #     # # # #       #   #     #   #   #   # #   #   #       # # #   #   #
# # ##### ####### ############# ##### ######### # # # ### # ####### ####### # # # ####### # ##### # # # ### # # # ### # # ##### # # # # ### #
# #     #       # #   #         #   #   #   #   #   #     #                 # # #       # # #   #   #   # # #   #     #   # #   # # # # #   #
# ##### ##### ### # # # ######### # ### # # # ####### ############# # ####### # ##### ### # # # ######### # ##### ####### # # ### # ### # ###
# #   #   #   #     # # #     #   #     # # # #     #             # # #       #     # #   #   #   #       # #   #   #   #   #   # # #   #   #
# # ##### # ### ####### # ### ##### ##### # # # # ############### ### ####### ##### ### # ####### ####### # # # ##### # ##### # # # # #######
# # #     # #   # #     #   #     #   #   #   # #         #     #   #       #     #   # # #     #         # # #   #   #     # # # # #       #
# # # ##### # ### # ### ### ##### ### # # ##### ##### ##### ### ### # ##### # ### ### # # # ### ########### # ### # ####### ### # # ####### #
# # # #   # # #   #   #   #     #   # # # #   #     #         #   # # #     # #   #   # # # # #             #   #   #     #     # #   #   # #
# # # # # # # ### ### ######### ### # ### # # ##### ########### # # # # ##### # ### ### ### # ################# ##### ### ####### ### # # # #
# # #   # # #   #   #           #   #     # #     # #   #       # # # #   #   #   # #             # #       #   #   # #   #   #       # #   #
# # ##### # ### # # ########### # ######### ##### # # # # ##### ### # ### ### ### # ############# # # ##### # ### # # # ### # # ####### ### #
# #       #     # #     #     # # #   # #   #   #   # # #     # #   #   #   # #   #       # #   #   # #       #   #   #   # # #   #   # #   #
# ### ############# # ### ### # # # # # # ### ####### ####### ### ######### # ########### # # # ### # # ####### ######### # # ### # # # # ###
#   #       #     # # #   # # # # # #   #   #     #         #   #     #     # #         # #   #     # # # #     #       # # # #   # #   # # #
### ####### # ### # # # ### # # # # ####### # ### # ##### ##### ##### # ##### # ####### # ########### # # # ##### ##### # # # # ### ##### # #
# #   #   #   #     # # #     # # # #   #   #   #       #   #       #   #   #   #     #   #         # #   # #   # #       # # # #   #     # #
# ### ### ##### ####### # ####### # # # # ### ######### ### # ##### ##### ### ### ### ##### ####### # ##### # # # # ####### # # ### # ##### #
# #   #     #   #       #       # #   # # #   #       # #   #     # #   #   # #   # #   #   #   #   # #   # # # # # #   #   # #   # #     # #
# # ### ##### ### ############# # ### # # ##### ##### ### # ##### ### # # # # # ### ### # ### # # ### # # # ### # ### # ##### ### # ##### # #
#   #           #   #     #     #   # # #       #   # #   #     #   # #   #   #   #   #   # # #   #     #       #     # #   # #   #   #     #
# ############### # # ### # ####### ### ######### ### # ####### ### # ########### # # ##### # ################# ####### # # # # ##### ##### #
#       #   #   # # # # #   #     # #   #   #     #   # # #   # # #   #       #   # #     #   #   #   #       #   #     # #   # #   #   # # #
####### # # # # ### # # ##### ### # # ### # # ### # ### # # # # # ######### # # ### ####### ### # # # # ##### ##### ##### ##### # # ### # # #
#         #   #     #         #     #     #     #       #   #               #   #               #   #   #           #             #     #   #
#############################################################################################################################################
