#############################################################
#     #   #           #       # #                     #     #
##### # # ### ####### ##### # # # ############### ### ##### #
#   # # #   #     #   #     # # #       #       #   #       #
# # # # ### ##### # ### ##### # ####### # ##### ### ####### #
# # # #   #     # #   # #   # #   #   # # #     # #   #   # #
# ### # # ##### # ### # ### # # # # # # # # ##### ### # ### #
# #   # # #       #   #   #   # #   # #   #       #   #     #
# # ### # # ######### ### # ######### ####### ##### #########
#   #   # # #       #   # #         #       # #     #       #
# ### ### ### ##### ### # ######### # # ##### # ##### ##### #
# #     #         #   #   #   #     # #   #   # #         # #
# # ################# ##### ### ##### ### # ### # ######### #
# # #         #     #   #     # #   #   #     #   #       # #
# ### ####### # ### ### # ### # # # # ############# ##### # #
# #   #     # #   #     #   # #   # # #         #   #     # #
# # ### ##### ### ####### ### ##### ### ####### # ### ##### #
# #   #     #   #   #     #   #   # #   #     #   #   #     #
# ### # ### ### ### # ##### # # # # # ### # # ##### ### ### #
#     # #     #     # #   # #   # #   #   # # # #   #     # #
####### # ########### # # # ##### ##### ### # # # ### ### # #
#       #           #   # # #     #   # #   #   # # # #   # #
# ########### ##### # ##### # ####### # # ####### # # # #####
# #   #       #     # #     #   #     # #       # #   #     #
# # ### ####### ####### ####### # ##### ####### # ####### # #
#   #   #               #     # #     #       #   #     # # #
# ### ### ################# # # ### # ####### ##### ### ### #
# #   #   #     #   #       # #   # #       #       #   #   #
### ### ### ### ### # ### ####### ##### # # ######### ### # #
#   #     # # #   #   # #       # #   # # # #     # # #   # #
# ### ##### # ### # ### ##### ### # # ### # ### # # # # ### #
# #   #       #   # #       #   #   # #   #   # #   # #   # #
# ##### ##### # ### # ##### ### ##### # ##### # ### # # # # #
#       #   # # # # #   # #   #     #   #   # #   # # # # # #
# ##### # # ### # # ### # ### ##### ##### # # ### ### ### ###
# #   # # #   # #       #   #     #     # # #   #   #   #   #
### # ### ### # ######### ####### ### ### # ### ### ### ### #
#   #   #   #   #     #   #     #   #     #     #     # #   #
# ##### ### # ### ### ### # # ##### ############# # ### # # #
#     # #   # #   # #   # # #     #   #         # # #   # # #
# ### # # ### # ### ### # # ### ##### ### ### # # ### ### # #
# # # #   #   #     #   # # # #     #   # #   # #   #   # # #
# # # ##### ### ##### ### # # ### # ### ### ### ### ### # ###
#   #     #   # #     #   #     # #   #   #   #   # #   #   #
######### ##### # ##### ####### # ### ### ### ### # # ### # #
#       # #     #     #         # # # # #     #   # # #   # #
# ##### # # ######### ########### # # # ####### ### # ##### #
#     # #         #   #         # #         #   #   #   #   #
##### # ######### # # # ####### # ########### ##### ### # # #
#     #   #   #   # # # #     # # #               #   # # # #
# ####### # # ##### ### # ##### # # ############# # # # # ###
#   #     # #     #       #     # # # #     #   # # # # #   #
# # ##### # ##### ######### ##### # # # ### # ### ### # ### #
# #     #   #   #       #   #         # #   #       # #   # #
# ##### ##### # ####### # ### ######### # ### ##### # ### # #
#   #   #     #           # #   # #     #   # #   #     # # #
# ### ##################### ### # # ####### ### # ####### # #
# #   #       #     #     #       # #     #   # #       #   #
# # ### ##### # ### # ### ######### # ### ### # ####### ### #
# #         #     #     #             #     #         #     #
#############################################################
