#####################################################################################################
#   #             #       #     #   #     #       #     #     #                   #     #       #   #
### # ### ####### # ##### # ### # # # ### # ### ### # ### # # # ####### ######### ### # ####### # # #
# # # # # #     # #   # #   #   # #   # #     #     # #   # # # #       #       #     # #     #   # #
# # # # # # ### # ### # ##### ### ##### ########### # # ### # ### ######### ########### # ### ##### #
#   # # # # # # # #     #   #   #     #     #     # # # # # #   #         #           # #   #       #
# ### # # # # # # # ##### # # # ##### # ### # ### ### # # # ### ######### ########### # # # ####### #
#   #   #     # # # #   # # # #     #   #   #   #   #     # # #         #   #       #   # # #       #
### ########### # ### # # # # # ######### ##### ### ####### # ######### # # # ##### ### ### ####### #
# #             #     #   # # # #     #   #     # #     #   #     #   # # #   #   #   #     #     # #
# ######################### ### # ### # ### ##### ##### # ### ##### # # # ##### ##### ##### # ### # #
# #         # #     #     #   #     # #   # #   #       # #     #   #   #   # #     #   #   # #   # #
# # # ##### # # # # # # # ### ##### # # ### # ### ####### ### # # ######### # # # # ### ##### # ### #
#   # #   #   # # # # # #   #     # #   #   #   #   #       # # #   #     # #   # # #   #   # #   # #
# ### ### ### # # # # # ######### # ##### ### # ### ####### ### ### # ### # ##### # # ### # # ### # #
#   # #     # # # # # #   #       #   #   #   #   # #   #   #     # # #   # #   # # # #   #   #   # #
### # # ##### # # # ##### # ####### ### ### ### ### # # # ### ##### ### ### # # # ### # ####### ### #
# # # #     # # # #       #     #   #   # # # #   #   #   #       #   #       #   #   # #       #   #
# # # ##### # # # ### ######### # ### ### # # ### ######### ##### ### ########### # ### # ####### ###
# # # #   #   # # #   #     #   #   # #   # #   #       #   #   #   #     #   #   # #   #   #   # # #
# # # # # ##### # ##### # ### ### ### # ### # # ### ##### ##### ### ##### # ### ### # ##### # ### # #
#   #   #       #       #   #   # #   #     # #   #   #   #       #       #       #       # #       #
# ############# ########### ### ### ##### ### ### ### # ##### ### ######### ############# # ####### #
#   #     #   #       #   #   #   #     # #     # #   #       # # #           #     #   # #   #   # #
### # ### # # ######### # # ##### ##### # # ##### # ########### # # ######### # ### # ### ### # # # #
#   #   #   #   #       # #     #       # #   #   #       #   #   # #       # # # # #       #   # # #
####### # ##### # ####### ##### ######### ### # ####### # # # # ##### ##### ### # # ##### ##### # ###
#     # # #   #   #   #   #   #         #   # #   #     #   # #       #   #     # #     # #   # #   #
# ### # ### # ##### # # ### # ##### ####### ##### # ##### ############# # ####### ##### ### # ##### #
# # # #     # #     # # #   #     #       #   #   # #     #             # #   #       #     #       #
# # # ####### # ### # # # ####### # ##### ### # ### # ##### ####### ##### # # # # ################# #
# #         # #   # # #   # #     #     #     #   # #     # #     # #       #   # #     # #       # #
# ######### # ### # ####### # ######### ######### # ##### # ### # # ############### # # # # ### ### #
#   #         #   # #       # #   #     #   #     #   # # # #   # #             #   # #   #   #     #
# # ######### ##### # ### ### # # # ##### # ### # ### # # # # ### ############# # ### # ##### #######
# # #       # #   #   #   #   # #         #     # #   # # # # # # #   #     # # # # # # #     #     #
### # ##### ### # ##### ### ####################### ### # # # # # # # # ### # # # # # ### ##### #####
#   # #   #   # #     #   # #         #       #   # #     #   # #   # #   #   #   # # #   #     #   #
# # # # # ### # ##### # # # # ####### # ##### # # # ### ####### ##### # # ######### # # ### ### # # #
# # #   #   #   #     # # # # # #     # #   #   # #   #     #   #   # # #         # # #   # #   # # #
# # ####### ##### ##### # # # # # ##### # # ##### # # ##### # # # # # # ##### ### # # ### # # ### # #
# #     #   #     #   # # # # #   #     # # #     # # #   # # # # # # # #     #     #     # #     # #
# ##### # ### ##### ### # # # ### # ##### # # ####### # ### # # ### # ### ######### ############### #
# #     # #   # #       # # #   #   #     # # #       # #   # #   # #   #       #     #         #   #
# ####### # ### # ####### # # # ##### ##### # ### ##### # ### ### # ### ####### ##### # # ##### # # #
#   #   # #   #         #   # #       # #   #   # #   #   #     #   # #   #   #     # # #   #   # # #
# # # # # ### ######### ##### ######### # ##### # ### # ####### ### # ### # # # ### # ##### # ### ###
# #   # # # #   #   #   #   #           # #   # # #   # #   #   #   #   #   # # # # # #   # #   #   #
# ##### # # ### # # # ### # ############# # # # # # ### # # # ### ### # ##### # # # # # # # ### ### #
# #     # #   #   # #     #     #       # # #     #   # # #   # #     #   # # #   # #   #   # #     #
# # ##### # # ##### ########### # ##### # # ######### # # ##### ######### # # ##### ######### ##### #
# #   #   # # # #   #   #         #       #   #     # # # #             #   #     # #         # #   #
# ### # ### # # # ##### # ################### # ### # # # ####### ### ##### ##### # # ### ### # # ###
#   #   #   #   #     #   #     #       #     # #   #     #     # #   #     #   #   #   #   # # # # #
### ##### ########### ##### ### # ##### ####### # # ####### ### # # ### ####### ####### ### # # # # #
# # #   #         # #       # #   #   # #   #   # # #         # # #     #     #       # #   #   #   #
# # # # # ##### # # ######### ####### # # # # ### ### ######### # ####### ### # # ### ### ### ##### #
# #   # #     # #     # #             #   # #   #     #   #     #         #   # #   #     #   #     #
# ##### # ##### ##### # # ##### ##### ##### ### ######### # ############### ### ### ######### # #####
#       # #   #     #   # #   #     # #       # #       # #       #         #   # #         # #     #
# ####### # # ### # ### # ### ##### # # ####### # # ### # ####### ### ####### ### ######### # ##### #
# #     # # #   # #   # #         # # # #     # # #   #         #   # #     #     #     #   # #     #
# # ### ### ### # ### ### ######### # # # ### # ### # # ########### # # ### ##### # ### # ### # #####
# #   #     #   #   # #   #       # # # #   # #   # # # #   #       #   # #     # # #   #   # # #   #
# # # ####### ##### # # ### ##### # # # ### # ### ### # # # # ########### ##### # ### # ### ### # # #
# # #     #   #     #     #     #   # #   # #   #     # # #   #     #   #       #     # #   #   # # #
# ### ### # ##### ############# # ##### ### ### ##### ### ##### # ### # # ############# # # # ### # #
#   # #   #     #   #           # #   #     # #     # #   # #   # #   #               # # # #   # # #
### # # ####### ### # # ####### ### # # ##### # ##### # ### # ### # ################# # # # ### ### #
# # # # #   # #   # # # #     # #   # #     # #       # # #   # #   # #         #   # # # #   #     #
# # # # # # # ### # # # # ### ### ### ##### # ######### # # ### ##### # ####### ### # # # ### ##### #
#   # # # # #     # # # # # #     # #     #     #   #   #   # #       # #     #   #   # # #     #   #
# ##### # # ### ##### # # # ####### ##### # ##### # # ### ### # ### # # ### # ### # ### # ####### ###
# #   #   #   # #     # # #       #     # # #   # # #   # #       # # #     # #   # #   #       # # #
# # # ####### # # ####### ##### # ##### # ### # # # ### # ### ##### # ### ##### ### # ######### # # #
#   #         #   #       #     #       #   # # # # #   #   # #     #   # #     # # #   #     # #   #
############### ### ####### ########### ### # # # # # ##### ### ##### ### # ##### # ### # ### # ### #
#     #         #   # #     #             #   #   # #     #     #   # #   # #     #   # # # #   #   #
# # # # ######### ### # ### ####### ############### # ### ####### ### # ### # ### ### ### # ### # ###
# # # #   #     # #       #       # #           #   #   # # #       # # # # # # #       # # #   #   #
# # ##### ### # # # ####### ##### ### ######### # ####### # # ##### # # # # # # ####### # # # ##### #
# #     #   # # # # #     #     #     #       #     #   # #   #   #   #   # # #   #   #   # #     # #
# ### ##### # # # ### ### ########### ##### ####### # # # # ### # # ##### # # # # # # ##### ### ### #
# # #     #   # # #   # #           # #     #   #     #   # #   # # #   # # #   # # #   #   #   #   #
# # ##### ##### # # ### ########### # # # ### # ########### # ### ### # # # ####### ### # # # ### ###
#     #   #   # # #   # #   #   #   #   # #   # #       #   # # #   # # # # #   #   # # # #     # # #
##### # ### # # # ### # # # # # # ####### # ### # ##### # ### # ### # # # # # # # ### # # ##### # # #
#   # #     # # #     #   # # #   #     # #   #   # #   #   #   # # # #   #   # #   # # # #   # #   #
### # ####### # ######### # # ##### ### # ### ##### # ######### # # # ######### ### # # ### # ##### #
#   # # #   # # #       # # #       # # #   #     # #     #     # #   #       #   #   #     # #   # #
# ### # # # # # # # ### ### ######### # ######### # ##### # ##### ######### # # ##### ####### # # # #
#   # # # #   # # #   #       #       #         #       # #   #   #       # # #       #     #   #   #
# # # # # ##### ##### ####### # # ########### # ####### # ### # # # # ### # # ######### ### #########
# # # # #     # #     #     # # # #     #     #     #   #   #   # # # #   # #     #       #       # #
# # # # ##### # # ##### ##### # ### ### # ######### # ##### ##### # # # ### ##### ############# # # #
# # # #     # # # #   #     # # #   #     #         #   # #       # # # #   #   #       #       # # #
# # # # ### # # # # ### ### # # # # ################### # ########### # # ### ######### # ####### # #
# # # # # # # # # # #   # # # # # # #                   #   #         # # #   #   #   # #   #   #   #
# # # # # # # # # # # ### # # # # ### ################### # ##### ##### # # # # # # # # ### # ##### #
# #     #   #     #       #     #                         #       #       # #   #   #       #       #
#####################################################################################################
