#######################################################################################################################################################
# #           # #               #       #       #   #             #           #   #         #       #         #         #                     #       #
# ##### ##### # # ############# # ### # ##### # # ### ### # ####### ##### ### # # # ####### # # ### # ##### ### # ##### # ######### ######### ####### #
#       #   # # # #           #     # # #     #   #   #   # #           #   # # #   #     # # # #   # #     #   # # #   #       #   #       #       # #
########### # # # # ######### ####### # # ######### ### ### # ########### # ### ####### # # # # # ### ####### ### # # ##### ##### ##### ########### # #
#         # # #   # #       #       # #   #         # #   # # #     #   # #   #       # # #   # # #   #       #   #   #     #   # #     #         # # #
##### ### # # ##### ####### ####### # # ### ##### ### ### ### # # ### # ##### ####### ### ##### # ### # ####### ### ### ##### # # # ### # ### ### # # #
#     # #   # #     #       #   #   # # #   #   #       #       # #   #       #     #     #     #   #         # #   #   #   # #   # # # #   #   # #   #
# ##### ### # # ##### ##### # # # ### ### ### # ######### ####### # ######### ##### ##### # ####### ######### # ##### ##### # ##### # # ### ### ##### #
# #   #   # #   #     #   # # #   #         # #     #   # #   # # # #   #   # #     # #   # #   # #     #     #   #   #   # # #     # # # # # #   #   #
# # ### # # ##### ### # # ### ##### ######### ##### # # ### # # # # # # ### # # ### # # ### # # # ##### ######### # ### # # # ### # # # # # # ### # ###
# #     # # #   #   # # # #   #     #         #       #     # #   #   #   #     #     # # #   # #   #   #   #     # #   #   #   # # #     # #   # #   #
# # ##### # ### ### # # # # ##### ### ##### ################# ######### # ########### # # ##### # # # ### # # # ### # ##### ### ### ####### # # # ### #
# #   #   #   #   # #   #   #   # #   #   # #   #   #         #       # # #   #     # # # #     # # #     # # # #   # #       #   #           # #   # #
# ##### ##### # # # ######### # ### ##### # # # # # # ####### # ##### ### # # # ### ### # # ##### ######### # ### ### ########### ############# ### # #
#     # #       # #     #   # #   #     #   # #   # #   #   #   #   #   # # #   # #   #   #   #       #     #   #   #   #       #         #   # # # # #
##### # # ############# # # # ### # ### # ### ##### ##### # ##### ##### # # ##### ### ### ### # ### # # ####### ### # # # ##### ######### # ### # # # #
#     # # #           #   # #   # # #   # # # #   #       #     # #     #   #       #       # # #   # #     #   #   # # # #   #           # #   # # # #
# ##### # # ##### ### ##### # # # ### ### # # ### ############# # # ##### ### ##### ######### ### # ####### # ### ##### # # ############### # ### # # #
#   #     # #   # #     #   # # # #   #     #       #           #   #       #   #   #   #     #   # #     # #   # #   # # #         #       # #   #   #
### # ##### # ### ####### ##### # # ######### ##### # ############# ####### # ### # # ### ##### ### # ### # # # # # # # # # ####### # ### ### # #######
#   # # #   #   #         #     # #           #   # # #           #       # # #   # # #   #     #   #   #   # #     #   # # #       #   #     #       #
# ### # # ##### ########### ##### # ########### # ### # ######### ####### # ### ### # # ##### ##### ### ############### # ### ##### ### ####### ### ###
# #     # #   #     #       # #   # # #     #   #   #       #   #   #   # #   # # #   # #     #   # #   #         #     #   #   # # #   #     #   #   #
# # ##### # # # ### ####### # # ### # # ### # ##### ######### # ### # ### ### # # ### # ### ### # ### ### ####### ######### ### # # # ### ### ### ### #
# #   #   # # #   #         # # #   #   #   #   # #       #   #   # #     #     #     # #   #   #   # #   #         #       #   #   #   #   #     #   #
# ### # ### # ### ########### # # ####### ##### # ####### # ##### # # ########### ##### # # # ##### # ### # ####### # ####### ######### ### ####### # #
#   # #     #     #     #       #       # #     #           #   #   #     #   #   #     # # #     # # #   # # #   #   #   #   #         # #   #     # #
# # # ############# # ### ############# # # ### ############# # ######### # # ##### ##### # ### ### # # ### # # # ##### # # # # ######### # ### ##### #
# # # #     #       #     #           #   #   # #         #   #       #   # #     #     # # #   #   # # #     # #     # # # #   #           #   #     #
# # # # ### # ################### # # ### ### ### ####### # ######### # ### ##### ##### # ### ### ### # ####### ##### # ### ################# ### #####
# # #   # # # #                 # # #   #   #   #       # # #         #   # #   # #     #       # #   #         #     #   #         #     #   #     # #
# # ##### # # # ############### ### ### ### ### ### ##### ### ####### ### # # # # # ##### ####### # ####### ##### ##### # ######### # ### # ####### # #
# # #     # #   #   #     #   # #   #   #   # #   # #     #   #     #   #   # # # # #   #   #   # # #     #     # #     # #       # # # # #   #   #   #
# # # # ### ##### # # # # # # # # ### ### ### ### # # ##### ### ### ### ##### # # # # ##### # # # # # ### ####### # ##### # ### # # # # # ### # # #####
# # # # #   #   # #   # #   # # # #     #   #   #   #   #     #   #   #   #   # #   #     # # # # #   # #         # #   #     # # # # # #   #   #     #
# # # # # ### # # ##### ##### # # ######### ### ####### ##### ####### ### # ### ##### ### # # # # ##### ############# # ##### # ### # # ### ######### #
# # # # # #   # # #   # #     # #         #   #     # #     #       #     #   #     # # #   # # #   #     #           #     # # #   # #   # #   #   # #
# # ### # # ### # # # # ####### # ##### # ### ### # # ##### # ##### ######### ### ### # ##### # # # # ### # ####### ####### ### # ### # # # # # # # # #
# #   # # #   # # # # #         #     # #   # #   #       # #   # #     #   #   #     # #     # # # # # # #       # #   #     # #     # #   # #   # # #
##### # # # # # # # ############# ##### ##### # ######### # ### # ##### # # ### ####### # ##### # # # # # ####### # # # ##### # ####### ##### ##### # #
#     # # # # # # #             # #   #   #   # #   #   # #   #     # #   #     # #     # #     # #   # #   #   # #   #   #   #       # #     #     # #
# ##### # # # ### # ######### ### # # ### # ### # ### # # ### ##### # ########### # # ### ##### # ##### ### ### # ####### # ##### ### # # ### # ##### #
# #     # # #   # #       #   #   # #     #     # #   # #   # #   #   #         #   # #   #   #   #       #   #     #     # #     #   # #   # #     # #
# # ##### # ### # ####### # ### ### ##### ####### # ### ### # ### ### ### ##### ##### # ### # ##### # ####### ####### ##### ### ### ### ##### ##### # #
# #       # #   # # #     #       #     # # #         #     #   #     #   #           #     # #     # #       #   #   #   #     # #   # #     #     # #
# # ######### # # # # ################# # # # ################# # ##### ################### # ### ### # ####### # # ### # # ##### ### # # ##### ##### #
# #     #     # # #   #       #       # #   #     # #     #     #     #   #       #       # #   # # # # #       # # #   # # #   #   # # # # #   #     #
# ##### # ##### # # ### # ##### ##### # ### ##### # # ### # ######### # # # ##### # ##### # ### # # # # ##### ### # ##### # # # ### # # # # # ####### #
# # #   #   # # # #   # # #   # #       #   # #   # # #     #       # # # #   #   # #   # #   # # # # # #     # # #     #   # #   #   #   #   #       #
# # # ##### # # # ### # ### # # ######### ### # ### # ####### ####### ### ### # ### # # # ### # # # # # # ##### # ##### ##### ### # ####### ### ##### #
# # #     # #   # #   #   # # # #   #     #   # #   #   #   # #         #   # # #     # #   # # # # # #   #   #   #     #       # #   #   # #   #   # #
# # ##### # ##### # ##### # # # # # ##### # # # # # ### # # # # ####### ### # # ### ### ### ### # # # ####### # ### ### # ##### # ### # # # # ### ### #
# #     #   #     #       # # #   # #   #   # #   #   #   # #   #     #     # #   # # # # # #   # #   #       #     # # # #   # #   # # # #   #     # #
# # ### ### # ##### ####### # ##### # # ### ######### ##### ##### ### ####### ### # # # # # # ### ##### # ### ####### # # # # ##### # ### ##### ### # #
# # # #   # # #     #       # #   #   # #   #       #   #   #     # #         # # #   # #   #   #   #   # #       #     # # #   #   #   #       #   # #
# # # # # # # # ##### ####### # # ##### ##### ##### ### # ### ##### ##### ##### # ##### # ##### ### # ### ##### ### ##### # ### # ##### ######### ### #
# #   # # # # #     #       #   #     #       #   #   # # #   #         # #   #         #     #   #     # #   # #   #   # #   #   #         #     #   #
# # ### ### # ############# ######### # ####### # # ### # ### # ######### # # # ############# ### ##### # # # ### ### ### ### ############# # ### # ###
# # #   #   #       #       #   #     # #       # #     #   # # #   #   # # # # #         #       #   # # # #     #   #   # #           #   # #   #   #
# ### ### ######### # ####### ### ##### # ####### ######### # # # # # # # # # ### ####### ##### ### # # # # ######### # ### ########### ### # # ##### #
#   #   #   #     #   #       #   #     #     #           # # #   #   #   # #           #   #   #   # # # #       #   #     #         #   #   # #   # #
# # ### ### # ### ##### ####### ### ######### ########### # # # ########### ########### ### # ### ### # # ####### # ####### # ####### ### ### ### # # #
# #   #       # #       #       #   #       #   #       # # # #       #       #     #   #   #   #   # # #   #     #     #   # #   #   #   #   #   #   #
# ### ######### ##### ### ####### ######### ### ### ### # # # ####### # ####### ### ##### ##### ### # ##### # ##### # ### ### # ### # # ####### #######
# #   #   #   #     # #   # #     #   #   # #   #   #   #   # #     # #     #   #         #       # #   #   #     # #   #   #   #   # #         #     #
# # ### # # ### ### # # ### # ##### # # # # # ### ########### # ### ####### # ####### ######### ### ### # ####### ##### ### ### # ### ########### ### #
# #   # # #     #   # # #           #   #   # #       #       # # #         # #     # #       # #   #   #     #           # #   #   # #   #     #   # #
##### # # ##### # ### # ################# ### # ##### # # ### # # ########### # ### ### ##### ### ### ####### # ######### # ####### # # # ### ### ### #
#     # # #   # #   # #   #   #   #       #   #     #   # #   # #       #     #   #     #   #     # #   #   #   #   #   # #         # # #   #     #   #
# ##### # # # # ### # ### # # # # ######### ######### ### # ### ### # ### ### ### ######### ####### ### # # ### # # # # # ########### # ### ####### # #
# #   # #   # # #   #   # # #   #   #     #         # #   #   #     # #   # # #   #       #         #   # #   # # # # # #         # # # #   #   #   # #
# # # # ##### ### ### ### # ####### # ### # ####### # # ############# # ### # # ### ##### # # ####### ### ### ### # # # ######### # # # # ### # # ### #
#   #   #     #   #   #   # # #     # # # # #     # # #       #     # # #   # #   # #   # # #       #   # # # #   #   # #           # # #     # # # # #
# ####### ##### ### ### ### # # ##### # # ### ### # # ####### # ### # # ### # ### # # # # ######### ### # # # # ####### # ########### # ####### # # # #
# #   #   #           #     # # # #   #   #   # #   # #   # #   # #   #   #   # #   # # # #       #   #   # #     #     #       #     # #         # # #
# # # # ### ################# # # # # ### # ### ##### # # # ##### ####### # ### ####### # # ##### ### ##### ####### ########### # ##### ########### # #
# # # #   #     #   #         # #   #   #   #   #   # # #   #       #   # #             #   #   #   #       # #   # #         # # #   #       #     # #
# ### ### ##### # # # ### ##### # ##### ##### ### # # # ### ##### # # ### ####### ########### # ### ### # # # # # # # ####### ### # ### ##### ##### # #
#   #   # #   # # # #   #       #     # #   # #   # #   # #   #   #   #   #     # #         # #   #   # # #   # #   # #     # #   #   #     # #   #   #
### # # # # # # # # ### ############# # # # # # ### ##### ### # # ##### # # ### ### ####### # ### ### # # ### # ##### ### # # # ### # ##### # # # ### #
# # # # # # #   # #   #   #   #     # #   # # #   # #           # #     # #   #   # # #   #   #   # # # # #   #   #   #   # # # #   #       #   #   # #
# # ### # ### ### ####### # # # ### ####### # ### # # ####### ##### ##### ### ### # # # # ##### # # # ### # ##### # ### ##### # # ################# ###
# #     #   #   # #     #   #   # #     #   #     #     #   # #   #   # # # #   # # #   #     # #   #     # #   #   #       #   # #   #           #   #
# ##### ### ### # # # ########### ##### # ### ########### # ### # ### # # # ### # # # ####### # # ######### # ####### ##### ##### # # # ######### # # #
#     # # #   #   # #     #           #   #   #     # #   # #   #     #     #   #   #     #   # # #     #   # #     #   # # #   # # # #     # #   # # #
# ### # # ### ### # ##### # ######### ##### ##### # # # ### # ##### ######### ####### ##### # # ### ### # ### # ### ### # # # # # # # # ### # # ##### #
# #   #   # #   # # #   #   #   #     #   # #     # # # #   # #     #       #     # # #     # #       # #   # # # #     # #   #   # # # # # #   #   # #
# ####### # ### ### ### ####### # ### ### # # ##### # # ### # ##### # ##### ##### # # # ############### ### # # # ####### ######### # # # # # ### # # #
#       #   # #     #     #     # # # #   #   # #   # #   #   #   # # #   #   # # #   # #       #   #     # # # #                 # # #   # #   # # # #
# ### ##### # ####### ### # ### # # # # # ##### # ### ### ##### # ### # # # # # # ##### # ### # ### # ##### # # # ####### ######### # ##### ### # # # #
#   #       #         #     # # # #     # #     #   #   #     # # #   # # # #   # #   #     # #   # #     # # # #   #     #         #   #   # #   #   #
### ################# ####### # # ####### ### # ### # ####### # # # ### # # ### # # # ### ### ### # ##### # # # ### # ### # ########### # ### ####### #
# # #   #           #   #     # # #     # #   #   # # #     #   #   #   # # #   #   #   # #   #         # # #     # # #   # #         # #   #       # #
# # # # ##### ##### ### # ### # # # ### # # ##### # # # ### ######### ##### ########### # # ############# # ##### ### # ### ### ####### ### # ##### # #
# #   #     # #   # #   #   # # #   #   #   #   # # #     #         #     #           # # # #             #   #       # # #   # #       #   #     # # #
# ######### # # ### # ##### ### ##### ####### # # # ####### ### ### ##### ##### ### ### # # # ########### ### # ####### # ### # # ####### ####### # # #
#         #   #     #     #     #   #   # #   # # #       #   #   #     #   #   #   #   # # # #   #     #   # #   #   # # #   # # #       #       # # #
# ############# ##### ### # ##### # ### # # # ### ####### # ##### ##### ### # ### ### ##### # ### # # # ### # # ### # # # # ### # # ####### # ##### # #
#           # #     # #   #   # # #   # #   #     # #     # #     #   # #   #   # #   #     #   #   # # #   # # #   # #   # #   # #     #   # #   # # #
# ####### # # ##### ### ##### # # ### # ######### # # ##### # ##### ### # ##### ### ### ####### ##### # # ### # # ### ##### # ### # ### ### ### # ### #
#     #   #   #   #     # #   #     # #         #   #     # # #   # #   # #   #     #   #     #   #   # # # # # # # #       #   # # # # #   #   #     #
##### # ### ### # ####### # ######### ######### ######### # # # # # # ### # # ####### # # ### ### # ### # # # ### # ########### # # # # # ### #########
#     # #   #   #   #     # #     #   #       #   #       # # # #   # #     #   #     #     # #   #   # #   #     #     #     # # #   # #   #   #     #
####### # ### ### # ### ### # ### # ### # # ##### # ####### # # ### # ####### # ######### ### # ##### ### ######### ### ### # # # ### # ### ### # ### #
#       #   # #   #     #   #   #   #   # # #   #   # #     # # #   #         #   #     # #   #     #     #   #     # #   # # # #   # # #     # #   # #
# ########### # ####### # ##### ##### ### ### # ##### # ##### # # ############### # ### # # # ##### ### ### # # ### # ### # # # ### ### # ##### # # ###
# #           #   #   # #     #       # #     #       # #     # # #   #           # #   # # # #   #   # #   #   #   #       #     #     #       # #   #
# # ############# # # ####### # ####### ########### # # # ##### ### # # ##### ##### # ### # ### # ### ### ####### ### ################### ####### ### #
#   #   #       #   #       # # #       #         # # # # #     #   #   #   # #     # # # #     #   #     #     #   # #   #           # #   #     # # #
# ### # # # ############# ### # # ##### # ####### ### # # # ### # ####### # # # ##### # # ######### ####### ### ### ### # # ####### # # ### # ##### # #
#   # # # #       #     #   # # #   #   # #       #   # # #   #   #   #   # #   #   # #           #         #   #   #   # # #     # #   #   # #     # #
### # ### ####### # ### ### # # ### # ### # ####### ### # ##### ### ### ### ##### # # ### ############### ##### # ### ### # # ### # ### # ### ##### # #
# # #     #     #   #     #   #     # #   #     #       #     #     #   # #     # # #   # #     #       #     # #   #   #   # #   #   # # #         # #
# # # ##### ### ##### ### ##### ####### ####### ##### ####### ####### ### ##### # # ### # # ### # ##### # ### ##### ### ##### # ##### ### ####### ### #
#   #     #   #       # #     # #     # #       #   #   #   #         #     #   # #   # # # #     #     #   #     #   # #     #   # #   #       # #   #
# ##### ##### ######### ##### ### ### # # ####### # ### # # ############# # # # # ### # # # ####### ##### ##### # # # # ##### ### # ### ####### # # ###
# #     #     #     #         #   # #   # #       # #     # #     #       # # # #   # # # #     #       # #   # # # # #   #   #       #     #   # #   #
# ####### ##### # ### ######### ### ##### # ####### ####### # # ### ### ### # ##### # # ##### # ####### ### # ### # # ### # ######### ### ### ####### #
#     #   #   # # #   #     # #   #       #   #   #       # # #     #   # # #       # #     # #   #         #     # #   # #     # #   # #     #       #
##### # ### # # # # ### # # # # # # ######### # # ####### # # ####### ### # ######### ##### ##### ######### ####### ##### # ### # # ### ######### ### #
#   #   #   # # #   #   # # # # # #         # # #         # # #       #         #     #   # #     #   #   # #     #       # # # #   #       #     #   #
### ######### # ######### # # # # ######### # # ########### ### ####### ######### ##### # # # ##### # # # # # ### ######### # # ### # ##### ### ### ###
#           # # #       # # # # # #     #   # #     #   # #     #     #     #   # # #   #   #       #   # # #   #     #   # # #   #   # #   #   #     #
# ######### # # # ##### # # # # # ### # # ### ##### # # # ####### # ####### # # # # # ####### ########### ##### # ### ### # # ### ##### # ### ####### #
#   #     # # # #   # #   # #   # #   # #     # #   # # # #     # #     #   # #   # # #     # #   #     #   #   #   #   #       # #     # # #     #   #
# # # # ### # # ### # ##### ##### # ### ####### # ### # # # # ### ##### # ### ##### # # # # # # # # ### ### # ##### ### # ####### # ### # # # ### # ###
# # # #   #   #     #     #     # #   # #     # #     # #   #     #   #     # #   #   # # # # # # #   #   #   #   # # # #   #     #   #   # # # # #   #
### # ### ### ####### ######### # # # ### # # # ####### ##### ####### ####### # ### ### # ### ### ### # # ##### ### # # ##### ####### ##### # # # ### #
#   # #     # #   #     #       # # #   # # #         #     # #           #   #   #   # #   #   #     # #   #   #   # #       #       # #   # # #   # #
# ### # ##### ### # ### # ####### # ### # # # ####### ##### # ##### ##### # ##### ### ##### ### # ##### # ### # # ### ######### ####### # # # # ### # #
# # # #           # # #   #       #   #   # # #     #   #   #       #     # #       #     # #   #   # # # #   # # #     #       #     # # #   #   # # #
# # # ############# # ######### ##### ##### # # ### ### # ########### ##### # ########### # # ##### # # ### ### # # # # # ######### # # # ##### # # ###
# #           #   # #         # #     #   # # #   # # # #   #     #   #     # #           # #   #   # #     #   # # # # # #     #   # # # #   # # #   #
# ### ######### # # # ### ### # # ####### # ##### # # # ### ### ### ### ##### # ########### ### ### # ####### # # ### ### # ### # ### # # # # # # ### #
#   # #         #   # # #   #   #     #   # #     # #   #   #   #   #   #     #       # #     #   #     #     # #   #   #   # #   #   #     #   # #   #
# # ### ############# # ### ######### # ### # ##### ##### ### ### ### ### ### ####### # # # ##### ##### # ##### ### ### ##### ##### ########### ### # #
# #     #   #       #   #   #   #   # # #   # #   #       # #     #   # #   # #       # # #     #   #   # #   # # #   #           #           # #   # #
# ######### # ##### ### # ### ### # # # # ### # # ######### # ##### ### # # ### ####### # ##### ### ##### # ### # ### ### ### ############### ### ### #
#     #     #     #     # #       # # # #     # #       #         #   #   #     # #     #     #           #         #   #   #         #     #   # #   #
##### # ### # ##### ##### # ####### # # ######### ### # ############# # ######### # ### ### ##################### ##### ### ##### ### # ### ### # #####
#   # #   # # #   #   #   # #     # # #         # #   #   #     #     # #         # #   #   #       #   #       # #     # #   # # # #   #     # # #   #
### # # # ### # # ##### ### # # # # # ##### ### ### ##### # ### # ##### # ##### ### # ### ### ##### # # # ##### # # ##### ### # # # # ####### # # # # #
#   # # #     # #       # # # # # # # #     # #   #     #   # #   #   # # #   #     #     # #   # #   # # #     # #   # #   # # # #   #     # # #   # #
# ### ######### ######### # # # ### # # ##### ### ##### ##### ####### # ### # ##### ####### ### # ##### # # ##### ### # # # # # # # ### ### # # ##### #
# #   #       # #     #   # # #   # #   #         #   # #     #       #     #     #         #   # #   #   #     #   # #   # #   # #   #   # # # #   # #
# # ### ##### # ##### # # # ##### # ##### ######### # # # # ### ### ############# ### ##### # ### # # ######### ##### # ### ### # ####### # ### # # # #
# # #   #   # #   #   # # #     # # #   #   #   #   #   # #   # # # #     #     #   # #   # # #     #           #   # # #   #   #   #     #     # #   #
# # ### # # # ### # ### # ##### # # # # ### # # # ####### ### # # # # ### # ### ### ### # ### # ################# # # # # ### ##### # ########### ### #
#       # #       #     #         #   #       #   #         #     #     #     #         #     #                   #   # #         #               #   #
#######################################################################################################################################################
