#####################################################################################################
#       #     #       #         #     # #       #                   #   #           #   #   #       #
####### # # ### ### # # ### ### ### # # # ### ### ##### ########### # # # ######### # # # # # ##### #
#       # # #   # # # #   #   #   # #   # # #     #   #   #           #   #       # # #   #   #   # #
# ####### # # ### # ##### ### ### # ##### # ####### ##### ########### ##### ##### # ######### # # # #
# #     # # #     #       #   #     #     #   #     #     #         # #     #     #     #   #   # # #
# # ##### # ##### ######### # ####### ##### ### # # # ##### ####### ### ##### ######### # # ##### # #
# #       #     # #   #     # #     # #   #     # # # #     #     #     #   # #       # # #   #   # #
# ### ######### # ### # ### ### ### # # # # ##### ### # ##### # ########### # ##### ### # ### ##### #
#   # #         # #   #   # #   #   # # #   #   # #   #     # #             # #   #   #   #   #     #
### # # ####### # # ##### ### ### ### ####### # # # ####### # ##### ### ##### # # ### ##### ### ### #
# # # # #     # # # #     #   # #   #       # # # #     #   # #   # # # #   # # #     #   #     #   #
# # # # ##### # # # # ##### ### ### ####### # # # ### # # ##### # # # # # # # # ##### # ######### ###
#   # #     #   # # # #     #     #     #   # #     # # # #   # #   #   # #   #   #   # #     #   # #
# ####### # ##### # # # ######### ##### # ### ##### # # # # # # ##### ### ####### # ### # ### # ### #
#       # # #   # # #   #       #     # # #   #   # # # # # #   #   # #   #       #     # # #   #   #
####### ### # # # # ##### # ### ##### # # # # # # ### ### # ##### # ### ##### ##### ##### # ####### #
#     #   #   #     #     # # # #   # #   # #   #   #     #       # #   #     #   # #     #         #
# ####### ######### ####### # # # # # ##### ####### ####### ####### # ##### ### # # # ######### ### #
#         #     #   #   #   # #   # #   #   #     # #       #     # # #   # #   # # # #       # #   #
# ######### ### # ### # # ### ##### # # # ### # ### # ####### ### # # # # # ### # # # ##### # # # ###
# #       # #   #     #   #       #   # # #   # #   # #     # #   # #   # #   # #   #     # #   #   #
# ### ### # # ############# ##### ##### # # ### # ### # ### ### # # ##### ### ########### # ####### #
#     # #   #     #   #       #     #   #   #   #   # # #       # #     #   #           # # # #     #
####### ######### # ### ####### ##### ##### ##### # # # ############# # ### ####### ##### # # # #####
#   #     #     # #     #     #     #   #   #   # #     #   #     #   #   #       #     # # # #     #
# # # # ### ### # ### ### ### # ### ### ##### # # ####### # # ### # ##### ####### # ### # # # ##### #
# # # #     # # #   # # #   # #   #   #   #   # #   #     #   # #   #   # #   #   # #   # # #       #
# ### ####### # ### # # ### # ####### ### # ### ##### ######### ####### # # # # ##### ### # # #######
# #   #       #     #     # #           #   # #     # #         #       # # #   #     #   # #       #
# # ### ##### ####### ##### ################# ##### # ####### # # ### ### # ####### ### ### ####### #
# #   # #   #     #   #   #         #       #   #   #       # # #   #     # #     #   #     # #   # #
# ### # # # ##### # ### # ### ##### # ### # # # # ### ##### # ##### ####### # ### ### ####### # # # #
#   # # # #       #   # #   #     #     # # # #   # # #   # #     #   #     #   #   # #       # #   #
### # # ##### ######### ### ##### ####### ### ##### # # ### # # ##### # ### ### ### # # ##### # #####
#   # #     #           #   #   #   #     #   #         #   # #       # # #   # # # # #   #   # #   #
# ### ##### ############# ##### ### # ### # ############# ############# # ### # # # # ### # ### # # #
# #   #     #   #       #     #     #   # # #           # #         #   #   # # # # #   # #     # # #
# # ### ##### ### # ######### # ##### # ### # ######### # # ####### # ### # # # # # # # # ####### # #
# # #     #   #   #         # # #   # #   #   # #       # #       #   #   #   #   # # #   #       # #
# # ##### # ### ####### ##### ### # # ### ##### # ##### # ##### # ##### ####### ### # ######### # ###
# #   #   #   #     #   #   # #   # #   #       # #   #   #   # #   #   #       #   #   #     # #   #
# ### # ### # ### ### ### # # # ### ##### ####### # # ##### # # ### ##### ####### ##### # ### ##### #
#   #   #   #     #   #   #   #   #     #   #     # # #     # #   #       #     # #   # # # # #   # #
### ##### ######### # # ######### ##### ### # ##### # # ##### ### ########### # # # ### # # # # # # #
#     # #     #     # #     #     #   #   #   # #   #   #   # # #     #   #   # # #   #   # #   # # #
# ### # ##### # ########### # ##### # ### # ### # ####### # # # ##### # # # ##### ### ##### ##### # #
#   #     #   # #         #   #     #   # #     #   #   # #   #     # # #   #   # #       #     #   #
# # ####### ### # ##### # ##### # ##### # # ##### # # ### ##### # ### # ##### # # # ####### # ##### #
# #       # # #   #     # #     # #     # # #   # # #     #   # #   #   #     # # # #       #       #
# ####### # # ##### ### ### ##### ##### # # # # ### # ##### ### ### ### # ##### # # # ###############
#     #   #   #   #   # #   #   #     # # # # #     #   #       # # #   # #       # #   #     #     #
# ##### ##### # # ### ### ##### ##### # # ### ######### ### ##### # # ### # ####### ### # ### # ### #
# #     #       #   # #   #         # # #     #       #   # #     #   # # #   #   # #   #   #   #   #
### # ### ########### # ### # ####### ######### ### # ### # # ### ##### # ##### # # # ##### ##### ###
#   # #       #       # #   # #     #         #   # # #   #   # # #     #       # # # #   #   # # # #
# ##### ####### ####### ##### # ### ######### ### # ### ####### # # # ########### # # # # # # # # # #
#       #     # #     # #   # #   #   #         # #   # #       # # #           # #   # # # # # # # #
# ####### ### # # ### # # # # # ### # # ######### ### # ### ### # ####### ####### # ### # ### # # # #
#     # # #     # #   #   # # # #   # #     #       # #   #   # #       #   #     # #   #     #   # #
##### # # # ##### # ####### # # # ### ##### # ####### ### # # ######### ### # ##### # ######### ### #
#   #   # # #     # #   #   #   # #     #   # # #     #   # #   #     #     # #   # #       #   #   #
# # # ### # # ##### # # # ### ### # ##### # # # # ### # ##### # # ### ##### # # # # # ##### # ### # #
# #   #   # #     # # #   #   #   #   #   # #   # #   # #   # #     #       #   # # #   #   #   # # #
# ##### ##### ##### # ##### ### ##### # ####### # ##### # # # ########### ##### # # ##### ##### ### #
#   # #       #     # #   # #   #   # # #       #     #   # # #   #     # #   # # #     # #       # #
### # ######### ##### # ### # ### # # # # ########### ##### # ### # ### ### # # # ##### # ####### # #
#   #         #     # # #   # # # #   #   #   #       # #   # #   # # #     # # # #   # #       #   #
# ########### ##### # # # ### # # ########### # ##### # # ### # # # # ####### # # # ### # ##### ### #
#                 #   #   # # # #   #       # #   # #   # # # # # # #       # # # # #   #     #   # #
################# ##### ### # # ### # ##### # ### # ### # # # # ### # ##### # ### # # ####### ### # #
#         #     #   # # #   # #   # #   #     #   #     # # # # #   # #   # # #   # #       #   # # #
# ####### # ####### # # # ### # ### # # ####### ##### ### # # # # ### # # ### # ### ####### ##### # #
# #   #     #       #     #   #     # #       # #   #   # #     # #   # # #   # # #       #     # # #
# # # ####### ############# ### ############# # # # ##### ####### # # # # # ### # # ##### ##### # # #
# # #     #   #         #   # # #           # #   #       #   #   # #   #   #   # #     #     #   # #
# # ##### # ### ####### # ### # ##### ##### # ############# # # ### ######### ### ##### # ######### #
# #   # # #   #   #     #   # #     #     # #         #     # # # # #         #     #   # #     #   #
# ### # # ### ### ##### ### # ##### ##### # ### ##### # ##### # # # ######### # ### # ### # ### # ###
#       #   #   #     #   # # #     #     #   # #   # #   #     #   #         # #   # #   # # #   # #
# ######### ### ### # ### # # # ##### ####### # # # # # # ####### ### ######### # # # # # # # ##### #
#     #       #   # # # # # # #     #   #   #   # # # # #   #   #     #     #   # # # # # # #   #   #
##### # ##### ### ### # # # # ##### # # ### ####### # # ### # # ####### ### ##### ### # ### # # ### #
#   # # #   #   #     #   # # #     # #   #         # #   # # # #       #         #   #   # # #     #
# # # # # # ### ####### ### # # ##### ### # ##### ### # ### # ### # ########### ### ##### # # ##### #
# #   # # #   # #   #   #   #     #   #   #     # #   # #   # #   #   #     # # #   #   # #   # #   #
# ##### # ### # ### # ### # ##### ### # ####### # # ##### ### # ##### # ### # # # ### # # ##### # ###
#     #   #   # #   # #   #     #   # #     #   #   #     #   # # #   # #   #   # #   # #       #   #
##### ##### ### # # # ### ##### ### ##### # ####### # ##### # # # # ### # ####### ##### ### ### ### #
#   # #   #   # # # #   # #     #   #   # #       # #     # # #   #   # #   #     #     # #   #   # #
# # ### # ### # # ##### ### ##### ### # # ####### # # ### ### ### ### # ### # ##### ### # ### ##### #
# #     #     # #     #   #   # #     # #     # # # #   # #   #   # # #   #   #     # #   # #     # #
# ############# ### # ### ### # ####### ##### # # # ##### # ### ### # ### ##### ### # ### # ##### # #
#         #   #   # #   #     # #       #       # #       # #   #   #   #     #   # #       #     # #
# ####### ### ### # ########### # ############# # ######### # ### # ### ##### ##### ####### # ##### #
# #     #   #     # #     #   #   #         #   #     # #     #   #   #     #     #     #   #   #   #
# # # # ### ##### # # ### # # # ####### ### ######### # # ####### # # ### ####### ##### # ##### # ###
# # # # # # #   #   #   # # # #         # # #     #   # #       # # #   #       #   #   #   # #   # #
# ### # # # # # ####### # # # ########### # # ### # ### ####### ### ### ### ####### # ##### # ##### #
#     #   #   #         #   #                 #     #               #     #           #             #
#####################################################################################################
