###############################################################################################################
#     #   #           #       # #               #         #             #     #       #       #     # #       #
##### # # ### ####### ##### # # # ### ####### ### ####### # ##### ##### ### # ##### # # # ### # ### # # ##### #
#   # # #   #     #   #     # # # # # #   #   #   #     # # #   # #   #   # # #   # # # # # # # #     #   #   #
# # # # ### ##### # ### ##### # # # # # # # ### ####### # # # # # # # ### # # # # # # # # # # # ####### ### # #
# # # #   #     # #   # #   # # # # #   # # # # #   #   #   # # # # #   #   #   # # #   # #     #   #   #   # #
# ### # # ##### # ### # ### # # # # ##### # # # # # # # ##### # # ### # ######### ### ### # ##### # # ### ### #
# #   # # #       #   #   #   #       # # #   # # #   #       # #   # #     #   #   # #   #   #   #   #   # # #
# # ### # # ######### ### # ######### # # ##### # ############# ### # # ##### # ### ### ##### # ####### ### # #
#   #   # # #       #   # #         # # #   #   # #   #       #   # # # #     #   #     # #   # #     # #     #
# ### ### ### ##### ### # ######### # # ### # ### # # # ##### ### # ### # ####### # ##### # ### # ### # # #####
# #     #         #   #   #   #     # #   #   #   # #     #     # #   #   # #   #   #   #   # #   #   # # #   #
# # ################# ##### # # ##### # # ####### ######### ### # ### ### # # # ### # # ### # ##### ### ### # #
# # #         #     #   #   # # #   #   #         #       # #   # # #   #   # #   # # #   #     #   #   #   # #
# ### ####### # ### ### # ### # # # # ############# ##### # ##### # ### ##### ### ### ### ####### ### ### ### #
# #   #     # #   #     # #   #   # # #         #   #     # #     #   # #     # #       # #       # #       # #
# # ####### # ### ######### # ##### ### ####### # ### ##### # ##### # # # ##### ######### # ####### ####### # #
# #   #     #   #   #       #     # #   #     #   #   #     #       # # # #         #   #   #         #   # # #
# ### # ####### ### # ########### # # ### # # ##### ##### # ######### # # # ######### # # ### # ####### # ### #
#     # #     #     # #     #   # #   #   # # # #   #     #   # #     #   # #   #     # #     # #       # #   #
####### # # ######### # ### # # ####### ### # # # ### # ##### # # ######### # # # ##### ### ##### ####### # # #
#         #         # # # #   #   #   # #   #   # #   # #       # #         # # #   # #   # #     #     #   # #
# ############# ### # # # ####### # # # # ####### # ### ### ##### # ### # ### # ### # ### ### ######### ##### #
# #       #   # #     #         #   # # #       # #   #   # # #   # #   # #   #     #     #   #       #     # #
# ### ### # # # ####### ####### ##### # ####### # ####### # # # ### # ### # ### ##### ##### ### # ### # ### # #
# #   #   # # # #   #   #     # #     #       #   #     # #   #   # #   # # # # #   #     #   # # #   # #   # #
# # # ##### # # # # # ### ### # # ########### ##### ### # ### ### # ### # # # # # # ##### ### # # # ##### # # #
#   # #     #   # #   # #   # # #     #     #       #   #   # #   # #   # # #   # # #   #     # # # #     # # #
##### # ######### ##### ### # # ##### # # # ######### ### # ### ### # ### # ##### # # # ######### # # ##### # #
#     # #         #       # # #   #   # # # #       # #   #     #   # #   #   #   # # # #         #   # #   # #
# ##### # ######### # ### # # ### # ### # ### ### ### # ######### ### # ##### # ### ### # ##### ####### # ### #
#   #   # #   #   # # #   # # #   #   # #   #   #   # # #           # #   # # # # # #   #   # #   #         # #
# ### # # # ### # # # ##### # ### ### # ### ### ### # # ########### # ### # # # # # # ##### # ### ### ####### #
# #   # # #     #   # #     #   # #   #   #   # # # # #         # # #   #   #   # # #           #   #   #     #
# # ##### # ######### # ####### ### # ### # ### # # # ######### # # ### ### ##### # ############### ### # #####
# #       # #       # #     #       # #   # #     # #   #     # #     # #         #         #     #   # # #   #
# ######### ### # ### ##### # ####### # ### # ##### ### # ### # ####### ######### ######### # ### ### # # # ###
# #   #   #   # # #     #   # #     # #   #   # #     # #   # #       # #       #   # #   # #   #     # # #   #
# # # ### ### # ### ### # ### # ### ##### ##### # # ### ### # ####### # # ##### ### # # # # # # ####### # ### #
#   #   #   # # #   #   # # # # # # #     #     # # #   # # #         # # #   #   # # # #   # #     # # #   # #
####### ### # # # ####### # # # # # # ##### # # # ### ### # ########### # # ##### # # # ########### # # ### # #
#     # #   #   #       # #   #   # #   #   # # #   #   # # #       #   # #       #   # #           #     #   #
# # ### # ##### ####### # ####### # ### # ### # ### ### # # # ##### # # # ### ######### # ####### ##### ##### #
# #     #   #   #       #       # #   # # #   # #   #   # # # #       # #   # #         # #   #   #   # #     #
# ######### # ### ##### ####### # # ### ### # ### # # ### # # ############# # ##### ##### # ### ### # ### #####
# #     #   # # #   #   #       # #     #   # #   # # #   # #           #   #       #     #     #   #   #   # #
# # ### # ### # ### ### # ### ### ####### ### # ##### ### # # ######### # ############### # ##### ##### ### # #
#   # # #   # #   #   # #   # #   # #     #   #     #   # # # #         #     #         # # #   # #   # #   # #
##### # # # # # ##### # ### ### ### # # ### ####### ### # # ### ########### # ### ##### # # # ### # # # # ### #
#     # # # # #     # #   #   # #   # # #     # #     # #       #         # # #   #   #   #   #   # # #   #   #
# ### # ### # ### ### ####### # # # # # ##### # # ### # # ####### ####### ### # ### # ####### # ##### ####### #
# #   #   #       #   #     #   # # # #   #   # # #   # #   #     #           #     #     # # #     #         #
# ####### # ####### ### # # ####### # ### # ### # ##### ### # ################# ######### # # ##### ##### ### #
#   #     # #     #     # #   #   # #   # #   # #     #   # #         #     #   #     # # # # #   #   #   # # #
# # # ##### # ### ### ### ### # # # ### # ### # ##### ### # ######### # ### ### # ### # # # # ### ### # ### # #
# # # #     #   #   #   # #   # # #     #   #   #   #   # #     #     # # #   #   # # # # #   #   # #   #     #
### # ######### ### ##### # ### # ######### ##### # ### # ### ### ### # # ### ##### # # # ### # # # ##### #####
#   #           # #   #   # #   #           #   # #   # #   # #   #   # # #   #     # # #   #   #   #   #     #
# ############### ### # ### ### ##### ####### # # ### # ### # # ### ### # # ####### # # ### ####### # # ##### #
#         #         #   # #   #     # #     # #   # # #   # # # #     #   # #       #   # #   #   # # # # #   #
# ### ##### ### ######### ### # ### # # ### # ##### # ### # # # ######### # ### # ##### # ### # # # # # # # ###
#   #       # #           #   #   # # #   # #   # #       # # # #         # #   # #   #     #   # #   #   # # #
### ######### ########### # ####### ### ### ### # # ####### ### # ######### # ##### # ##### ##### ####### # # #
# # #               # #   # #     #     #     # # #   #   #   #   #       # #       #     #   # # #   #   #   #
# # ######### ##### # # ### # ### # ##### ##### # ### # # ### # ### # ##### ##### ####### ### # # # # ####### #
# #   #   #   #       #   #   # # # #     #   # #   # # #     # #   # #     #   # #     #   #   #   # #     # #
# ### # # # ######### ### ##### # # # ##### # # # ### # ####### ### ### ##### # ### ### # # ### ##### # ### # #
#   # # # # #     # # # #   #     # #   #   #   # #   # # #   #   # #   #     #     #     #   #   #   #   #   #
### # # # # # ### # # # ### # ##### ### # ####### # ### # # # ### # # ### ##### ################# # ##### #####
#   # # # #     # #   #   # # #     #   #   # #     #   #   #   # # # #       # #   #         #   # #   #     #
# ### # # ####### # ##### # # # ##### # ### # # ##### ### ##### # # # ### ### # # # # ####### # ### # # ##### #
#   # # #     #   #     # #   #   #   #   # #   #   # #   #     # # #   #   # # # #   #   #   # #   # #   #   #
# # # # ##### # ####### # ##### ### ### ### ##### # # # ### ##### # ### ### # # # ##### # # ### # ### ### # ###
# # #   #   #   #     #     #   #   #   #   #     #   #   #       # #   #   # # #     # # #   # #   #   # # # #
### ##### ######### ####### # ### ### ### # # ########### ######### # ##### # ####### # # ### # ### # ### # # #
#     #           # #       #   # # #   # # #         # #       #   #     # # #       # #   #     #   #   # # #
# # ### ### ##### # # ########### # ### # ########### # ####### # # ##### # # # ####### # # ########### # # # #
# # #   # #   # # # #   # #       #   # #         # # #           # # #   # #   #     # # # #   #   #   # # # #
# ### ### ### # # # ### # # # ##### # # ### ##### # # ####### ##### # # ### ####### # ### # # # # # # ##### # #
#       # #   #     #   #   #   #   # # # #   # # # #       # #   #   # # #   #     #     # # #   #   #     # #
####### # # ### ##### ######### # # ### # ### # # # ####### ### # ##### # ### # ########### # ####### # ##### #
#     #   # #   #               # #     # #   # # #       #   # #       #   #   #   #       # # #     # #     #
# ### ### # ### # ############### ####### # ### # # ######### # ######### # ##### # # ####### # # ##### # ### #
# # # #   #   # #   # #       #   #   #   # #   #   #     #   #       #   # #     #   #   #   # # #     #   # #
# # # ####### ##### # # ##### ### ### # # # # ##### # ### # ### ##### # ##### ######### ### ### # # ####### # #
# #           #   #   #     #   #   #   # # #     # # # #   #   #   # # #   #   #     #   # #     # #       # #
# ########### # # ### ##### ### ### ##### # # # ### # # ##### ##### # # # # ### ### # ### # ##### # ######### #
#   #         # # #   #     #     #       # # #     # #     #       # #   #   #     #     #     # # #         #
### ##### ##### # # ### ######### ######### # ####### ### # ######### ####### ########### ##### # # # ####### #
#   #   # #     # #   #       # # #         # #       #   #       #   #     #           # #   # # #   # #     #
# ### # # # ##### ### ####### # # # # ######### ####### ######### # ### ### ### ##### # # # # # ####### # #####
#     # # #   #   #   # #   # #     # #       #   #     #     #   # #   # #   # #   # # #   # #         #     #
# ##### # ### # ### ### # # # ######### ##### ### # ######### # ### # ### ### # # # # ####### ### ##### ##### #
#     # # #   #     #     # #       #       #   #   #         #   #       #   #   # # #     # # # # #   #   # #
##### # ### ######### ##### ####### # ####### ####### ### ### ### ### ##### ####### # # ### # # # # # ### # # #
#     #   #     #         # #     # #   #   # #   #   #   #   # #   # #     #       #   #   #   # #   #   #   #
######### ##### ### ####### # ### # ### # # # # # # ### ### ### ### # # ##### ########### # ### # # ### #######
#       #     #   # #       # #   #     # # # # #   # #   #     # # # #     # #         # # #   # # #   #     #
# ##### ### ##### # # ### ### # ####### # # # # ##### ### ##### # # # ##### # # ####### # ### ### ### ####### #
# #       #     # # #   # #   #       # # #   #       #   #     # # #   #   # # #     # #   # # # #   #   #   #
# ####### ##### # ### # ### # ####### ### ### ####### # ####### # # ### # ##### # ##### ### # # # # ### # # # #
# #     #   #   #   # # #   # #   #       # # #   #   #       #   #   # #         #     #   # # #   #   # # # #
# # ### ### # # ### ### # ##### # ######### # ### # ######### # ##### ############# ##### ### # ##### ### # # #
# # #   #     #   #   # #       # #     #         # #     # # # #   # #           # #     #   #         #   # #
# # # ############### # ######### # ### ########### # ### # # ### # # # ######### # ### ### ### ####### #######
# # #     #         # #       #   # #   #           #   #   # #   # # #     # #   #   #     # #   #   #       #
# # ##### # ####### # ####### # ### # ### ########### # ### # # ### # # ### # # ##### ### ### ### # ######### #
#   #   #   #     #   #       #     #   #         #   # #   #   # # # # #   # #     #   #   #       #       # #
# ### # ######### ##### ##### ######### ######### ##### # ####### # # ### ### ##### ### ### ######### ##### # #
#     #                 #             #                 #         #       #             #             #       #
###############################################################################################################
