#######################################################################################################################################################
#   #             # #           # #       #     #         #     #       #         #     #           #   #                   #   #     #   #           #
### ########### # # # ### ##### # # # ##### # # ##### ### ### # ##### # # ####### ### # # ####### # # # # ######### ####### # # # # # # # ##### #######
# #     #       # #   #   #     #   #     # # #   #   # #     #   #   # #     #       # #   #   # #   #   #     # #   #     # # # # #   #       #     #
# ##### # ####### ##### ### ######### ### # # ### # ### ######### # ### ##### ########### ### # ### ####### ### # ### ### ##### # # ####### ##### ### #
#     # # #     #     # # # #   #   # # #   #   #   #   #         # #       #   #         #   #   #         # # #   #   # #   #   # #   #   #       # #
# # ### # # ### ##### # # # # # # # # # ####### ##### # # ######### # ##### ### # ######### ##### ########### # ### ### # # # ### # # # ##### ####### #
# # #   # # # #   #   # # #   #   # #     #     #     #   #   # #   # #   #   #   #       #   # # #   #   #         # # #   #   # #   #       # #     #
# ### ### # # ### # ### # ######### ##### # ##### ######### # # # # ### # ### # ### ##### ### # # # # # # ######### # # ####### # ########### # # ### #
#   #   # # #     #     # #       # # #   # #   # #       # # #   #   # #   # #     #   #   # #     #   #   #   #     # #       #     #     #   #   # #
# # ### # # # ########### # ##### # # # ### # ### # ### # # # ####### # ### # ####### # ### # ############# # # ##### # # ######### ### ### ##### # # #
# #   #   # #     #     #   # #   # #   #   #     # #   #   #       #     # #   #     # #   #         #   #   #   #   # #   # #     #   # #     # # # #
##### ##### ##### # # ### ### # ### ##### ### ##### # ############# ####### ### # ### ### ########### # # ####### # ### ### # # ##### ### ##### ### # #
#         #   #   # #         #   #       # # # #   # #           #       #   # #   #   #     #   #   # # #     # #   # # # # # # #   #       # #   # #
# ######### # # ### ############# ######### # # # ### ####### ########### ### # ### ### ##### # ### ### # # ##### ##### # # # # # # ### ### ### # ### #
# #         # # #       #   #     #           #     #   #   #   #       #     # #   #       #   #   #   #   #   #       #   #     #   #   #   #   #   #
# # ######### # ######### # # ### # ################### # # # # # # ########### # ### ### ### ### ### ####### # ######### ####### ### ### ### ##### ###
# # # #     # #           #   # # #     #   #           # # # #   # #         # #   #   # #   #   #   #   #   #     #     #     #   # #   #   #   #   #
# # # # # # # ### ############# # ##### ### # # ####### # # ##### # # ####### # # ##### ### ### ### ### # # ### ### # ##### ### ##### # ### # # ##### #
#   # # # # # #   #         #     #   # #   # #   #     # #     # # # #     # # # #   # #   # #   #     #   #   # # # #     # # #     # #   # # #   # #
# ### # # ### # ### ####### # ##### # # # # # ### ##### # ##### # # # # ##### # ### # # # ### ### ####### ### ### # # ##### # # # ##### # ### # # # # #
# #     # #   # #   #   #   # # #   #   # # # # #     # # #   # # #     #     #   # # # #     #   #     # #   #   # #   #   # #   #     #   #   # #   #
# ####### # ##### ##### # ### # # ####### ### # ##### ### ### # # ##### # # ##### # # # # ##### ### ### ### ##### # ### # ### ############# ##### #####
# #       #       #     #   # # #   #     #   #   # #         # # #   # # # #     # # #   #     #   #       #     # # # # #                 #     #   #
# # ##### ########### # ### # # ### # ##### ### # # ########### # # # ### ### ##### # # ### ##### # ######### # ### # # # ### ### ##### ##### ##### # #
#   #   #   #       # # #   #   # # # #     #   # #   #     #   # # #   # #   #     # # # #   #   #   #       #   # # #   #   # # #   # #     #     # #
##### ##### # # ### # ### ##### # # # # ##### ### # ### ### # ##### ### # # ### ##### # # ### ####### # ##### ### # # ##### ### # # # ### ##### ##### #
# #       # # # #     #   #   #   # # # #     # #   #   # # #     #   #   # # #   #   # # #   #       # #   # # # # #       #     # #     #     #     #
# # ##### # # # ####### ### # # ### # # ### ### # ### ### # ##### # # ##### # # # ### # # # ### ####### # # # # # # ### ##### ##### ####### ### ### ###
#     #   # # #     #   #   #   #   # #     #   # #   #   #       # #     # #   #   # #   #   #   #   # # # # # #   #   #   # #   #     # # # #   #   #
####### ### ####### # # ####### # ### ####### # # # ### ################# # ### ### # ### ### ### # # # # # # # ##### ##### # # # ##### # # # ### #####
#       #   #       # # #     # # #     #     #   # #   #       #         #   # # # #   #   #   #   # # # # # #   #       # # # #   #   #   # #   #   #
# ### ### ### ##### # ### ### ### ### # # ######### # # # ### # ### ##### ### # # # ### ####### ### # ### # # # # ####### # # # ### # ### ### # ### # #
#   # #   #     #   # #   # #     #   # # #       # # # #   # #     #   #   # #   # # #       #   # #     # # # #         #   # #   # #     # #     # #
# # # # ### ### # ### # ### ####### ##### # ### ### # ##### # ####### ##### # ##### # ####### ### ######### # # ########### ### # ### ##### # ####### #
# # # # #   #   #   # # # #     #       # # #   #   #     # #   #   #   #   #   #   #   #   #   #       #   #   #   #   # # #   #   #   #   #   # #   #
### ### # ### ####### # # # # # ####### # ### ### ##### ### ### # # ### # ##### # ### # # # ### ####### # ####### # # # # # # # ### ### # ### # # # ###
#   #   #   #     #   # #   # # #     # #     #   #     #     #   #   #       #   #   #   #   #     #   #         # # # #   # # #     # # #   #   #   #
# # # ######### # # # # ##### # # ### # # ##### ### # ### ##### ##### ################# ### ####### # ### ######### # # # ##### ##### # # # ### ##### #
# # #     #   # # # # #   #   #   #   #   #   # #   #     #   # #   #                 #   #       #   # #         #   # # #   #   # # # # # #   #     #
# ####### # # ### # ##### # ####### ### ### # # ### ####### # # ### ############### # ##### ### # ##### ####### ####### # # # ### # # # # # # ### ### #
#       #   # #   #     #   #   # # # # #   # #   #   #     # #   #       #     #   #     # #   # #     #       #       #   #     #   # #   # #   # # #
# # ### ##### # # ##### ##### # # # # # # ### ### ### # ##### ### ##### # # ### # ####### ### ### # ### # ####### ########### ######### ####### ### # #
# # #       #   #   # # #     #   # # # # # # #   #   # #   # #   #     # # # #   #     # #   #   # # # #       # #         # #         #       #     #
# # ############### # # # # ### ### # # # # # # ### ### ### # # ### ### ### # ##### ##### # ### ### # # ####### # ### ##### # # ######### ####### #####
# # #   #         # # # # # #   #   #   # # #   # #   #   #   # #   #   #   #       #     #   # # #   #     #   #   # #   # # #           #     #   # #
### # # # ####### # # # # # ##### ####### # ##### ### ### # ### # ####### ### ####### ##### # # # ### # ##### ##### # # # # # ############# ### ### # #
#   # #     #     #   #   #     # #       #     #     #   # # # # #     #   #         #   # # #     # #     #   # # #   # #     #       #   # # # #   #
# ### ####### ####### ##### ### # # # ##### ### # ##### ### # # # # ### ### # ######### # ### ### ### ##### ### # # ########### # ##### # ### # # ### #
#   # #   #   #       #   # #   # # # # #   # #   #     #   #     # # #   # # #         #     # # #   # #     # # # #   #     # # #   #   # #       # #
# # # ### # ### ####### # ### # # ### # # ### ##### # ##### ####### # ### # # ### # ########### # # ### # ### # # # # # # ### # # # # ##### # ####### #
# #       # #   #       #     # #     # # #   #     # #   #     #   #   # # #     # #   #   #     #   # # #   #   #   #     # #   # #   #       #     #
########### # ### ####### ############# # # # # ####### # ##### # ### ### # # ####### # # # ######### # # ### ### ########### ####### ### ####### #####
#   #       # # #       # #             # # # #         # #   # #   # #   # # #   #   #   #         # # #   # #   # #       #       #     #     #   # #
# # # ##### # # ####### ### ######### # # # # ########### # ### ### # # ### ### # # ############# ### # ### ### ### # ##### # ##### ####### ### ### # #
# # #   #   # #       #     #       # #   # #   #   #     #   #     # # #   #   #   #     #     # #   #   #     #   # #     # #   #     #   # #   # # #
# # ### ##### ### ########### ##### # ##### ### # # # ##### # ####### # ### # ####### ### # ### # # ##### ######### # # ##### # # ##### # ### ### # # #
# #   #     #   # #         #   #   #   #   # #   # # #     #         # #   #   #     # #   # # #   #               # #   #   # #   #   #   #   #   # #
# ### ##### ### # # ####### ### # ##### ### # # ##### ### ####### ##### # ##### # ##### ##### # ####### ##### ##### # ### # ### ### # # ### ### ##### #
#   #       # #   # #     #     #     #   # #   #   #   #   #   #   #   # #   #   #     #     #   #     #   # #   # # # # #   # # # # #   #       #   #
### ####### # ### # # # ############# ### # # ### # ### ### # # ### # ### # # ##### # ### # # ### # ##### # # # # ### # # ##### # # # ### ####### ### #
#   #   # #   #   # # #     #   #     #     # #   #   # #   # #   # #   # # #       # #   # #   # #       # # # # #   # #     # #     # #   #   # #   #
# # # # # ### # ### ##### # # # # ######### ### ##### # # ### ### # ### # # ##### ### # ### ##### ####### # ### # # ### ##### # ####### ### # ### # ###
# # # # #     #   #     # #   #           # #   #       #     # # #   # #     #   #   #   #   #   #     # #   # #   #     #   # #     #       #   #   #
# ### # ####### ####### ################# # # ### ##### ####### # ### # ####### ##### # ##### # ### ### ##### # ##### ##### ### # ### ####### # ##### #
#     #         #       #       # #     # # #   # #   # #     # # #   #   #     #   # # #     #     #         # #     #         # # #     #   #       #
# ############### ####### ##### # # ### # ##### ### # ### ### # # # ##### # ### # # ### # # ######### ######### # ##### ######### # ##### ########### #
# #     #       #       #   # # #   #   #   #   #   # #   # # #   #         # # # #   # # # #       # # #       # #   #   #       # #   #   #   #     #
# # ### # # ########### ### # # # ### ##### # ### ### # ### # ############### # # ### # # ### # ##### # # ####### # # ### # ####### # # ### # # # #####
#   # # # #           #   #   # # #   #     #   #   #   #   #   #   #     #   # # # #   #   # # #       #     # #   #     # #   #     #   #   # #   # #
##### # # ######### ### # # ### ### # # ####### ### ##### ##### # # # ### # # # # # ####### # # # ########### # # ######### ### # ####### ##### ### # #
#   #   #       #   #   # # #   #   # # #         #   #   #   #   # # # # # #   # #     #   # #   #     #     # #   #       #   # # #     #   #     # #
# # # ### ####### ### ##### # ### ##### # ########### # # # # ##### # # # ####### # # ### # # ##### ### # ##### ### # ####### ### # # ### # # ####### #
# # # # # #       #   #     # #       # # #     #     # # # #     # # # #         # # #   # #     # # #   #     # # #   #   # #     #   # # # #       #
### # # # # ####### ### ##### # ##### # # # ### # ####### # ##### # # # ############# # ##### ##### # ####### # # # ### # # # # ##### # ### # # ##### #
#   # #   #     #   #   #   # # #   #   # #   #   # #     # #     #   # #         #   #     # #     #         #   # # # # # #   #   # # #   #   #   # #
# # # ######### # ### ##### # # ### ##### ### ##### # # ### # ### ##### # ### ### # ####### # # ##### # ######### # # # # # ##### # ### # ####### ### #
# # #     #     #   # #     # #   #         # #       # #   # # #   #       #   #   #     #   #   #   #   #       # # #   #     # #   #     #     #   #
# ####### # ### ### # # # ### ### # ##### ### # ##### # # ### # ### # ######### ### # ### ####### # ##### # ##### # # ######### # ### ##### # ##### ###
#           #   # #   # #   # #   #     # #   # #   # #   #   #     #   # #   #   # # # # #     # # #   # # #   # # #         #   # #   # #   #   #   #
# ########### ### ######### # # ##### # # # ### # # # ##### ########### # # # ### ### # # # ### # ### # # # # # # # ######### ##### ### # ### # # ### #
# #         #         #     # # #   # # # # #   # # # #   #               # #   # #     # #   # #   # #   # # # # # #   #     #     #   #     # # #   #
# # ####### ######### # ### # # # # ### ### # ### # ### # # ############### ### # # ##### ### # ### # ####### # ### # # # ##### # # # ######### # # ###
# #   #     #   #     # #   # #   #     #   # #   # #   # # #   #       #   # #   # # #   #   #   # #         #   #   # # #     # # #     #     # #   #
##### # ####### # ##### ##### ######### # ##### ### # ### # # # # ####### ### # ### # # ### ##### # ### ######### ##### # # ##### # ##### # ##### ### #
#     #       #   # #       #   #       #   #   # # # #   #   #   #       #     #     # #   # #   #   #   #     #       # # #   # # #   # #     #     #
# ########### # ### # ##### ### # ######### # ### # # # ##### ##### ############# ##### # ### # ##### # ### ### ####### # # # # # ### # # ##### ##### #
#   #     #   #   #   #       # # #   #   # #   #   # #   #   #     #           # # #   # #   # #     # #   # # #     #   # # # #     #   #   #   #   #
### # # ### ##### # ### ####### # # # # # # # # ### # ### ##### ### # ######### # # # ### # # # # ####### ### # # ### ### # # # ########### # ### # ###
#   # #     # #   # #   #       #   # # # # # #   # #   # #     # # #       #   #   #   # # # # #       # #   #   # # #   # # #             #     #   #
# ##### ##### # ##### # # ########### # # # ##### # ### # # ##### # ####### # ##### ### # # ### ####### # # # ##### # ##### ### ##################### #
#     # #           # # # #         #   # # #     #     #   # #     #     # #       #   # # #   #   #   # # #       #     #     #     #         #     #
# ### # ########### # # # # ##### ####### # # ############### # ##### # # # ######### # # # # ### # # ### # ##### # ##### ####### ##### # ##### # #####
#   # #   #     #     # # #   #   #     # # #   #   #               # # # #     #   # # #   #     # #   # #   #   #     # #           # # #     #   # #
### # ### # ### # ####### ##### ### ### # # ### # ### ##### ######### # ####### ### # ##### ####### ### # ### # ######### # ######### # # ### ##### # #
# # #   #   # # # #     # #     #   # #   #   # #   # #   # #   #     #   #     #   #     # #     #   #   #   #   #     #   #   #   # # #   #     # # #
# # ### ##### # ### ### # # ##### ### ####### # # # # # # ### # # ####### # ##### ##### # # ### # # # ##### ##### # ### ####### # # # # ### ##### # # #
#   #   #     #     # #   # #     #   #   #   # # #   # #     # # # #   # #   #   #     # #     # # #     #   # #   # #         # # # #   #     # # # #
# ### ### # # # ##### ##### # ####### # # # ### # ##### ####### # # # # # ### # ### # ########### # ##### ### # ##### ##### ##### # # ### ##### # # # #
#   # #   # # # #   # #     # #       # # # #   #     #   #   #   # # # # #   # #   # #         # #     #   #     #       # #     # #   #   #   # #   #
### # ##### ### # # # # # ### ### ##### # # # ####### ### ### ##### # # # # ### # # ### ##### ### ##### ### ##### # ### ### # ##### ### ### # ### ### #
#   #     # #   # # #   #   #     #     #   #   # #     #   #     #   # # #   # # # #   #   #   # #   #   #   # # #   #   #   #   #   #     #   #   # #
# ####### # # ### # # ##### ##### # ########### # # ####### # ### ##### # ### # # # # ### # ### # # ##### ### # # ### ### ##### ##### ######### ##### #
# #   #   #   #   # #     #     # # #           #     #     # #     #   #   # # # # # #   # #   # #     # # # # #   #   #     # #     #     # #     # #
# ### # ### ### ### ########### # # ##### ####### ##### ##### ##### # # # ### # # ### # ##### ### ##### # # # # ### ####### # # # ### # ### # ##### # #
#   # #   # #   # #       #     # #     # #         #   #   #   #     # #       #     #     #   # #   # # #       #   #     #   # # # # #     #   #   #
### # ### ### ### ####### # ##### ##### # ######### # ##### # # ### ########### ########### ### # # # # # ########### # ### ##### # # # ##### # #######
# # #   # #       #   # # #       #   # #         # #     #   #   # #         #               #     #   #           #   # # #   # #   #     # #       #
# # ### # # ##### # # # # ### ##### ### # ####### ####### ##### # ### ####### ############# ######### ##### ##### # ##### # # # # # ####### # # ##### #
# #     #   #   #   # # #   #   #   #   #     # #       #     # #   # #           #         #   #   # #   #   #   #       # # #   #     #   # #     # #
# ##### ##### # ##### # ### ### ### # ####### # ### ### ##### # ### # # ######### # ######### # # # # # # ##### ########### # ######### # ### ##### # #
#   #   #     # #   #     # # #     # #     #     # #     #   # #   # # #   #     #   #       # # #   # #     # #           #     #     # #     #   # #
# ### ### ##### # # ####### # # ##### # # ####### # ####### ### # ### ### # ### ####### ####### # ##### ##### # # ############### # ##### ##### # ### #
#     #   #       #       # #   #     # #       # #       #   # # #   #   #   #   #     # #   # #   #   #     # #       #   #   # #   #   #   # # #   #
# ##### ################# # # ### ##### ### ##### ####### ### ### # ### ##### ### # ##### # # # ##### ### ##### ####### # ### # # ### # ### # # ### # #
# #   # #     #       #     #   # #   # #   #     #     #   #     #     #     # # #   #   # # # #     #     #         #   #   #   #   #     # #     # #
# # # # # ### # ##### # ######### # # # # # # ##### ### ### ##### ####### ##### # ### # ### # # # ######### ##### # ##### # ####### ### ##### ####### #
# # #   # # #     #   # # #     #   # # # # #       #     #           #   #     #     # #   # # #         #       # #   # #   #   #   #   # #   #   # #
# # ### # # ####### ### # # ### ##### # # # ### ######### ############# ### # # ####### # ### # # ####### ### ####### # # ### # ##### ### # ### ### # #
# #   # #   #       #     #   #   #   # # # # # #     #   # #       #   #   # #     #   #   #   #       #   # #       #     # #     # #       #   #   #
##### # ### # ##### ##### ### # ### ### # # # # # ### ### # # ##### # ####### ##### # ##### ##### ##### ### ### ############# # ### # ####### ### #####
#     #   # #     # #   # #   #     #   # # # # # #     #   # # #   # #       #   # #     #     # #   #   #       #         # # # # #   #   #   #     #
# ##### ### ##### ### # # # ############# # # # # ##### ##### # # ### ### ##### ### ### # ##### ### # ############# ####### # # # # ### # ##### ##### #
#     # #   #   #   # # # #         #   # #   # # #   #   #   # #   # #   #   # #   #   #   # # #   #       #       #   #   # #   #   # #     # # #   #
# ### ### ### # ### # # # ######### # # # ##### # # # ### # ### ### # # ### # # # ### ##### # # # ######### # ######### # ### ##### # # ##### # # # # #
#   #         # # # # # #     # #   # # #       #   #   #   #     #   #   # #   # #   # #     # # #       #   #     #   # #   #     # # #     #   # # #
# ####### ##### # # # # ##### # # ### # ##### ######### ##### ### ##### # # ##### # ### # ##### # ### ### ####### # # # # ### # ####### # ####### # ###
# #     # #   #   #   # #       #     # #   # #         #   #   #   #   # #     # #   #     #   #   #   #         # # # #     # #       #       # #   #
# # ### ### # ### ##### ############### # # ### ######### # ### ### # ### # ### # ### # ##### ##### ### ##### ##### # # ####### # ############# # ### #
# # # #     #   #     # #           #   # #     #       # #     #   #   # # # #   #   # # #   #     # # #   #     # # # #       # # #           # # # #
# # # ######### ##### # # ##### ##### ### ####### ### # ####### # ### ### # # ##### ### # # ##### ### # ### ##### # # # # ### ### # # ### ####### # # #
# # #         #     # #   #     #     #   #     #   # #   #   # #     #   #         #   # # #     #   #         # #   # #   # #   # #   #           # #
# # ##### ######### # ##### ### # ####### # ### ### # ### # # # ####### ############# ### # # # ##### ### ##### # ##### ### # # ### ### ########### # #
# # #   #     #     # #     #   # #       #   #   # # # #   # # #     # #     #     #   # # # #   #     # #   # #   # # #   # #   #     #     #   # # #
# # # # # ### # ##### # ######### ### ####### ##### # # ##### # # ### # # ### # ### ### # # # ### # ### # # # ##### # # ##### ### ##### # ### # # # # #
# #   # #   #   #   # #   #       #   #     # #     # #     # #   #   # # #   #   #   #   # #   # #   # # # #     # # #         #     # # #   # # # # #
# ##### ### ####### # ### # ####### ### ### # # ##### # # ### ######### # # ### # ####### # ### # ### ### # ##### # # ######### ##### # # # ### # ### #
# #   # #         #   #   #     #   #   #     # #   # # #               # #   # #       # #   # #   # #   # #   # # # #     #     #   #   # #   #   # #
# ### # ######### # ### # ##### ### # ######### # # # # ################# ### # ####### # ### ##### # # ### # # # # # # ### # ##### ### ##### ##### # #
#     #   #     # #   # # #     #   # #         # #   #     #       #     # # #   #     #   #       #   #   # # #   # #   #   #     #   #     #   #   #
##### ### ### # # ##### ### ##### ### # ######### # ####### # ##### # ##### # ### # ####### ######### ### ### ####### ### ##### ##### ### ##### # ### #
#   #   #   # # # #     #   #     # #   #     #   # #     # #   #   # #     # #   #         #       #   # #   #       #   # #   #   #   #   #   # #   #
# ##### ### # ### # # ### ##### ### # ### ### # ##### ### ##### # ### ##### # # ####### ##### ##### ### # # # # ### ### ### # ### # # ##### ##### # ###
#     # # # #       # #   #     #     #     # # #     # #   #   # #   #   # # # #     # # #   # #   #   # # # # #   #   #   #   # #   #   #   #   #   #
### # # # # ########### ### ##### ##### ### # # # ##### ### # ### # ### # # # ### ### # # # ### # ### ### # # # # ### ### ##### # ##### # # # # ##### #
#   # # # #             #   # #   #   #   # # # #   #     # #   #   #   #   #     # # #   #   # #     # # # #   #         #     # #   # # # # #     # #
# ### # # ############### # # # ### # ##### ### ### # ### # ### ##### ##### ####### # ####### # ####### # # ##### ##### ### ##### # # # # ### ### # # #
#   # #   #           #   # # # #   # #   #   #   #   #   #   # #     #   # #     # #   #   # #     #   # # #   # #   # #   #       # # # #   #   # # #
# # ##### # ######### ##### # # # ### # # ### ### ##### ### ### # ##### ### ### # # ### # # # # ### ### # ### # ### # ### ############# # # ### ##### #
# #         #               #     #     #       #         #       #             #     #   #     #       #     #     #                   #   #         #
#######################################################################################################################################################
