###################################################################################################################################
# #           # #               #       #       #   #             #           #   #         #       #       #   #         #       #
# ##### ##### # # ############# # ### # ##### # # ### ### # ####### ##### ### # # # ####### # # ### # ####### # # ####### # ### ###
#       #   # # # #           #     # # #     #   #   #   # #           #   # # #   #     # # # #   # #       # # #     #   # #   #
########### # # # # ######### ####### # # ######### ### ### # ########### # ### ####### # # # # # ### # ####### # # # # ##### ### #
#           # #   # #     # #       # #   #         # #   # # #     #   # #   #       # # #   # # #     #     # # # # #       #   #
# ########### ##### ### # # ####### # # ### ##### ### ### ### # # ### # ##### ####### ### ##### # ### ##### # # # ### ####### # ###
# #   #     # #     #   #   #   #   # # #   #   #       #       # #   #       #     #     #     #   #       # # #   # #   #   #   #
# # # # ### # # ##### ##### # # # ### ### ### # ######### ####### # ######### ##### ##### # ####### ######### # ### # # ### ##### #
# # # # #   #   #     #   # # #   #         # #     #   # #   # # # #   #   # #     # #   # #   # #     #     #   #   #   # # #   #
# # # # # ####### ### # # ### ##### ######### ##### # # ### # # # # # # ### # # ### # # ### # # # ##### ##### # ######### # # # ###
#   #   #       #   # # # #   #     #         #       #     # #   #   #   #     #     # # #   # #   #   #   # #           #   #   #
# ############# ### # # # # ##### ### ##### ################# ######### # ########### # # ##### ### # ### # # ##### ######### ### #
# # #           # # #   #   #   # #   #   # #   #   #         #       # # #   #     # # # #     #   #     # #     #             # #
# # # ######### # # ######### # ### ##### # # # # # # ####### # ##### ### # # # ### ### # # ##### # ####### ##### ############### #
#   #   #         #     #   # #   #     #   # #   # #   #   #   #   #   # # #   # #   #   #   #   # # #     # #   #     #       # #
### ### # ############# # # # ### # ### # ### ##### ##### # ##### ##### # # ##### ### ### ### # ### # # ##### # ### ### # ##### # #
#   # # # #         # #   # #   # # #   # # # #   #       #     # #     #   #       #       # # #     #     # #     # # # #   #   #
# ### # # # ##### # # ##### # # # ### ### # # ### ############# # # ##### ### ##### ######### # ### ####### # ####### # # # # ### #
# #   # # # #   # #     #   # # # #   #     #       #           #   #       #   #   #   #     #   # #     # # #     #   # # #     #
# # # # ### # ### ####### ##### # # ######### ##### # ############# ####### # ### # # ### ####### # # ### # # # # ### ### # #######
#   # # #   #   #         #     # #           #   # # #           #       # # #   # # #   #       # #   #   #   #     # # #   #   #
### ### # ##### ########### ##### # ########### # ### # ######### ####### # ### ### # # ### ####### ### ########### ### # ### ### #
#   #   # #   #     #       # #   # #       #   #   #       #   #   #   # #   # # #   # #   #       #   #         #     #   #   # #
# ### ### # # # ### ####### # # ### ##### # # ##### ######### # ### # ### ### # # ### # # # ####### # ### ####### ######### ### # #
# #   #   # # #   #         # # # #     # # #   # #       #   #   # #     #     #     # # #       # # #   # #       #       # #   #
### # # ### # ### ########### # # ##### # ##### # ####### # ##### # # ########### ##### # ####### # # ### # # ##### # ####### ### #
#   # #     #     #     #       #       # #     #           #   #   #     #   #   #     # #   # # # # #   # # #   #   #   #   #   #
# ### ############# # ### ####### ####### # ### ############# ########### # # ##### ##### # # # # # # # ### # # # ##### # # # # ###
#   # #     #       #     #       #       #   # #         #     #     #   # #     #     # # #   # # # # #     # #     # #   #   # #
### # ##### # ################### ### ### ### ### ####### ##### # # ### ### ##### ##### # # ### # ### # ####### ##### # ######### #
#   #     # # #                 #   #   #   #   #       # #     # #   #   # #   # #     #   #   # #   #         #     # #         #
# ####### # # # ############### ### # ##### ### ### ##### # ### # ### ### # ### # # ####### ##### # ####### ##### ##### ####### # #
# #     #   #   #   #     #   # # # # #   #   #   # #     #   # #   #   #   #   # # #   #   #   # # #     #     # #   #       # # #
# # ### ### ##### # # # # # # # # # ### # ### ### # # ##### # # ### # ####### ### # # # ##### # # # # ### ####### # ######### # ###
# #   # # # #   # #   # # # # # # #     #       #   #   #   # # #   #   #       #   # #       #   #   # #         #         # #   #
# ### # # # # # # ##### # # # # # ############# ####### ##### ### ##### # ##### ##### ########### ##### ########### ### ### # ### #
#     # # # # # # #   # #   # # #   #     #   # #   # #     #   # #   # #   # #       #     #   #   # #           #   #   # #   # #
# ##### # # ### # ### # ####### # # ### # # # # # # # ##### # # # # # # ### # ####### # ### ### ### # # # ####### ### ### ##### # #
# #     # #   # # #   #         # #   # #   # #   # #   # # # # # # #   # # #     #   # # #   #       # # #         # # #   #   # #
# # ##### ### # # # ############# ### ### ### ##### # # # # ### # # ### # # ### ### ### # ### ### ##### # ########### # ### # ### #
# #   #     # # # # #       #       #   # #     #   # #   #   # # #   #   #   #   #   # #   #   # #   # #   #       # #   # #   # #
# ### # # ### # # # # # ##### ##### ### ### ### # ### ### ### # # ### ####### ### ### # ### ### ### # # ### # ##### # # # # ### # #
# #   # # #   # # #   # #   # #   # #       #   #     # # # # #     #         #   #   # #     #     # # # #   # #   #   # #   # # #
### ### # # ### # # ### # # # # # # # ####### ######### # # # ##### ########### # # ### # ### ####### # # ##### # ####### ### # # #
#   #   # # #   # #   #   #   # #   # #   #   #   #         #   # # #   #       # #   # # # #   #   #   #       #       # # # # # #
# ### ### # # # # ### ######### ####### # # ### # # ########### # # # # ####### ##### # # # ### ### ##### ##### ### # ### # # # # #
# #   #   # # # # # # #       #         # #   # #   #     #     # #   # #       #     #   # #   #   #   #   # #   # # #   # # # # #
# # ### ### # ### # # ### ##### ######### ### # ##### ### # ##### ##### # ##### # # ####### # ### # # # ### # # ### # # ### # # # #
# #   #   # #   # # #   # #   #         # # # # #   # #     #   #     #   #     # # #   #   #     #   # #   # #   # # # #   #   # #
# ##### # # ### # # ### # # # # ######### # # # # ### ####### # # ### ##### ##### ### # # # ########### # ### ### # ### # # ##### #
#     # #       # #   #   # # # #       # #   # #   #   #   # # #   #   #   #   #     #   #     #       #     #   #     # #       #
# ### # ######### # # ### # # # # ##### # # ### # # ### # # # # ### # ### ### # ########### ##### ########### # ######### ####### #
#   # #   # #     # #     # # # #   #     #   # # #   #   # # #   # #   # #   #   #       #       #       #   #     #   #       # #
##### ### # # ##### ####### # ##### ####### ### ##### ##### # ### # ### # # ##### ##### # ######### # ##### ##### ### # # ##### # #
#     # #   # # #   #       # #   #     #   #       #   #   # #   # #   #   #   #       # #         # #     # #   #   # # #   # # #
# ##### ### # # # ### ####### # # ##### ##### ##### # # # ### # ### # ######### ######### # ##### ### # ##### # ### ### # ### # # #
#   #       # #     #       #   #     #       #   # # # # #   #   # #   #     #     #   # #   # # #   # #     #   #   #   #   # # #
# # ### ##### ############# ######### # ####### # # ### # ### ### # ### # # # ### # # # # ### # # ### # # ### ### ### ##### # # ###
# #   #   # #       #       #   #     # #       # #     #   #   # # # #   # # #   #   # # # #   #   # #   #   # #   # #     # #   #
# ### ### # ####### # ####### ### ##### # ####### ######### # # ### # ##### # # ### ##### # ### ### ####### ### # # # ### # # ### #
# # # #   #   #   #   #       #   #   # #     #           # # #       #     #   #   #     #   # #   #     #     # # #   # # # #   #
# # # ### ### # # ##### ####### ### # # ##### ########### # # ######### ########### # ##### ### # ### # ####### # # ### ### # # # #
#   #   #   #   #       #       #   # # #   #   #       # # # #   #   # #         # # #     #   #     #     #   # #   #     # # # #
### ### ### ### ##### ### ####### ### # # # ### # ##### # # # # # # # # # ####### ### # ### # ########### ### ### ##### ####### ###
# #   # # #   #     # #   # #     #   #   # #   # # #   #   # # # # #   # #   # # #   #   # #     #     #   #   #       #     #   #
# ### # # ### ##### # # ### # ### ######### # ### # # ####### # # # ##### # # # # # ##### ####### ##### ### ### ######### ### ### #
#   # # # #   #     # # #       #   #   #   # # # # #       #   # #   #   # #   # # #     #   #           #     #     #   # #   # #
# ### # # # ######### # ########### # # # ### # # # ##### # ##### ### # ### ##### # # ##### # # ################# ### # ### ### # #
#     # #           # #   #   #   #   #   #   #       # # #   #   # #   # #     #   # #     #   #   #           # #     #   #   # #
# ##### ########### # ### # # # # ######### ######### # # # ### ### ##### # ### ##### # ######### # # ######### # ####### # # ### #
# #   #   #     # # #   # # #   #   #     #         #   # # #   #       #   #       #   #       # # #     # #   #   #     # # #   #
# # # ### # ### # # # ### # ####### # ### # ####### ##### # # ### ### # ### # ### ### ####### # # # # ### # # ##### ### ### # ### #
#   # #   # # # #     #   # # #     # # # # #     # #     # #   #   # #   # #   # #   #     # # # # #   # #   #   #   # #   #     #
##### # ### # # ##### # ### # # ##### # # ### ### # # ##### ### ### # ### # ### ### ##### # ### # # ### # # ### # # # # # ####### #
#   # #       #   #   #     # # #     #   #   # #   # #   # # #   # # # # # # #     #     #     # # #   # #   # # # # # #       # #
# # # ####### ### ########### # # ### ### # ### ##### # # # # ### # # # # # # ####### ########### # ##### ### # # ### # ### ##### #
# #     #   # # #   #         # # # #   #   #     #   # #   #   # # # # # # #       #   #         #   #   # #   #     #   # #     #
# ####### # # # ### # ### ##### # # ### ##### ### ### # ####### # ### # # # ### # # ### # ########### # ### ############# ### #####
# # #     # #   #   #   #       #     # #   # #   #   #   #     #     # # #   # # #     # #         # #   #       #       #   #   #
# # # ##### ##### # ### ############# # # # # # ### ##### ### # ####### # ### ### ##### # ### ####### ### # ### # # ### ### ##### #
#   #   # #       #   #   #   #     # #   # # #   # #   #     # #       #   #     #   # #   # #       #   #   # # # # #     #     #
### ### # ########### ### # # # ### ####### # ### # # ######### ### ### ### ### ##### # ### # # ####### ### ### # # # ####### ### #
# #   # # #         #   #   #   # #     #   # #   # #       #   #   # #   # #   #   # # #   # # #       # # #   # # #         # # #
# # ### # # ### # ##### ######### ##### # ### # ### ####### # ### ### ### # # ### # # # # ### # # ####### # # ##### ### ####### # #
#   #   # #   # # #     #         #   #   #   #   #   #   #   #   #       # # #   # #   # #   # #     # #   # #   #     #         #
# ### ### ### # # # ##### ####### ### ##### ##### ### # # ### ### ### ##### # # ### ##### ### # # ### # # ### # # ####### #########
#   # #     # # # # #     #     #       #   #   #   #   #   #   #   #     # # # # #       #   # # # # #   # #   #       #   #     #
### # # ### # # # # # ### # ### ### ##### # # # ### ##### # ### ### ##### # ### # ######### ### # # # # ### ##### ##### ### # #####
#   # #   # # # # # # #   # #   #   #     #   #   #     # # #       #   # #     #     #       # #   # # #       #   #     # #     #
# ### ### ### # ### # # ### # ### ### ########### ##### # # # ##### # # # ####### ### # ##### # ### # # # ######### # ##### ##### #
#   #   #   # #     # # #   #     # # # #       #   #   # # # #   # # # #       #   # # #     #   # # #   #   #     # # #   #   # #
### ### ### # ######### ### ####### # # # ##### ### # ##### ### # # # # ####### # # ### # ### ### ### ### # # # ##### # # ### # # #
#   # #   #   #   #   #   #     #   # # #   #   #   #     #   # # # # # #   #   # #     # # # # #     #   # # #     #   # #   #   #
# ### ### ### # # # # ### ##### ### # # ### # ### ####### ### # # ### # # # # ### ####### # # # ########### # # ### ### # ### ### #
# #     #   # # #   #     #   #   # # #     #   #       # #   # #   # #   # #   # # #   # #       # #       # # #   # # # #   #   #
# # # ##### # # # ######### # ### # # # ####### ####### # # # # ### # ##### # ### # # # # ####### # # # ##### ### ### # # # ### ###
# # # #     # # # #         # #     # # #       #   #   # # # #   # # #   # # #   #   # # #     # #   # #   #     #     # #   #   #
# ### # ##### # # # ######### ####### ### ##### # # # ### # ##### # # ### # ### ### ### # # ### # # ### ### ####### ##### # # ### #
# #   #   # # # # # #       #       #     #     # #   #   #       # #   # #     #     # #   #   # #   #   #   #     #     # # #   #
# # # ### # # # ### # # ########### ####### ##### ##### ######### # ### # ########### # ##### ### ####### # # # ##### ##### # #####
#   #   # # # # #   # #         #   #   #       # #   #     #   # #   # #   #     #   #     #   # #   #   # # # #   # # #   #     #
####### # # # # # ### ##### ### # ### # # ####### # ####### # # ### ### # # ### # ######### ### # # # # ### # # ### # # # ####### #
#   #   # #     # # # #   #   # #     # # # #     # #     #   #     #   # #     #             # #   #   # # # #   # # #       #   #
# ### ### ####### # # # # ### ######### # # # ##### # # ########### # ### ################### # ######### # # ### # # ######### # #
#     # #       # #     # # #         #   # #   #     # #   #       # #   #     #   #       # #         #   #       # #   #     # #
# ##### ####### # ####### # ####### ####### ### ### ### # # # ####### # # # ### # ### # ### # ######### ############# # # # ##### #
# #           # #   #             #         # #   # #   # #   #     # # # #   # #   # #   # #   #     #   #         #   #   #     #
# ##### ####### ### ####### ########### ### # ### ### ### ##### # ### # ##### # ### # ### ##### # ### ### # ####### ######### #####
#   #   #       # #       # #     #     # #   # #   #     #   # # #   #       #   #     #   #   #   #   #   #     #   #   #   #   #
### # ### ##### # ####### # # ### # ##### ### # ### # ##### # ### # ### ##### ### ######### # ### # ############# ### # # # ### # #
#   #   #   # #     #     # # #   #   #     #   #   #       #   # # #   #   #   #       #   #   # #             # #   # # # #   # #
# ##### ### # ### ### ####### # ### # ### # ### # ############# # # ##### # ### ####### # ##### # ##### ####### # # ### # # # ### #
#       #   # #   #   #       # #   #   # #     # #     #     # # #       #   #       # #       #     #     # #   #   # #   # #   #
# ##### # ### # ### ### ### ### ####### # ####### # # ### # ### # ########### # ####### # ########### ##### # ### ### # ####### # #
# #   # # #   #   # #   # # # # #     # #   #     # #     #     #     #       # #       #       #       #   #   # # #   #       # #
### # ### # # ### # # ### # # # # ### # ### # ##### ############### # # ######### ############# # ####### ### # # # ##### ####### #
#   #     # # #   # # #   # # # # # # # #   # #   # #             # # #   #       #   #       # #   #     #   # #   #       # #   #
# ######### ### ### # # # # # # # # # # ##### # ### ### ### ##### ### ### # ####### # ### ##### ##### ##### ### ### # ##### # # ###
# # #         #   # #   # # #     #   #     # #         #   #   #     #   #         #   #     #       #     #     # # #     # #   #
# # # ####### ### # ##### # ####### ####### # # ######### ### # ####### ### ######### # ##### ######### ##### ##### # # ##### ### #
# #         #     #   # # # #     #       # # # #     #   #   #     #   #   #       # #     #           #     # #   # # # #   #   #
# ######### ######### # # # # ### ####### # # # # ### # ### ####### # ##### # ##### # ##### # ### ######### ### # ##### # # # # ###
#       # #   #       #   #   # # #   #     # # #   # #   #   # #   # #   # #   # # #   #   # #   #   #   #     #     # #   #   # #
# ##### # ### # ######### ##### # # # ##### # ##### # ### ### # # ### # # ##### # # # ### ### ##### # # # ########### # ##### ### #
#     # #     # #       #       #   #     # # #     # #   #   # #   #   #     # #   # #   #         #   #     #       #     #     #
### ### ####### # ##### ####### ######### ### # ##### ##### ### ### ######### # # ### # ### ################# # ####### ### ##### #
# # #   #       #   #   #     #     #   # #   # #   #     #   #   # #       #   #   # # #   #       #     # #   #         # #     #
# # # ### ######### # ### ### ####### # # # ### ### ##### ### # # # # ### ######### ### # ##### ### ### # # ############### # #####
#   #               #     #           #   #             #       # #     #               #       #       #                   #     #
###################################################################################################################################
