#####################
#   #               #
### ##### ####### # #
# #     # #     # # #
# ##### # # ### ### #
#     # # # # # #   #
# ### # ### # # # ###
# #   #     #   #   #
# # # ####### ##### #
# # #   #   # #     #
### ### ### # # ### #
#   #       # #   # #
# ### ####### # # ###
# #     #     # #   #
# ##### # ######### #
#   # # # #   #     #
# # # # # # # # ### #
# # #   # # #   #   #
# # ##### # ##### ###
# #         #       #
#####################
