#####################
# #     #   #       #
# # ### # ### # #####
# #   # #     #     #
# ### # ##### ##### #
#     # #   #     # #
####### # # ##### # #
#       # # #     # #
# ####### # ####### #
# #       #     #   #
# ####### ##### # ###
#   #     # #   #   #
### # ##### # ##### #
#   # #     #     # #
# ### ### ####### # #
# #   #   #     # # #
# ### # ### # ### # #
# #   # #   #   #   #
# # ### # ##### ### #
#   #         #     #
#####################
