#######################################################################
# #           # #                         #                       #   #
# ##### ##### # # ############# ######### # ### ### ############# ### #
#       #   # # # #           #       #   #   #   # #         # #     #
######### # # # # # ######### ####### # ##### ### ### ####### # ##### #
# #       # # #   # #   #   #       # #   # #   #   #       # #       #
# # ### ### # ##### # # # # ####### # ### # ### ### ### ##### # #######
#   #   #   # #     # #   # #   #   #   # #   #   #   # #     # #   # #
# ### ####### # ##### ##### # # # ### # # # ##### ### # # ##### # # # #
# # #       #   #     #   # # #   #   # #   #   # # #   #   #     #   #
# # ####### ##### ### # # ### ##### ### ##### # # # ####### ######### #
#       #     # #   # # # #   #   # # #       #   # #     #     #   # #
####### # ### # ### # # # # ##### # # ############# # # # ##### # # # #
#     # #   #   # # #   #   #   #   #     #         # # #     # # # # #
### # # ### ### # # ######### # ### # # ### ####### # # ##### # ### # #
#   # # #   #     #     #   # #   # # # #   #     #   # #     #   #   #
# ##### # ############# # # # ### # # ### ### ### ##### ##### ### # ###
#       # #         # #   # #   # # # #   #   #   #   # #   #   # #   #
# ####### # ##### # # ##### # # # # # # ### ### # ### # # # ### # #####
# #       # #   # #     #   # # # # # #   #   # #     # # # #   #     #
# # ### ### # ### ####### ##### # # # ### # ### ##### # # # ######### #
# # #   #   #   #         #     # # #     # #   #     #   # #     #   #
# # ### # ##### ########### ##### # ### ### # # ####### ### # ### # # #
# #   # # #   #     #       # #   #   #   # # # #     # #   # #     # #
# ### ### # # # ### ####### # # ##### ### ### # # ### ### # # ####### #
#   # #   # # #   #         # # #   #   #     # # #       # #   #   # #
##### # ### # ### ########### # # ##### ### ##### ######### ### # # # #
#     #     #     #     #       # #   #   # #   #     #       #   # # #
# ################# # ### ####### # # ### # # # ##### ### ######### # #
# #         #       #     #         #     # # #     #   #   #   #   # #
# # ### ### # ################### ########### ##### # # ##### # # ### #
# # # #   # # #                 #   #         #   # # # #     # # #   #
# # # ### ### # ############### ### ####### ### # # ### # ##### # ### #
# # #   #   #   #   #         # # # #     # # # # #   #       # #   # #
# # ### ### ##### # # # ##### # # # # ### # # # # ### # ##### # ### # #
# # #     #     # #   # #     # # #   # #   #   #   # # #   # #   # # #
# # # ### ### # # ##### # ##### # ##### ##### ##### # ### # ##### # # #
# # # # #   # # # #   # #     # #         #   #   # #     # #     # # #
# # # # ### # # # # ### ####### ##### ##### ##### # ####### # ### # # #
# #   # #   # # # #   #         #     #     #     #     #   # #   # # #
# ##### # ### # # # # ########### ### # ####### # ### ### ### ##### ###
# #         # # # # #       #     # # # # #     #   #         #   #   #
# # ######### # # ####### # ##### # # # # # # ##### ########### # # # #
# #       #   # # #       #       #   # #   #   # # #   #       # # # #
# ####### # ##### # ####### ########### ####### # # # # # ####### ### #
#         #     # # #       #   #     #         # #   # #     #       #
# ############# # # ######### # # ### ########### ##### ##### ####### #
#   #   #   #   # #           #     # #   #       #     #   #   #   # #
### # # # ### # # # ########### ##### # # # # # ### ##### ##### # # # #
#   # #   #   # # # #     #   # #     # #   # # #   #       #   # # # #
# ### ### # ### # # ##### # # # # ##### ##### ### ######### # ### # # #
#   # #   # #   # # #   # # # # #     # #     #   #         # #   #   #
### # ##### ##### # # # # # # # ##### # # ### # ### ##### ### # #######
# # #   #   #     #   #   # # #     # # # #   # #   #     #   #       #
# # ### # ### ##### ####### # ##### # # # # ### ### ####### ######### #
# #     #   # #   # #       # #   # #   # #   # #   #     #         # #
# ### ##### # # ### # ####### # # ##### # ### # # # # ### # ####### # #
#     #   # # #     #       #   #     # # #   #   # # # # # #     # # #
# ##### # # # ############# ######### # # ######### # # # ### ### # # #
# #   # #   #       #       #   #     # #   #       # #   #   # #   # #
# # # # ### ####### # ####### ### ##### ### # ####### ### # ### ##### #
# # # #   #   #   #   #       #   #   #   # #   #   #   #   # #     # #
# ### ### ##### # ##### ####### ##### # ### ### # # ### ##### # ### # #
# #   #   #     #       #       #   #   #     # # # # # #   #     #   #
# # ### # # ######### ### ####### # ##### ##### # # # # # # ###########
# #   # # #   #     # #   #       # #   #   #     #   #   #           #
# ### # # ### # ### # # ####### ### # # ### # ####################### #
# #   # #   # # #   # # #       # #   #   #   #         #   #   #     #
# # # # ##### ### # # # ### ##### ####### ##### ####### # # # # # ### #
#   # #           # #       #                   #         #   #   #   #
#######################################################################
