###############################
#   #             # #         #
### ########### # # # ### ### #
# #     #       # #   #   # # #
# ##### # ####### ##### ### # #
#     # # #     #     # #     #
### ### # # ### ##### # # #####
#   #   # #   #   #   # # #   #
# # # ### # # ### # ### # # # #
# # #   # # # # # #     #   # #
# ##### # ### # # ########### #
#     #   #   # #   #     #   #
# ### ##### ### ### # # # # ###
#   #     #   #   # # # # # # #
##### ### # # # # # ### ### # #
#   #   #   # # #   #   #   # #
# # ##### ### ##### # ### ### #
# #     # #   #   # #   # #   #
# ##### # # # # # # ### # ### #
# #   # # # # # # #     #     #
# # # # ### # # # ########### #
# # # # #   # # #           # #
# # # # # # ### ########### # #
# # # #   # #   #         #   #
# # ##### ### ####### ### #####
# #       #   #       # # #   #
# ### ##### ### ####### # # # #
#   # #     #     #     #   # #
# # ### ######### # # ####### #
# #               # #         #
###############################
