#############################################################################################################################################
# #           # #               #       #       #   #             #           #   #         #       #   #     #       #   #   #             #
# ##### ##### # # ############# # ### # ##### # # ### ### # ####### ##### ### # # # ####### # # ### ### # ### # ### ### # # # # ### ####### #
#       #   # # # #           #     # # #     #   #   #   # #           #   # # #   #     # # # #   #   # # #   # #   # #   #   #   #     # #
######### # # # # # ######### ####### # # ######### ### ### # ########### # ### ####### # # # # # ### ### # ##### ### # ######### ##### ### #
#       # # # #   # #   #   #       # #   #         # #   # # #     #   # #   #       # # #   # # #     #           # #   # #   # #   #   # #
# # ### # ### ##### # # ### ####### # # ### ##### ### ### ### # # ### # ##### ####### ### ##### # ### # ####### ##### ### # # # # # # ### # #
# # #   #   # #     # #     #   #   # # #   #   #       #       # #   #       #     #     #     #   # #       # #       #   # #   # #     # #
### # ##### # # ##### ##### # # # ### ### ### # ######### ####### # ######### ##### ##### # ####### ##### # ### # ######### # ##### ### ### #
#   #       #   #     #   # # #   #         # #     #   # #   # # # #   #   # #     # #   # #   # #     # #     #   #       # #       # #   #
# # ####### ##### ### # # ### ##### ######### ##### # # ### # # # # # # ### # # ### # # ### # # # ##### ##### ##### # ####### ### ### # # ###
# # #     #   # #   # # # #   #     #         #       #     # #   #   #   #     #     # # #   # #   #   #   #   #   # #     #   # #   # # # #
# ### ### ### # ### # # # # ##### ### ##### ################# ######### # ########### # # ##### ### # ### # ##### # # ##### ### ### ##### # #
#       # # #   # # #   #   #   # #   #   # #   #   #         #       # # #   #     # # # #     #   #     # #     # # #       #   #         #
# ####### # ### # # ######### # ### ##### # # # # # # ####### # ##### ### # # # ### ### # # ##### # ####### # ##### # # ######### ######### #
#     #   #       #     #   # #   #     #   # #   # #   #   #   #   #   # # #   # #   #   #   #   # # #     #   #   #   #       #         # #
### ### # ############# # # # ### # ### # ### ##### ##### # ##### ##### # # ##### ### ### ### # ### # # ####### # ##### # ##### ######### # #
# # #   # #           #   # #   # # #   # # # #   #       #     # #     #   #       #       # #   #   #     #   #   #   # #   #           # #
# # # ### # ##### ### ##### # # # ### ### # # # # ############# # # ##### ### ##### ######### ### # ####### # ####### ### # # ############# #
#   # #   # #   # #     #   # # # #   #     #   #   #           #   #       #   #   #   #     #   # #     # # #   #   # # # #       #     # #
##### # ### # ### ####### ##### # # ######### ##### # ############# ####### # ### # # ### ##### ### # ### # # # # # ### # # ### ##### ### # #
#     # #   #   #         #     # #           #   # # #           #       # # #   # # #   #   #   # #   #   #   #       # #   #     # # # # #
# ##### # ##### ########### ##### # ########### # ### # ######### ####### # ### ### # # ### # # # ##### ############### # ### ##### # # # # #
# #     # #   #     #       # #   # #     # #   #   #       #   #   #   # #   # # #   # #   # # #   #   #         #     #   # #     # # # # #
# ####### # # # ### ####### # # ### # ### # # ##### ######### # ### # ### ### # # ### # # ### ### # # ### ####### ######### # # ##### # # # #
#     #   # # #   #         # # # # #   #   #   # #       #   #   # #     #     #     # #   #   # # # #   # #       #       # # #     # # # #
# ### # ### # ### ########### # # # # # ####### # ####### # ##### # # ########### ##### ### ### ### # ### # # ##### # ####### # # ##### # # #
# #   #     #     #     #       # # # #   #     #           #   #   #     #   #   #     #   #   #   # #   # # #   #   #     # # #   #   # # #
### # ############# # ### ####### # ##### # ### ############### ######### # # ##### ##### ### ### # # # ### # # # ######### # # ### # # # # #
#   # #     #       #     #       #     # #   # #         #   #       #   # #     #     # #       # # # #     # #     #     # #   # # # #   #
# ### ### # # ################### ##### # ### ### ####### # # ##### # # ### ##### ##### # # ######### # ####### ##### # ##### # # # ### #####
#   #     # # #                 # #   # #   #   #       # # #       # #   # #   # #     # #   #   #   #         #     #       # # # #       #
# # ####### # # ############### # # # # # ##### ### ##### # ### ######### # # ### # ##### ### # # # ####### ##### ##### ####### # # # ##### #
# # #       #   #   #         # # # # # #     #   # #     #   # #       #   #   # # #     #   # # # #     #     # #   #   #   # # #   # #   #
# # ############# # # # ##### # # # # # ##### ### # # ##### # ### ### # ####### # # # ### ##### # # # ### ####### # # ### # # # ####### # ###
# #   #       # # #   # # #   # #   #   #     # #   #   #   # #     # # #       #   #   #       # #   # #         # # #     # # #       # # #
# ### # ### # # # ##### # # ### # ####### ### # ####### ##### # ##### ### # ########### ######### ##### ########### ### ####### # ### ### # #
#   #   # # #   # #   # #     # # # #   #   #   #   # #     #   #     #   #     #     # #   #         #           #     #     # #   #     # #
### ##### # ### # # # # ####### # # # # # # ### # # # ##### # ### ### # ####### # # ### ### # # ####### ####### # # ##### ### # ### ####### #
# # #     # # # # # # #         # # # #   #   #   # #     # #   # #   # #   # #   #   #     # # #   #   # #   # # #   #   # # # #   #   #   #
# # # ### # # # # # ############# # # ####### ##### # # ### ##### ##### # # # ####### ##### # ### # # ### # # # # ### # ### # # # ### # # # #
# #   #   # # # # # #       #   # # #   #     #   # # #   #   #   #     # # #       #       #     #   # #   # # # #   # #       #   # #   # #
# ##### ### # # # # # # ##### # # # # ### ##### # # ##### ### # ### ##### # # ### # ################### # ### # ### ### ########### # ##### #
# #       # # # # #   #   #   # # #   #   #   # #   #       # #   # #     # # #   #   #         #         # # #     # #   #         # #   # #
# # ####### # # # # ##### # ### # # ### ##### # ##### ##### # ### # # ##### ### ##### # ##### # ####### ### # ####### ### # ######### # # # #
# #   # #   #   # # #   #   #   # #   # #     # #     #     #   #   # #   # #   #     #   #   #       # #   #   #       #   #     # # # # # #
# ### # # ### ### # ### ##### ### ##### # ### # # # ########### # ### # # # # ### ####### # ######### # # ##### # ### # ##### ### # # ### # #
#       # # #   # # #   #   #   #       # #   # # # #     #     # #   # # #   #   #     # #       # # #   #   # # #   #   #   #   # # #   # #
# ####### # ### # # # # # ##### ######### ##### # ### ### # ##### # # # ####### ### # ### ####### # # # ### # # # # ##### # # ### # # # ### #
# #       # #   # #   # # #   #   #   #       # #   # #     #     # # #     #   #   #         #   # # # #   # #   # # #   # #   # #     #   #
# # ####### # ### ##### # # # # ### # # ##### # ### # ####### ##### # # # ### ############### # ### # # # ### ##### # # ####### # ####### # #
# #   #         # #   # # # # # #   # # # #   #   # #   #   # #   # # # #     #   #       #   #   # # # # # #       #   #     # #         # #
# ### ##### ##### # ### # # # # # ### # # # # ### # ### # # # # # # # # ####### # # ##### ### ### # # ### # ######### ### ### # ########### #
#   # #   # #     #       # # #   #   # # # #   # #   #   # # # #   # #   #   # #   #   #   #   # # #     # #         #   #     #   #   # # #
##### # # # # ##### ####### # ##### ### # # ##### ### ##### # ####### ### # # # ##### # ### ### # # ####### # ########### ####### # # # # # #
#     # # # # #     #       # #   #       #         #   #   #       # # #   #   #     #   #   # # # #         #   #       #       #   # #   #
# ##### # ### # ##### ####### # # ####### ######### # # # ######### # # ######### ##### ##### # # # # ######### # # # ##### ########### ### #
#       #   # #     #       #   #     #       #   # # # # #       # # #         #   # #     # # # #   #   #     #   # #   # #     #   #   # #
# ######### # ############# ######### # ####### # # ### # ### ##### # ##### # ##### # ### # # ### # ### # ##### ####### # # # # # # # ### # #
# # #       #       #       #   #     # #       # #     #   #   #   #     # #       #   # # #     #     # #   #         # # # # #   #   # # #
# # # ### ######### # ####### ### ##### # ####### ######### # # # ####### # ######### # # # ############# # # ########### # ### ####### # ###
#   #   # #       #   #       #   # #   #     #           # # #   #   #   # #     #   # # #           # #   #       #   # #   #   #     #   #
### ### ### ##### ##### ####### ### # ####### ########### # # ##### # # ### # ### # # ### ##### ##### # ########### # # # ### # # # ####### #
# # # #   #     #       #       #   # #     #   #   #   # # #     # #   # # # # # # # #   #   # #   #   #       #   # # # #   # # # #       #
# # # ### ##### ### ##### ####### ### ##### ### # # # # # # ##### # ##### # # # # # # # ### # ### # # ### # ##### ### # # # ### # # # ##### #
# # #   # #   #   #   #   #   #     # #     #   # #   # #   #   #   #   #     #     # # #   #     # # #   #       #   #   #   # # # # #     #
# # ### # # # ### ### # ### ### ### # # ### # ### ########### # ##### # # ######### ### # ######### ### ########### ### ##### ### ### # #####
# # #   #   #   #   # # #         # # # #   # #     #   #     #   #   # # #     #   #   #   #     #     #       #   #   #   #   #   # #   # #
# # # # ####### # ### # ########### # # # ### # ### # # # ### ### ### # ### ### ##### # ### ### ######### ##### # # ##### # ### ### # ### # #
#     #   #   #   #   #   #   #   #     # #   #   #   #   #   #       #     # #       #   # #   #     #   #     # # #   # #   #   # # #     #
# ####### # # ##### # ### # # # # ######### ######### ##### ### ############# ### ######### # ### # # # ### ### # # # # # # ##### # # # #####
# #     # # #       #   # # #   #   #     #         #     #   # #   #       #   # #         #   # # # # #   #   # #   #   #     #   # # #   #
### ### ### ######### ### # ####### # ### # ####### ##### ### ### # # ##### # # # # ########### # # # ### ### ### ########### ##### # ### # #
#   # # #   #   #     #   # # #     # # # # #     # #   # #   #   # # #   # # #   # #         #   # #     # # # #     #     #     # #     # #
# ### # # ### # ### ### ### # # ##### # # ### ### # # # # # ### ### # # # # # ##### # # ##### ### # ####### # # ##### # ### ##### # ####### #
# #   # #   # #   #   #     # # # #   #   #   # #   # # # #   #   #   # # # #   #   # # #       # # #     #         # # #       #       #   #
# ### # ### # ### ########### # # # # ### # ### ##### ### ### ### ##### # # ### # ### # ####### ### # ### ##### ##### # ############### # ###
#   #   #   # # #   #         # # # #   #   #         #   # #   # #     # #   # # #   #       #     #   #     # #     #   #           # #   #
# # # ### # # # ### # ### ##### # # ### ##### ####### # ### # # # ### ### ### ### ####### ### ##### ### ##### # # ####### # ######### ### # #
# # # #   # #   #   #   #       #     # #   # #     # #     # # #   # #   # #   #       # #   #     # #   # # # #       # #   #     #   # # #
### # ### # # ### # ### ############# # # # # # ##### ##### # # ### ### # # ### ####### # # ### ##### ### # # ######### # ### ##### ### # # #
#   #     # # #   #   #   #   #     # #   # # # #       #   # #   # #   # #   #     #   # #   # #       # # #           #   # #       # # # #
# ##### ##### # ##### ### # # # ### ####### # # # ####### ### ##### # ### # # ### ### ### ### # # ### # # # ####### ##### ### # ##### # ### #
#   #   #     # #   #   #   #   # #     #   # # #       #   #       # #   # #   #     # #   # # # #   # #   #     #       #   #     # # #   #
### # ### ##### # # ############# ##### # ### # ####### ### ######### # ### ### ####### ### # # # # ####### # ### ##### ### ### ### # # # # #
#   #   #   # #   #           #   #   #   # #   #     #   #   #   #   #     # #   #   #     # # # #       # #   #   # # #   # #   # # # # # #
# ##### ### # ######### ##### # ### # ##### ### # ### # # ### # ### # ####### ### # # # ##### # # ####### # ### ### # # # ### ### # ### # ###
# #   #   # #     #   #     #   #   #         #   #   # # #   #   # #     # #     # #     #   # # #       #   # # # #   # #       #     #   #
# ### # ### # # # # # ##### ##### ##### ##### ##### ### ### ### # # ##### # # ##### ####### ### ### # ####### # # # ##### ######### ####### #
#   # # #   # # #   #     # #     #   # #   #     #   #     #   #   #   # # #   #   #       #       # #       # #   #   #         #       # #
### # # # ##### ######### # # ##### # ### # ### # ### ####### ####### # # # ### # ### ####### ######### ####### # ### # ##### ### ####### # #
#   #   #     #   #     # # #   #   # #   #     #   #   #     #       # # #     # #   #   #   #     #         # #     #     # #   #     # # #
# ########### ### # ### ### ### # ### # ##### ######### ##### ### ### # # ####### # ##### # ### ### # ######### ########### ### # # ### # # #
#     #       #   #   #       # # #   # #     #       #     #   # #   # #       # #     # # #   # #   #       #         # # #   # #   # #   #
# ### # ####### ##### ####### # # ### # ##### # ##### ##### ### ### ### ####### # ##### # # # ### ##### ##### ######### # # # ####### # ### #
#   #   #   #   #     #   #   # #   #   #   # # #   #   # # #     # # # #     #     #   #   # #       #     # #         # # #         # #   #
### ##### # # ### ### # # ### # ### ##### # ### # ### # # # ##### # # # # ### ####### ### ### # ##### ##### # # ######### # # ######### # ###
#         # # #   #   # #   # #   #     # # #   #   # #   # #   #   # #   # # # #     #     # #   #     # # #   #   #       # #   #     #   #
# ######### # # ####### ### ##### ##### # # # ##### # ### # # # ##### ##### # # # ######### # ### ##### # # ##### ### ####### ### # ####### #
#   #   #     #           #     # #   #   #   #     # #   #   #   #         #   # #     # # #   #     #   # #   #   # #   #       #   #   # #
# ### # ##################### # # ### ######### # # # ########### # ########### # # ### # # ### ##### ##### # # ### # # # ####### ### # ### #
# #   #                       # #       #       # # #           # #       #     #   # # #   #   #   #     # # #     #   # #     # #   # #   #
# # ######### ########### ############# # ####### ####### ### ### ####### # ######### # ##### ### # # ### # # ########### # ### ### ### # ###
# #   #   #   #     # #   #         #   #   #     #   #   #   #   #     # # #   #     #   #   #   # # #   # #       #     # #   #   #   # # #
# ### # # ##### ### # # ### ##### ### ####### ##### # # ### ### ### ### # # # # # ### ### # ### ### ### ### # ##### # ##### # ### ### ### # #
#   #   #     #   # #     #   # # #   #     #       # #   # #   #     #   #   #   #   # # #     #       #   # #   #   #     # #   #   #   # #
### ######### ### # ##### ### # # # ##### # ####### # ### ### ### ### ### ######### ### # # ##### ####### ### # ####### ##### # ### ### ### #
#   #     #   #   #   #   #     # #   #   # #     # #   #     # # # #   #     #     #   #   #   # #       # # #   #   #   # #   #       #   #
# ##### # # ### ##### ##### ##### ### # ### # ### ##### ####### # # ### ### ### ##### # ##### # ### ####### # # # # # # # # ##### ######### #
#       # #         #       #       # # # #   # #       #     #   # #   #   #   #     #   # # #     #     #   # #   #   # #     # #       # #
####### ########### ####### # ### ### # # ##### ####### # # ### ### # ####### ### ####### # # ####### # # # ### ####### # # ### # ##### # # #
#     # #   #   #     #   # # #   #   # # #           # # # #       #             #   #     # #     # # # # #     #   # # # # #   #     #   #
# # ### # # # # ####### # ### # ### ### # # ####### ### # # # ##### ############### ### ##### # ### # # # # ####### # ### # # ##### ####### #
# #     # # # #         #   # #   #     # #   #   #     # #   #   # #       #   # #     # #   # #   # # # #         #   # # #   #   #       #
# ####### # # ############# # ### ####### ### ### ####### ##### # # # ##### # # # # ##### # ### ### # # ############### # # # # # ### #######
#       # # # #   # #       # #   #         #     #   #   #   # # # # #   #   # #   #     # #     # # # #       #       # #   #   #         #
# ####### # # # # # # ####### ### # ####### ##### ### # ##### # # # # # # ##### # ####### # # ### ### # # ### ### ####### ################# #
# #       # #   # # #   # #     #   #   #       #   # # #     # # # # # # #     #         # # # #   # #   # # #   #     #     #     #     # #
# # ####### ##### # ### # # ### ##### ### ######### # # ### ### # ### # ### ########### ### # # ### # ##### # # ##### # ##### # ### # ##### #
# #   #   # #     # #   #     #     #     # #       #       #   #     #   # #       #   #   # #   # # #     #   #     #   #   # # # #       #
##### # # # # ##### # ######### ### # ##### # ############# # ######### # # # ### ### ### ### ### # # # # ####### # ##### # ### # # ### #####
#     # # # #   # #           # #   #   #   # #         #   #     #     # # #   #     #   # #   # # # # #         # #   # #   # # #   # #   #
# ##### # # # # # # ######### ### ##### # # # ####### # # ####### ####### # ### ####### ### ### # # # # ########### # # # ### # # ### # # # #
# # #   # # # # # # # #     #     #       # # #       # #       #       # # #       #   # #   # # #   #   #       # # # #   #       # #   # #
# # # # ### ### # # # # ### ####### ######### # ####### ####### ####### # # # ####### ### # # # # ####### ### ### # ### ### # ####### ##### #
# #   #     #   # #   #   # #     #   # #     # #   #   #       #       # # # #       # #   #   #       #   #   # #   #   # #   #     #   # #
# ####### ### ### # ##### # # ### ### # # ##### ### # ### ##### # ####### # ### ####### # ####### ### ##### ##### ### ### # ##### ##### ### #
# #     # #   #     #     # #   #       #     #   # # # # #   # # #       #     #       # #   #   #   #   # #     # #   #         #     #   #
# # ### # # # # ##### ##### ################# # # # # # # # # ### # # ########### ##### # # ### # ##### # # # ### # ### ########### ##### ###
#   #   # # # # # #   #   # #     #       #   # # # # #   # #     # #           #   #   # #     #       #     #       #   #     #       # # #
# ### ### ### # # # ##### # # ### # ### ### ##### # # # ### ####### ########### # ### # # # ####################### ##### # ##### ##### # # #
# # #   #     #   # #     #     # # # #     #     # # # #   # #   # #     #   #   #   # # # # #       #   #       # #     #     #   # #   # #
# # ### ######### # # ### ####### # # ####### ##### # ### ### # # # # ##### # ##### ##### # # # ##### # # # ##### # # ##### ### ### # ##### #
#   # # #         #   # # # #     # #         # #     #   # #   #   #   #   #     # #   # # # #   # #   # # #     # #   #   #     #   # #   #
### # # ############### # # # ### # ### ####### # ##### ### # ####### # # ####### # # # # # # ### # ##### # # ##### ### # ### ####### # # # #
# #   #             #   # # #   # #     #       # #     #     #       # #     #     # #   #   #   # #   #   #     #   # #   # #       #   # #
# ### ########### ### # # # ### ############# # # # ##### ######### ### ##### ####### ####### # ### # # ######### ##### ### # # ########### #
#   # #     #   #   # #   #   #               # # #   # # #       # #   #   #       # #       # #     #           #   # # # # #   #         #
# # # ### # ### ### # ####### ######### ######### ### # # ##### # ### # # # ####### # ######### # ################# # # # # # ### ### ##### #
# #       #       #                   #               #         #     #   #       #             #                   #   #   #         #     #
#############################################################################################################################################
