#######################################################################
# #       #             #     #         #                 #         # #
# # ##### ##### # ##### # # # ### ##### ########### ##### ### ##### # #
#   #   #     # # #   # # # #     #   #   #   #     #   # #   #   # # #
##### ####### ### # # # ### ######### ### # # # ##### # # # ### # # # #
#   #       #     # # #   #   #         #   # #   # # #   # #   # #   #
# ### # ### ####### # ### ### # ### ### ##### # # # # ##### # ### ### #
#     # #     #     #   # #   #   #   # # #   # # # # #       # #   # #
# ##### ##### ### ##### # # ##### ### # # # ### # # # # ####### ### ###
#     #   #       #     #   #     #   # # #   # # #   #   # #     #   #
##### ### ######### ######### ##### ### # ### ### # ##### # # # ##### #
#   #   #     #   #     #       #   #       #     # #   # # # # #   # #
# # ### ##### # # # ##### ##### # ################# # ### # # # # # # #
# # # #     # # #   #     #   # #       #           #     #   # # # # #
# # # # ##### # ##### ##### # # ####### # ########### ##### ### # # # #
# #   # #     # #   # #     # #       # #       #   #   # # # # # #   #
# ##### # ####### # # # ##### ### ##### ####### # # ### # # # # # ### #
#   #   #         #   # #   # #   #     #     # # #   # #     # #   # #
# # # ################# ### # ##### ### # ### # ### ### # ##### ### ###
# #   #         #     #   #   #   # #   # #   #   # #   #   #     #   #
# ########### # # ### ### # ### # # # ### ### ### # # ####### ####### #
# #           # # #       # #   #   # #     #   # # #     #   #     # #
# ### ####### ### # ####### # ####### ##### ##### # ##### # ### ### # #
#     #   #   #   # #   #   #     # #       #   # #         #   # # # #
####### # # ### ### # # # ####### # # ##### # # # ######### # ### # # #
#       #   # # #   # # #   #   # #   #   # # # #         # #   #   # #
# ########### # ##### # ### # # # # ### # ### # ######### ##### # ### #
# #           #   #   # #     #   # #   #   # #         #       #     #
# ### ####### ### # ### ########### # ##### # # ### ################# #
#   #   #     #   # # #     # #     # #   #   # #   #     #       #   #
### ### # ##### ### # ##### # # ##### ### ##### ##### ### # ##### # ###
# #   # #     #   #   #   # #   #   #     #   #     #   #   #   #   # #
# ### # ##### ### ### # ### # ##### ##### # ####### ### ##### ####### #
#   # #     #   #   # # #   #     #   #   #       #     #   #         #
# # # ######### # ### # # ####### # ### ##### ########### ### ##### # #
# # # #   #     #       # #         #   #     #           #   #   # # #
# # # # # # ### ######### ##### ##### ### ### # ##### # ### ### # # # #
# # # # #   # # #     #   #   # #   # #   # # # # #   # #   #   # # # #
# # # # ##### # # # ### # # # # # # # # ### # # # # ##### ### ### # # #
# #   # #       # #   # # # # # # #   # #     #   #     #   #   #   # #
# ##### ######### ### # ### # ### ##### ######### ##### ### ### ##### #
#     #   #     #   # #     #   # #         #     #   #   #   #     # #
##### # # # ### # ### ######### # ##### ### # ####### # ### ##### # # #
#   # # # # # #   #       #   # #     #   #   #       #     #   # # # #
### # # # # # ##### ### ### # # ##### ##### ### ### ######### # ### # #
#   # # # # #   #   #   #   #   #   #     # #   # # #       # #     # #
# ### # # # # ### # ##### ##### ### ##### # # ### # # # ##### ####### #
# #   # # # # #   # #   # #   # #     #   # #     # # # #     #       #
# # ### # # # # ### # # # # # # # ### # ### ##### # # # # ##### #######
# #   # #     # # # # # # # #     #   # #       # #   # #     #       #
# ### # ####### # # # # # ############# ####### ####### ##### ####### #
# #   # #   #   #   # #   #     #     # #     # #         #   #   # # #
# # ##### # # # ##### ### # ### # ### # # ### # # ####### # # # # # # #
# # #     #   # #     #   # # #   # # #   #   #   # #   # # # # # #   #
# # # # ### ##### ######### # ##### # ##### ####### # # # # # # # ### #
# # # #   # #   #   #       #       #     # # #       #   # # # #   # #
# # ##### ### # ### # ############# ### ### # # ########### # # ### ###
# #     # #   #     # #             #   #   #   #   #       # #   #   #
# ##### # # ######### # ########### # ### ### ### # # # ##### ### ### #
#     # # #     #     # #   #       #     #       # # # #   # #   #   #
##### # # ##### # ##### # # ##### ######### ######### ### # ### ### # #
#     #       #   # #   # # #   #       # #   #     #   # #   # #   # #
# ### ####### ##### # # # # # # ####### # ### # ### # # # ### # # #####
#   #     #   #   #   #   #   # #     # #     # # # # #   # #   #     #
# # ####### ### # # ########### # ### # ####### # # # ##### ######### #
# #         #   # #       #   #     # #       # # # #             #   #
# ############# # ####### # ####### # ####### # # # ############# # # #
#   #           #       #   #     # #       # # # #   #         # # # #
### ### ############### ##### ### ######### # # # ### # ####### ### # #
#       #                     #             #   #       #           # #
#######################################################################
