#####################
# #           # #   #
# ##### ##### # # # #
#       #   # #   # #
######### # # # ### #
#   #     # # #   # #
# # # ##### # ##### #
# # #   #   # #     #
# # ### # ### # ### #
# #     #   #   #   #
# ####### ####### ###
# #       #   #   # #
# ####### # # # ### #
#   #   # # #   #   #
# # # # ### ####### #
# # # # #   #       #
# # # # # ####### ###
# #   #   #     #   #
# ######### ### ### #
#           #       #
#####################
