###################################################
#   #             #   #           #   #   #   #   #
### # ### ####### # ### ### ##### # ### # # # # # #
# # # # # #     # #   #   #     #   #   #   #   # #
# # # # # # ### # # # # ####### ##### ########### #
#   # # # # # # # # #   #   #   #     #     #     #
# ### # # # # # # # ##### # # ### ##### ### # ### #
#   #   #     # # # #   # # #     #     #   #   # #
### ########### # ### # # # # ##### ##### ##### # #
# #             #     #   # #   #   # #   #     # #
# ######################### ### # ### # ### ##### #
# #   #         # #       #   #   #       # #   # #
# # # # ##### # # # ##### ### ##### ####### # ### #
# # #   #   # # #   #       #     # #   #   # #   #
# # ##### ### # ##### ########### # # ### ### # ###
#   #       # #       #   #       #   #   #     # #
# ### ##### # ######### # # ####### ### ### ##### #
# #       # # #         # #     # # #   # #     # #
# ######### # # ######### ##### # # # ### ##### # #
#   #       #   #     #     #   #   # # #     # # #
### # # ######### ### # ### # ### ### # # # # # # #
#   # # #         #   #   # #   # #   #   # # #   #
# ### ### ######### ##### # ### ### ##### # # ### #
# # #   # # #     #       #   #   #     # # # #   #
# # # # # # # ### ########### ### ##### # # # # ###
# #   # # #     #           #   #       # # # #   #
# ##### # ##### ########### ### ######### # ##### #
#   #   #   #       #     #   #   #     # #       #
### # # ### ####### ##### ### ### ##### # #########
# #   # # #     #     #   #     #       #   #     #
# ##### # ##### ##### # # # ####### ####### # ### #
# #   # #     #     #   # #     #   #     #   #   #
# # # # ##### ##### ##### ##### # ### # ####### ###
#   # # #       # #   #   #   #     # #       #   #
# ### # # ##### # ### # ### # ####### ### ####### #
# #   # #     #     # #   # #   #   #   #     #   #
# # # # ##### ##### # ##### ### # # ### ##### # ###
# # # #       # #   #         #   #   # #   #   # #
# # ########### # ##### ########### # # # # ##### #
# #       #       #   #   #       # # #   #     # #
# ####### # ####### # ### # ##### # # ######### # #
#       # # #     # #   # #     #   # #     #   # #
####### # # # ### # ### ### ### ##### # # ### ### #
#     # # # # #   #   #   #   #   #   # #   # #   #
# # ### # # # ####### ### ####### # ### ### # ### #
# #     # # #       #   #       # #   # # # #     #
# ####### # # ##### ### ####### # # ### # # ##### #
#   #   #   # #   #   #     #     # #   # #       #
### # # ####### # ### ##### ######### ### #########
#     #         #         #                       #
###################################################
