#######################################################################################################################################################
#   #                 #           #           #     #           #         #           #   #     #         #           #             #       #         #
### ##### ####### # ### ######### # ### ####### ### # ##### ### ### ### # ### # ##### # ### # ### ### ### # ####### # # ######### ### # ### # ### ### #
# #     # #     # #       #       #   #     #     #       # #     #   # #   # # #   # # #   #     #   #   # #     # # #     #     #   #   # # #   #   #
# ##### # # ### ########### ### ##### ##### # ########### # ##### ##### ### ### # # # # # ######### ### ### ##### # ####### # # ### ##### ### # ### ###
#     # # # # # #           #   #     #   #     #       # #   #     #   # #   # # #   #   #     # #   # #   #     #     #   # # #   # #   #   # #   # #
# ### # ### # # # # ######### ### ##### # ####### ##### ##### ##### # ### ### # # ##### ### ### # ### ### ### ######### # ### # # ### # ### ### ### # #
#   # #     #   # # #   #   #   #     # #   #   #     #     #   # # #   #   #   #   #     # # #     #   #     #       #   #   # # #   # #   # #   # # #
# # ######### ### ### # # # ### ##### # ### # # ##### ##### # # # # # # # ######### ##### # # ### ##### ##### # ##### # ### # ### # ### # ### ### # # #
# #         # # #     #   #   #     # #   # # #     #   # # # # #   # # #         #   # #   #   # #     #     # #   # # # # # #   #   #   #   #   #   #
####### ### # # # ######### # ####### # # ### ##### ### # # # # # ##### # ### ####### # ##### ### # ### # ##### # # # # # # ### ### # ##### # # ##### #
#     # #   # # #   #     # #         # # #   #   # #   #   # # # #     # # # #     # #   #   #   # #   #   # # # #   # # #   # #   #       # #   #   #
# ### # ##### # ### # ### ########### ### # ### # # # ### ##### # # ##### # # # ### # # # # # # ### ####### # # # ##### # ### # ##### ####### ### # ###
#   # # #     #     #   #           #   # # #   #   # #         #   #   # # #     # # # #   # # # #       #   # #     #     #         #       # # #   #
# # # # # ############# ########### ### # # # ####### ############### # # # ####### # # ##### # # ##### ### ### ##### ######### ####### ####### # ### #
# # #   # #   #         #         # # # # # #   #         #           # # #   #     # # #   # #       #     #   #   # #       # #   #     #   # #   # #
# # ### # # # # ######### ######### # # # # ### # ####### # ####### ##### ### # ### # # ### # ### ########### ##### # # ##### # # # ##### # # # ### # #
# #   # # # #   # #                 # # # # # # # #   #   # #       #         # #   # #     #     #   #       #   #     #     # # #   #     #     # # #
# ### # # # ##### # ################# # # # # # ### # # ### ##### ### ######### ##### ##### ####### # # # ##### # ####### ####### ### ########### # ###
# #   # #   #     # #       #     #       # # #     #   #   #   # #   #       #     #   #   #   #   #   # #   # #   #   # #       # #   # #       #   #
### ### ##### ##### # ##### # ### # ####### # ########### ### # ### ### ##### ### # ### # ### # # ##### ### # # ### # # # # ### ### ### # # ######### #
#   #   #   #       # # #   #   # # #   #   #           #     # #   #   #   #   # #     #     # # #   # #   #   # # # #   #   #   #   # # #       #   #
# ####### # # ####### # # ### # # # # # # ### ####### # # ##### # ### ### ##### ##### ##### ##### # # # # ####### # # ####### ### ### # # ##### ### # #
# #   #   # # #   #   # #   # # # #   # #   #   #     # # # #   #   # #     #   #   #   #   #     # #   #   #   # # # # #   # #   #   # # #     #   # #
# # # # ### # # # # ### ### # # ####### ### ##### ####### # # ##### # ##### # ### # ### ##### ############# # # # # # # # # # # ### ### # # ##### #####
# # #   # # #   #   #     # # #     #   # # #   #           #     # #   #   # #   # #         #   #       #   #   # # # # #   # # #   # #       #     #
# # ##### # ######### ##### # ### # # ### # # # ######### ####### # ### # # # # ### # ######### # # ##### ### ##### # # # ##### # # # # ####### ##### #
#   #     #     #   #       # #   # #     #   #         # #     #     #   # #     # # #       # #   #   #     #     # # # #   # # # # # #     #   #   #
# ### ######### # # # ####### # ####### ########### ### ### ### ########### ####### ### ##### # ####### ####### ##### # # # # # # # # # # ### ##### # #
# #           # # #   # #   # #         #         #   #       #     #       #     #   #   #   # #           # #     # #     # # # # #   # # #     # # #
# ####### ##### # ##### # # # ########### ####### ### ########### # # ####### ### ### ### # ### # ######### # ##### # ######### # # ##### # ##### # # #
#   #   #     #   #     # # #   #         # #     #   #   #     # # #   #     # #   #     #   # #   #     # #   #   #           #         #     #   # #
### # # ### # ######### # # ### # ######### # ##### ### # # ### # # # ### ##### ### # ####### # ### # ### # # ### ############# ########### ### ##### #
# #   #   # #           # #   # # #         #   #   #   #   # # # # # #   #       # # #     #     # # # #   # #   #           # #   #   #   #   # #   #
# ####### ##### ####### # # # # # ### # ### ### ##### ####### # ### # # ### ### # # ### ### ##### # # # ##### # ### ######### # # # # # # ### ### # ###
#     # #     #   #   # # # # # #   # # #     #       #       #   #   #   # #   # #   #   #     # # # #       #   #     #     # # #   # # #     # #   #
# # # # ##### ### # # ### # ### ### ### ### ############### # ### # ##### ### ####### # # ##### # # # ### ####### ####### # ### # ##### # ##### # ### #
# # # #   # #   # # # #   #       #   #   # #             # # #   #     #   #       # # # #   # #   #     #     #     #   # #   #   #   #   #     # # #
### # # # # ### # # # # ############# # # ### ####### ### # ### ####### ### # ##### # ### # ### ####### ### ### # ### # ##### ##### # ### # ##### # # #
#   #   #     # #   #   #     #       # #           # #     #   #   #     # # #     # #   #   #       # #   #   # #   #   #   #     #   # #   #     # #
# ##### ####### # ########### # ############# ####### # ##### ### # # ##### ### # ### # ##### ####### ### ### ##### ### # # ### ####### ##### ####### #
#   #   #   #   #             # #       #   # #       #   #   #   # #   #   #   # #   # #       #   #     # # #     # # #   #   #   # #   #   #       #
# # # ### # # ##### ######### # ### ### # # ### ######### # ##### # ### # ### ##### ### # ####### # ####### # # ##### # ##### ### # # ### # ### #######
# # #   # #   #     #     #   #   # # # # #   #         # # #     # #   #   #     #     #   #     #             #     #   # # #   #   #   #   #   #   #
# # ##### ########### ### ####### # # # # ### ######### ### ### ### ####### ##### ####### # # ################### # ##### # # # ##### # ### # ### # # #
# # #   # #           # #   #     # # # # # #   #       #   #   #   #       #   #         # #   # #       #     # #         # # # #   # #   #     # # #
# # # # # # ########### ### # ##### # # # # ### # ##### # ### ### ### ##### # # ### ####### ### # # ##### # ### ############# # # # ### # ########### #
# #   #   #     #           #     # #     # #   # # #   #     # # #     #   # #   # #     #   # # #   # #     #     #       #   # #   # # # #         #
# ######### ### ##### ########### # ####### # ### # # ######### # # ### ##### ### ### ### # ### # ### # ##### ##### # ##### ##### ### # # # # # #######
# #     #     #     # #     #     #   #     # #   # # # #         #   #       # #     #   # #   # #     #   #   #   # #   #   #     # # # #   #       #
# # ##### ######### # # ### # ##### # # ##### # ### # # # ########### ######### ####### ### # ### # ##### # ##### ### # # # # # ### # # # ### ####### #
# #       # #       # # # #   #   # # #         #   # # # #         # #       # #     # #     #   #   #   #     # #   # # # # #   #   # #   #     #   #
# ##### ### # ####### # # ##### ### # # ######### ### # # ######### # # ##### # # ### # # ####### ### # ####### # # ### # # ##### ##### ### ####### # #
#     #   # #   #   #   # #       # # #   #     #   #   #   #     #   # #   # #   #   # #         #   #     #   # # #   # # #     #   # #   #       # #
##### ### # ### # # ##### # ##### # # ##### ### # # ### ### # ### ### # # # # # ### ### # ####### # ####### # ### # ##### # # ##### # # ### # ####### #
#   # # #     #   #     #     #   # #   #   # # # #   #   #   # #   #   # # # #   # #   # #     # # #     # #   #     #   #   # #   # #   # #     # # #
# ### # ##### ####### # ##### # ### ### # ### # ### ##### ##### ### ##### ### # ### # ### # ### ### # ### # ### ##### # ##### # # ### ### # ### # # # #
#     #     #   #   # # #   # # #   # #       #   #     #     #   #   #   #   # #   #   # # # #     # #   #   #   # # # #   #   # # #     #   # # #   #
# ##### # ##### # # ### # # # # # ### ########### # ### ##### # ##### ### # ### # ##### ### # ######### ##### ### # # # # # ##### # ######### # # #####
#     # # #     # #   # # # # # #   # #           #   #   #   # #   #   # # #   #     #     # #       #     # #   # #   # #       # #   #   # # #     #
##### ### # ##### ### # # # ### ### # # ####### ####### # # ### # # ### # # ### ### # ####### # # ### ##### # # ### ### # ######### # # # # # # ##### #
#   #   # # #   # #   #   # #   #   # #   #     #     # # # #   # #     # #   #   # #     #   # # #   #     # # #       #     #   #   # # # # #     # #
# ##### # # ### # # ####### # ### ### ### # ##### ### # # # ### # ####### ### ##### ##### # ### # # ### ### # # ### ######### # ### ### # # # ##### # #
#     # #   #   # # #       # #   #   # # # #   # # # # #       #   #     #   #     #   # #     # #   # #   # #   # #         #       # # # #   #   # #
# ### # # ### ### # ### ##### # ### # # # # # # # # # ####### ##### # ##### ### ##### # # ##### # ### # # ### ### ### ################# # # ### # ### #
#   #   # #   #   # #   #     #   # #   # # # #     #     #   #   # #     #     #     # # #   # # # #   #   # #     # #       #       # # # #   # #   #
### ##### # # # ### # ### ### ### # ### # ### ####### ### # ### # # # ### ########### # # # # ### # ####### # ##### # # ##### # ##### # # # # ##### # #
#   #   #   # #   # #   # # #     #   # #       #   #   # # #   # # #   #             # #   #     #       # #     #   # #   #   #     #   #   #     # #
# ##### ##### ### # ### # # ####### # # ######### # ##### # # ### # ### ####### ##### ################# ### ##### ### # # ####### ##### ####### ##### #
# #   #       # # # #   # # #     # # # #       # #       # # # #   #   #     #     # #               #   # #   #   # # #       #     # #   #       # #
# # # # ####### # # # ### # # # ### # # # ##### # ######### # # ##### ### ### ##### ### ##### ####### ### # # ##### ### ### # ####### # # # ### ### ###
#   # #         # # # #   #   #     # # #   # # #   #   #   # #   #       #     #   #       # # #     #   # #     #   #   # #       # # # #   #   #   #
##### ### ####### # # # ############# # ### # # ### # # # ### # # # ####### ##### ### ####### # # ##### # # ### # ### ### ######### # # # ### ####### #
#     #   #     # #   # #           # # #   # #     # # # #   # #   # #   # #   #   #   #   # #   #   # # #     # # #   #     #   # # # #   #         #
# ######### ### # ##### # ######### # # # ### ####### # # # ####### # # # ### # ### ### # # # # ### # # ######### # ### ##### # # # # # ### ######### #
# #         #     #   # # #       #   # # #         # #   # #     #   # # #   #   #   # # #   #     #   #       # #   #     #   #   # #     #   #     #
# ### # ########### # # # ##### # ##### # # ######### ##### # ### ##### # # ##### ### # # ######### ##### ### # # ### ##### ####### # ####### ### #####
#   # #     #   #   # # #     # #   # # # #         #     #   # #       # #   #     #   #   #     # #     #   # # #   #   #       # # #     #   #   # #
### # ##### # # # # ### ##### # # # # # # ##### ### # ######### ######### ### ##### ##### # # ### # # ##### ##### # # # # ### ##### # ##### # # ### # #
# # # #     # # # #   #   #   # # #   # #     #   #   #         #       #   #   #       # # # #   # # #   #     # # #   # # #       #     #   #   # # #
# # ### ##### # ##### ### # ### # ### # ##### ### ##### ##### # # # ### ### ### ####### ### # ##### # # # ##### # # ##### # ############# ##### ### # #
# # #   #     #     #       #   # #   #   # #   #     #   # # # # #   #   #   #   #         #       # # # #     #   #               #   # #   #   #   #
# # # ### ######### ########### # ####### # ### ##### ### # # # ##### ####### # # ######### ######### # ### ######### ####### ####### # # # # ### ### #
#   #       #     #           # #       # #   # #     #   # # #       #       # # #     #   #   #       #   #       # #   #   #     # #   # #       # #
# ######### ### # ########### # ####### # ### # ####### ### # ##### ### ######### # ### # ### # # ####### # # ##### # # # ##### ### # ##### ##### ### #
# #     #     # # #     #     #       #       #       # #   #     # #   #         #   # #   # #   #   #   # # #   #   # #       #   #   #       # #   #
# ### # ##### # # # ##### ####### ################### # ### ##### # # ##### ######### # ##### ##### # # ##### # # ##### ######### ##### # ##### # # ###
#     #   #     #   #     #     # #         #         #   #     # # # #     #   #   # #       #     # #       # # #   #   #     # #     #     # # #   #
######### # ######### ##### # ### # ####### # ### ####### # # ### ### # ##### # # # # ######### ##### ######### # # # ### ##### # # # ######### ##### #
#     #   # #     #   #     #     # #     # #   # #       # #   # #   # #   # # # #   #     #     # #   #   # # #   #     #   #   # # #     #   #   # #
# ### # ##### ### # ### ########### # ##### ### ### ####### ### # # ### # # # # # ####### # # ### # ### # # # # ########### # ### ### # ### # ### # # #
# #   # #     # #   #   #   #     # #   #       #   #     #   # # #   #   #   #   #     # # #   # #       #   # #           #   #   #     # #     #   #
### # # # ##### ######### # # ### # # # # ####### ### # ##### # # ### ##### ####### ### # # ### # # ######### # # ############# ### ##### # # #########
#   # #   #           #   #   # # # # #   # #     #   #       # #   #     #   #     # # # #     # #   #   #   #   #       #   # # #     # # #   #     #
# ######### ######### # ####### # # ##### # # ######### ####### ### ##### ### # ##### # ####### # ##### # ##### ##### ### # ### # ##### # # ### ##### #
# #     # #       #     # #     # #     # # #   #     #   #       #       #   #     #         # #       # #   #       #   #   # #   #   # #   # #     #
# # # # # # ##### ####### # ### # ##### # # ### # ### ### # ############### ##### # ######### ########### # # ######### ##### # # ### ### ### # # ### #
# # # # #       #     #       #   #   # #   #   # #   #   #   #         #   #   # #   #           #     # # # #       # #     # #   #   #   # #   #   #
# # # # ##### ##### # ########### # # # ##### ### ### ####### # ##### ### ### # ##### # ######### # ### # # # ####### # # ##### ### ### ### # #########
#   # #     # #   # # #         #   #   #     # #   #       #       #     #   #   #   # #       # #   #   # #       # # # #     #   # #   # # #       #
##### ##### ### # ### # ####### ######### ##### # # ####### ####### ####### # ### # ##### ##### # # # # ### ####### # # # # ##### # # ### ### # ##### #
#     #   #     #   # # #     #   #       # #     #   #   #   #   #   #   # # #   #     #   #   # # # # #   #     # #     # #     #   # #   #       # #
# ##### ##### ##### # # # ### ### # ####### # ####### # ##### # # ### # # ### # ####### ### ### # ### ### ### ### # ####### # ####### # ### ####### # #
# #   #       #   #   # #   # #   #   # #     #       #   #   # # #   # #     # #     #   #   # #   #   #   # #   #         #   #         #   #     # #
# # ### ####### # # ### # # # # ##### # # ##### ######### # ### ### ### ####### ### # ### ### # ### ### ### # ### ########### # # ########### # ##### #
# #       #     # # #   # # # #   #   # #   #   #     #   # #           #     # #   #   #   # #   #     #   #   # #   #       # # #   #       #     # #
# # ####### ##### ### ##### # ### # ### ### # ### ### # # # ############### # # # ##### # # # ### ##### # ### # # # # # ####### # # ### ############# #
# #   #   # #   #   # #     # # #   # #     #       # # # #       #         # #   #   # # # #   # #   # # #   # #   # #     #   # #   #             # #
# ### # # # # # ### # # ##### # ##### # ############# # ######### # ##### ### ##### # # # ##### # # # ### # ### ##### ##### # ### # # ############# # #
#   # # #   # #   #   #   # #   #     # #     #       #         # # #     #         # #   #     # # #     #   # #   # #   # # #   # #     #       # # #
# # ### ####### # ####### # ### ##### # ##### # ####### ####### # # # ############### # ### ##### # ########### ### # # # ### # ### ### # # ### # # # #
# #     #     # #         #     #     #       #     #   #     #   # # #       #     # # #   #   #   #         #   # #   #   # # # # # # # # # # # #   #
# ####### # # # ########### ##### ### ####### ##### ### # # # ##### # # ##### # ### ### # ### # ##### ####### # # # ####### # # # # # # ### # # # ### #
# #       # # # #   #       #     #   #   #   #   #   # # # #   #   # # #     #   #     #     #       #   #   # # # #     #   # #     #   # # # #   # #
# # ####### # # # ### ####### # ####### # # ### ##### # ### ### ##### # # ####### ##################### # # ### # # # ### ##### ######### # # # ##### #
# # #   #   #   # #   #       # #       # #   #     # # #   # #     #   #       # #         #           # #   # # #     #     #   #       # # #       #
# ### # # ####### # ##### ####### ####### ### ### ### # # ### ##### ##### ##### # # ##### # ### ######### ### # # ##### ### ##### # ##### # # #########
# #   # # #       #     # #             #   # #   #   #   # #     # #   #     # # # #     #   #     #   # # # # #     #   #     #   #     # #         #
# # ### # # ##### ##### # # ########### ### # # ### ####### # ### # # # ##### # # ### ####### ##### # # # # # ### ### ####### ##### ####### ##### # # #
# #   #   # #   #   #   # #     #     # #   # #   #   #       #   #   # #     #       #     #       # #   # #   #   # #     #       #     #     # # # #
# # # ##### # # ### # ### ##### # ### ### ### # # ### ####### # # ##### # ############# ############# ##### ### ### # # ### # ####### ### ##### # # # #
# # # # #   # #   #   #     #   # # #     #   # #   #       # # #   #   #   #   # #       #     #   #   #     #   # # #   # #   #     # #     # # # # #
# ### # # ### ### ##### ### # ### # ##### # ##### # ####### ### ##### ### ### # # # ##### # # ### # ### ### # ### ### ### # # ### ##### ##### # # # ###
# #   #   #   # # #   # # # # # # #       # #     # #       #   #   # #   #   # #   #   #   # #   #   #     #   #   # #   # # #   #   #   #   # # #   #
# # ##### # ### # ### # # # # # # ### ##### # # ##### ####### ### # # # ### ### # ### ####### # ### ########### ### # # ### ### ### # # # # ### # ### #
# #     # # #   #   #     #     #   # #       # #   # #   #     # #   #   #   # #     #       #   # #           #   # # # #     #   #   # #     # #   #
# # ### # # # # ### ############### ### ######### # # ### # ### # ########### # ####### ######### # # ########### ### # # ####### ####### ####### # ###
# # #   # # # #     #             #     #       # #   #   #   #   #           #   #   # #         # #           # #       #     #     #   #     # #   #
# ### ### # # ####### ########### # ##### ##### # ##### ##### ####### ########### # # # # ######### ########### # ####### # # ### ### # ##### ### ### #
#   #   #   #   #     #   #   #   #     # #   #   #         # #       #   #     #   # #   #       #   #     #   #       # # #     #   #     #       # #
### ### ####### # ##### # # # # ######### ### ##### ####### # # ####### # ### # ##### ##### ##### # ### # ### ######### # ### ##### ####### ######### #
# #   # #       # #     #   # # #         #   #   #   #   # #   #       #     # #   #       #   # # #   #   #       #   #   # #   #   #   #         # #
# ### # # ##### # ####### ### # # ######### # # # ### # ### ##### # ########### ### ######### ### # # ##### # ####### ##### ### # # # # ########### # #
# #   # # #   #   #     #   # #   # #       # # # #     #   #   # #           #   #   #       #   # # #   #   #       #   #     # # # #     #     # # #
# # ### ### # ##### ### ##### ##### # # ##### # # ####### # # # # ########### ### # # # ##### # ### # ### ##### ####### ######### # # ### # # ### # # #
#   #       #     #   #     #     #   #     #   #         # # # # # #       # #     #   #   # # #           #   #       #       # # #   # #   #   #   #
# ####### ####### ### ##### ### # ######### ####### ##### ### # # # # ### ### # ######### # # # ########### # ######### # ##### # ##### # ### ####### #
#       # #     #   #     #   # # #         #       #   # #   # # # #   #   # # #     #   #   #     #   #   #         #   #   # #   #   # #   #     # #
####### # ### # # ####### ### # # # ##### ########### # ### ### # # # ##### # ### ### # ########### # # # ####### ### ##### # # ### # ### ##### # ### #
#   #   # #   # #         #   # #   #     #       #   # #   #   # #   #     #   # # # #           # # # #   #   #   #     # #     #   #       # #   # #
# ### ### # ### ##### ##### ### ##### ##### ##### # ### # ### ### ### # ### ### # # # ######### ### # # ### # # ##### ### # ################# # ### # #
#     #     #   #   #     # # #   #       # # #   # #   # # #   #   # # #     # # # # #   #   # #   # #     # #     #   # #   #             # # # #   #
# ########### ### # ##### # # # # ####### # # # ### # ### # ### ### ### # ##### # # # # # # # # # ### ####### ##### ##### # # # # ######### # # # #####
#       #       # #   #   # #   #   #     #   #     #   # #   #   #   # # #   # # # #   # # # # # # # #     #   #   #     # #   # #     #   # # #     #
####### # ####### ### ### # ####### ##### ### ####### # # # ### ##### # ### # # # # ##### # # ### # # # # ##### # ### ##### ##### # ### # ### # ### # #
#   #   # #     # #     # #       #     #   #   #   # # #   #   #     #     # # #   #   #   #     #     # #     #   # #   # #   # #   # #     #   # # #
# ### ##### ### # ##### ######### ##### ####### # # ### ### # # # ##### ##### # ### # # ########### ####### ####### # # ### ### # ### # ######### # # #
# #   #     # # #     #   #     # #     #     # # #     #   # # #     #   #   # #   # # #   #     #   #   #   #   #   #   #     #   # #     #   # # # #
# # ### ##### # ##### ### # ### # # ##### # ### # ####### ### ####### ##### # # # ### # # # ### # ##### # ### # # ##### # ##### ### # ##### # # # ### #
#       #             #     #     #       #     #           #               # #       #   #     #       #     # #       #         #       #   #       #
#######################################################################################################################################################
