###################################################
# #           # #                 #         #     #
# ##### ##### # # ############# ### ##### ### ### #
#       #   # # # #           #       #   #   # # #
########### # # # # ######### ####### # ### ### # #
#   #       # #   # #   #   #       # #   #     # #
# # # # ### # ##### # # # # ####### # ### ### ### #
# #   # #   # #     # #   # #   #   # # #   # #   #
# ##### # ### # ##### ##### # # # ### # ### # # ###
#   #   # # #   #     #   # # #   # #     # # #   #
##### ### # ##### ### # # ### ##### ##### # # ### #
#     #       # #   # # # #   #     #     #     # #
# ########### # ### # # # # ##### ### ########### #
#         # #     # #   #   #   #   #   #   # #   #
# ####### # ##### # ######### # ### ### # # # # # #
# #     # #       #     #   # #   #   #   #   # # #
# # # ### ############# # # # ### # ######### # ###
#   # #   #           #   # #   # #     #     #   #
# ##### # # ##### ### ##### # # # # ### # ####### #
# #     # # #   # #     #   # # # # # # # #       #
# # ### ### # ### ####### ##### # # # # # # #######
# #   # #   #   #         #     # #   # # #       #
# ### # # ##### ########### ##### ### # # ####### #
# #   # # #   #     #       # #   #   #     #   # #
# # ##### # # # ### ####### # # ############# # # #
# #   #   # # #   #         # # #         #   #   #
# ### # ### # ### ########### # # ####### # ##### #
#   # #     #     #     #       # #       #   #   #
# ### ############# # ### ####### ####### ### # ###
# #   #     #       #     #             #     #   #
### # ### ### ################### ##### ######### #
#   #   #   # #                 #     # #       # #
# ##### ### # # ############### # ##### # ####### #
# #         #   #   #     #   # # #     # #       #
# ### ########### # # # # ### # ### ##### # #######
#   #   #   #   # #   # #   # # #   #       #     #
# # ##### # # # # ##### ### # # # ##### ####### # #
# # #   # #   # # #   # #     # #     # #     # # #
# # # # # ##### # ### # ####### # ### # ### # ### #
# #   #       # # #   #         #   # #     #   # #
# ############# # # # ############### ######### # #
#   #     #     # # # #           #   #   #   #   #
### ### # # ##### # ### # ####### # ### # # # ### #
#       # #     # #     # #   #   # #   #   # #   #
# ############# # # ##### ### # ### ######### # ###
# # #     #     # #     #   #   #     #       #   #
# # # ### # ### # ######### # ####### # ##### ### #
#   # #     #   # #       # #   #     # #       # #
### # ########### # ##### # ### # ##### ######### #
#   #               #       #     #               #
###################################################
