#############################################################
# #       #             #     #         #                 # #
# # ##### ##### # ##### # # # ### ##### ########### ##### # #
#   #   #     # # #   # # # #     #   #   #   #     #   # # #
##### # ##### ### # # # ### ####### ##### # # # ##### # # # #
#   # #     #     # # #   #   #     #   #   # #   # # #   # #
# # # ##### ####### # ### ### # ##### # ##### # # # # ##### #
# # # #         #   #   # #   #       #   #   # # # # #     #
# # # # ####### # ##### # # ### ######### # ### # # # # ### #
# #   # #   #   #   #   #   #     #       #   # # #   # #   #
# ##### # ### ### # # ############# ##### ### ### # ### ### #
# #     #   #   # # #   #           #       #     # #     # #
### ####### ### # # ### ##### ####### ############# ##### # #
#   #         # # #   #       #     # # #           #     # #
# ##### ##### # # ### ########### # # # # ########### ##### #
# #     #     # # # #     #       # # # #       #     #   # #
# # # ####### # # # ##### # # ##### # # ####### # ####### # #
# # # #     # # #       # # #     # #   #     # #       #   #
# # ### ### ### ### ##### # ##### ##### # # ### ### ### # ###
# #       #   #   # #     #   # #   #   # #   #   #   # #   #
# ########### ### ### ####### # ### # ### ### ### # ### #####
#   #     #     #     #     #   # #   # # # #   # # #   #   #
# # # ### # ############# # ### # ##### # # ### # # # ### # #
# #   # # #         #   # # #   #   #   # # #   # # #     # #
# ##### # ####### # # # # # # ### # # ### # # ### ######### #
# #     #     #   #   # # # # #   # #     # #   #         # #
# ### # ##### # ####### ### # ### # ### ### ### ######### # #
#     # #     #   #         #     #   #       # #       #   #
### ##### ####### # ####### ######### # ##### # # ### # ### #
# # #   #   #     # #   #     #   #   # #   # # #   # #   # #
# # # # ### ### ##### # # ##### # # ##### # ### ### # ### # #
#   # #     #   #     # #   #   # # #     #   # #   # # # # #
# ### ####### ### ##### ##### ### # # # ##### # # ### # # # #
#   #   #     #   #   #       # # # # #   #   # #   # #   # #
### ### ##### # ### # ####### # # # ##### # ### ### # ##### #
# # #   #   #     # #       # # # #     # #       # #       #
# # # ### # ####### ####### # # # ##### # ####### # #########
# # #     # #     # #   #   # # #     # # #   #   #       # #
# # ####### # ### # ### # ### # ### # # # # ### ######### # #
# #   #   #   #   #     #   #   #   # #   # #   #       # # #
# ### ### ##### ####### ### ##### ######### # ### # ### # # #
#   #   #     #       # #   #   #   #     #   #   # # # #   #
# ##### # # ##### ##### # ### # ### # ### # ### ### # # ### #
# #     # #     #       #     # #   #   # # # #   # #   #   #
# # ##### ##### ############### # ##### # # # ### # ##### ###
# #     #   #     #     # #   # #       # # # #   #     # # #
# ##### ### # ### # ### # # # # ######### # # # ####### # # #
#     #   # # #   #   #   # #   #         # #   #       # # #
# ### ### ### # ### # # ### ##### ##### ### # ### ####### # #
# #     # #   # # # # # #   #     #     #   #   # #       # #
# # # ### # ### # # # ### ### ########### ####### # ####### #
# # # #   #   # #   #   # # #               #     # #   #   #
# # ### ##### # # ##### # # # ############# # ##### # ### # #
# #   #       # # #   # # #   #     #     # #   #   #     # #
# ### ######### # # # # # ##### ### # ### # ### # ####### # #
# # #         # # # #   #     #   #   # # #     #       # # #
# # ### # ##### ### ### ##### ### ##### # ############# ### #
#   #   # #   #     # # #   #     #   # #   #     #   #   # #
### # ##### # ####### # ### ####### # # ### # ### # # ### # #
#   #       #                       #     #     #   #       #
#############################################################
