###############################################################################################################
# #           # #               #       #       #   #             #           #   #         #       #   #     #
# ##### ##### # # ############# # ### # ##### # # ### ### # ####### ##### ### # # # ####### # # ### ### # ### #
#       #   # # # #           #     # # #     #   #   #   # #           #   # # #   #     # # # #   #   # #   #
########### # # # # ######### ####### # # ######### ### ### # ########### # ### ####### # # # # # ### ### # ###
# #         # #   # #     # #       # #   #         # #   # # #     #   # #   #       # # #   # # #       #   #
# # ### ### # ##### ### # # ####### # # ### ##### ### ### ### # # ### # ##### ####### ### ##### # ### ####### #
#   # # # # # #     #   #   #   #   # # #   #   #       #       # #   #       #     #     #     #   #     #   #
# ### # # # # # ##### ##### # # # ### ### ### # ######### ####### # ######### ##### ##### # ####### ##### # ###
#     # #   #   #     #   # # #   #         # #     #   # #   # # # #   #   # #     # #   # #   # #     # #   #
##### # # ####### ### # # ### ##### ######### ##### # # ### # # # # # # ### # # ### # # ### # # # ##### ##### #
#     # #     # #   # # # #   #     #         #       #     # #   #   #   #     #     # # #   # #   #   #   # #
##### # ##### # ### # # # # ##### ### ##### ################# ######### # ########### # # ##### # # # ### # # #
#   # # #   # #   # #   #   #   # #   #   # #   #   #         #       # # #   #     # # # #     # # #     # # #
# # # # # ### # # # ######### # ### ##### # # # # # # ####### # ##### ### # # # ### ### # # ####### ####### # #
# # # # #       # #     #   # #   #     #   # #   # #   #   #   #   #   # # #   # #   #   #   #   #   #     # #
# # ### # ############# # # # ### # ### # ### ##### ##### # ##### ##### # # ##### ### ### ### # # ### # ##### #
# #     # #           #   # #   # # #   # # # #   #       #     # #     #   #       #       # # #     #     # #
# ####### # ##### ### ##### # # # ### ### # # # # ############# # # ##### ### ##### ######### # ### ####### # #
#   # #   # #   # #     #   # # # #   #     #   #   #           #   #       #   #   #   #     #   # #     # # #
# # # # ### # ### ####### ##### # # ######### ##### # ############# ####### # ### # # ### ####### # # ### # # #
# # # # #   #   #         #     # #           #   # # #           #       # # #   # # #   #       # #   #   # #
# # # # # ##### ########### ##### # ########### # ### # ######### ####### # ### ### # # ### # ######### ##### #
# # #   # #   #     #       # #   #   #     #   #   #       #   #   #   # #   # # #   # #   # #     #   #     #
# # ##### # # # ### ####### # # ##### # ### # ##### ######### # ### # ### ### # # ### # # ##### ### # ### # # #
# #   #   # # #   #         # # #   # #   # #   # #       #   #   # #     #     #     # #         # # #   # # #
# ### # ### # ### ########### # # ### ### ##### # ####### # ##### # # ########### ##### # ######### # # ### # #
# #   #     #     #     #       # #   #   #     #           #   #   #     #   #   #     #   #       # # #   # #
### # ############# # ### ####### # ### # # ### ############# # ######### # # ##### ####### # ##### # ### ### #
#   # #     #       #     #       # #   # #   # #         # # #       #   # #     #     #   # #     # #   #   #
# ### ### # # ################### # # ####### ### ####### # # ####### # ### ##### ##### # ### # ##### # #######
# # #     # # #                 # # #       #   #       # # #   #   # #   # #   # #     #   # #   #   #       #
# # ####### # # ############### # # # ##### ### ### ##### # ### # # # ### # # # # # ####### # ### # ####### # #
# #   #     #   #   #       # # # # #     #   #   # #     # #   # #   # #   # # # # #       #   # # #     # # #
# # ### ######### # # # ### # # # # ####### # ### # # ##### # ### ### # ##### # # # ########### # # # ### ### #
# #   #   #     # #   # # #   # # #   #   # # # #   #   #       #   #         # #   #   #     # # #   # #     #
# ### ### # # # # ##### # ### # # ### # # # # # ####### ####### ### ########### ##### # # ### # # ##### ##### #
#   #     # # # # #   # #     # #     # #   #   #     #     # #   #           #       #   # #   # #     #     #
# # ####### # # # # # # ####### # ##### ####### ### # ##### # ### ########### ############# ##### # ### # #####
# #         # # # # # #         # #     #     #   # #     # #     #     #   #   #               # #   # #     #
# ########### ### # # ########### # ####### # ### # ####### ### ### ### ### ### # ############# # # # # ##### #
# # #       #   # # #           # #       # #   # #       #   # #   # #     #   #     #       #   # # # #     #
# # # ##### # # # # ############# # ##### # ##### ####### ### # ### # ##### # ####### ### ### ##### # # # #####
#   #     # # # # #       #       # #   # #     #   #     # # #   # #     # #       # #   # #     # # # # #   #
### ##### # ### # # ##### # ####### ### # # ### ### # ### # # ### # # ##### ####### # # ### ##### ### # # ### #
#   # #   #     # # # #   # #   #   #   # # # #   #   #     #   # # #       #   #   # #   #     # #   # # #   #
# ### # ####### # # # # ### # # # ### ### # # ### # ########### # # ##### ##### # ### ### # ##### # ### # # # #
#   # # #   #   # #   #       # # #     # #     #   #     #     # #     # #     #   #   # # #       #   # # # #
### # # # # # ### ### ######### # ##### # ####### ### ### # ##### # ### # # ####### ### # # # ########### # ###
#   # # # # #   # # # #   #   # #       # #     #   # #     #     # #   # # #     # # # # #   # #         #   #
# ### # # ##### # # # # # # # # ####### # # ### ##### ####### ####### ### # # ### # # # # # ### # ########### #
# #   # #       # # #   # # # #   #     #   # # #   #   #   # #       #   # #   #   # # # # #   # #     #     #
# ### # # ####### # ##### # # ### ### ####### # # # ### # # # # ####### ### ### ##### # # # # # # # ### # ### #
#     # # # #     #       # # #     #         #   #   #   # # #     #       #   #   #   # #   # #   #   # #   #
### ### # # # ##### ####### # ##### ####### ######### ##### # # ### ######### ### # # ### ### ####### ### # ###
#   #   #   # # #   #       # #   #       # #           #   # # # # #         #   # # #   #   #     #   # #   #
# ### ##### # # # ### ####### # # ####### ### ######### # ### # # # # # ######### # # # # ##### # # ### # #####
#   # #     # #     #       #   #     #       #   #   # # #   #   # # # #   #   # #   # # #   # # # # # #     #
### # ####### ############# ######### # ####### # # # # # ### ### # # ### # # # # ####### # # # # # # # ##### #
# # #       #       #       #   #     # #       # # #   #   #   # # #     #   # #       #   #   # # # # #     #
# # ####### ####### # ####### ### ##### # ####### ######### ### ### ########### ####### ##### ### # # # # ### #
#   #     #       #   #       #   #   # #     #           # # #         #     #       # #   # #   #   #   # # #
# ### ### ### ######### ####### ### # # ##### ########### # # ######### # ### ####### # # # ### ########### # #
# #     #   #           #       # # # #     #   #       # # #         # # # #     # # # # #     #   #   #   # #
# ######### ######### ### ####### # # ##### ### # ####### # # ######### # # ### # # # # # # ##### # # # # # # #
#     #   #       #   #   #   #     #     # #   #       #   # #         # # #   #   # #   # #     # # #   # # #
##### # # ####### # # # ### # # ####### ### # ### ##### ##### # ######### # # ##### # ####### ##### # ##### # #
#   #   #     #   # # # #   #       # # #   # # # #   #   #   # #       #   # #     #       # #     #     #   #
# ########### # # # # # ########### # # # ### # # # # # # # ### # ### ##### # # ########### # # ### ##### #####
# #   #         # # # #   #   #   #   #   #   #     # # #   #   # # #   #   # # #         #   # # # #   #     #
# # # # ########### # ### # # # # ######### ######### # ### # ### # ### # ### # # # ##### ##### # # ### ##### #
# # #   #   #       #   # # #   #   #     #         # #   # # #       #     # # # #     #     # # #   #     # #
# # ####### # ####### ### # ####### # ### # ####### # ### ### ####### ####### # ### ### ##### # # ### # ### # #
#   #       #   #   # #   # # #     # # # # #     # # # #   #       #     #   #   # #   #   # # #   # #   # # #
# ##### # ##### # ### # ### # # ##### # # ### ### # # # ### ####### ##### # ##### ### ### ### # # # # ### ### #
#       # #     # #   #     # # # #   #   #   # #   # #   #     #   # #   #     # #   #       # # #     # #   #
######### # ##### # ######### # # # # ### # ### ##### ### ### ### ### # ####### # # ### ####### ####### # # ###
#       # # #       #         # # # #   #   # #     #   #   #     #           # #   #   #     # #     #   # # #
# ####### # # ####### ### ##### # # ### ##### # # # ### ### ################### ##### ### ### # # ### ### # # #
#         # # #   # #   #       #     # #   # # # #   # #   #                   # #   #   # # # #   #   # #   #
########### # # # # ### ############# # # # # # # ##### # ### ##### ############# # ### ### # # ### ### ##### #
#     #   # #   # #   #   #   #     # #   # # # #       #       #   #   #       #   # # #         # # #   #   #
# ### # # # ##### # # ### # # # ### ####### # # ################# ### ### # ##### ### # ########### # ### # ###
# # #   #   #   # # #   #   #   # #     #   # #   #     #       # #       #   #   #   #   #       # #   # #   #
# # ########### # # ### ######### ##### # ### ### # ### # ##### # ### ####### # ##### ### # ##### # # # # ### #
# #   #         # #   #   #           #   #     # #   # # #     #   # #     # # #       #   # #   #   # #   # #
# # # # ### # ### ### ### ########### ##### ### # ### # # # ####### # # # ### # # ##### ##### # ####### ### # #
# # # #   # # #       #           #       # #   #     #   #     #   #   # #   #   #   #     # #       # # # # #
# # ##### # ### ################# # ##### ### # ############### # ######### ######### ##### # ### # ### # # # #
# #       #     # #       #   # # #   # # #   #             # #   #   #   #         #     # #   # # #   # # # #
# # ############# # ##### # # # # # # # # # ############### # ##### # # # ### ##### # ### # # # # # # ### # # #
# #   #   #       # #   #   # # # # # # # #   #     #     #     #   # # #   #   #   #   # # # # # # # #   #   #
# ### # # ### ### # # # ##### # # ### # # # # ### # ### # ##### # ### # ### # # ### ### # # # ### ### # # #####
# # # # #   #   # # # #   #   #       #   # # #   # #   #   #   # #   #   # # #   # #   # # #   #     # #     #
# # # # ### ### # # ##### # ########### ##### # ### # ##### # ### # ### # # ##### # ##### # ### ####### ### # #
# #     #     # # # #   # #       #   # #     #   #   #     #   # #   # # #     # #       # #   #     #   # # #
# ########### # ### # # # ####### # # # # ##### # ### ######### # ### # # ##### # ######### # ### # ##### # # #
# #         # #   #   #   #     #   # #   #   # #   # #         # #   # # #       #     #   # #   #   #   # # #
# # ####### # ### ####### # ### ##### ##### ### ### ### ######### # ##### # ####### ### # ### # ##### # ### # #
#   #     # #       #   #   # #   # #   #       # #     #         # #     # #     #   #   #         #     # # #
# ### ##### ####### ### ##### ### # ### ### ##### ####### ######### # ##### # ### ### ##################### # #
# #   #     #     #   #   #   #   #   #   # #           # #   #   # #   #   # # #     #     #         #     # #
# # # # ##### ### ### # # # # # ### ##### # # ######### # # # # # # # # ### # # ######### # # ####### # ##### #
# # # #   #   #   #     # # # # #     #   #   #       # # # # # # # # #   # # #           #   #   #   # #     #
# ### ### ### ##### ####### # # # ### # ####### ### ### # # # ### # ##### # # ### ############# ### ### # #####
#   #   #   #         #     # # #   # #     #     #       # #   #         # #     # #   #     # #   #   # #   #
### # # ### ########### ##### # ##### ##### ####### ####### ### ########### ####### # # # # # # # ### ### # # #
#   # #   #   #         #     #         #   #     #   #     # # #         # #     #   # # # #   #   #   #   # #
# ##### # ### # ######### ############# # ### ### ##### ##### # # ####### ### ### # ### # # ####### ### ##### #
#       #   #           #               #       #             #         #       #     #   #             #     #
###############################################################################################################
