###########################################################################################
# #     #             #     #           #       #           #             #   #           #
# # ### # ### ####### # ##### ##### ### ### ##### ####### # # ############# # # ####### # #
# #   # # # #     # # #         #   # #   #       #       # #             # #   #   #   # #
# ### # # # ##### # # ##### ##### ### ### ### ##### ####### ##### ####### # ##### # # ### #
#     # #   #   # #   #   # #     #   # #   #     # #     # #   #       # #   #   # # #   #
####### ### ### # # ### # ### ##### # # ### ##### # # ### # # # ####### # ### ##### # #####
#       #       # #     # #   #     #     #   #   #   #   #   #   #     #   #     # #     #
# ####### ####### ####### # ### # # ######### # ####### ######### ####### ####### # ##### #
# #   #   #   #   #   #     #   # # #         #   #   # #   #     #   #   #             # #
# ### # ### # # ### # ########### ### ########### # # # # # # ##### # # # # ############# #
#   #     # #   #   #   #       #   # #             # # # #   #     #   # # #   #   #     #
### # ##### ##### ##### # ##### # # # ######### ####### # ##### ######### # # # # # # ### #
#   # #   #     # #   # #     # # # #     #   # #       # #     #     #   #   # # #   #   #
# ### # # # ### # # # # ##### # # # ##### # # # # ####### # ####### ### ####### # ##### ###
# # # # # #   # #   # #   #   # # #     # # # # #     # # #   #     #   #       #   # # # #
# # # # # ##### ##### ### # ### # # ### # # # # ##### # # ### # # ### ### ####### # # # # #
# #   # #     # #       #   #   # # #   #   # #   #   #       # # #   #     #   # # # # # #
# ##### ##### # # ########### ### # ######### ### # ############# # ### ##### # # # # # # #
# #     # #   #     #   #     #   #         #   # #   #         #   #   # #   # # # # # # #
# # ##### # ##### ### # # ##### ########### ### ##### # ####### # ### ### # ### ### # # # #
# # #     #     # #   #   # #   #       #     #   #   # #   # # # #   #   #   #   # # #   #
# # # ######### ### ####### # ### ##### # # ##### # ### # # # # # # ##### ### ### # # ### #
# # # #       # #   #   #   # #   #     # # #     # #   # #   # # #   #   # # # #   #   # #
# # # # # ##### # ### # ### # ### # ##### # # ##### # ### ##### ##### # # # # # ##### ### #
#   #   #     #   #   #   #       # # #   # # #     #   # #   #   #   # #   # #       #   #
##### ####### ####### ### ### ##### # # ##### # ####### # # # ### # ### ### # # ### # # ###
#   #   #   #         # #   # #   #   #   #   #       # # # #     # #   #   # #   # # #   #
# ##### # # # ######### ### ### # ####### # ### ### ### # # ####### # ### ### ### # ##### #
#     # # # # #   #             #         # #   #   #   # #   #   # #   #   #   # #       #
### # # ### # # # ##################### ### # ### ### ### ### # # # ### ### ### # #########
#   # # #   #   #   #     #         # # #   #   #           #   #   #   # #   # # #     # #
# ### # # # ####### # ### # ####### # # # ##### ########### ######### ### # ### # ### # # #
# #   #   #   #   #   # #   # #     #   # #       #   #               #     #   #     # # #
# # ######### # ####### ##### # ### ##### ### ##### # ############# ######### ######### # #
# # #         #               #   # #   #   # #     #     #     #   #         #       # # #
# ### ######### # ############### ### # ### ### ######### # ##### ### ########### ##### # #
#   # #   #     # #             #     #   #   #   #   #   # #   #   #         #   #   #   #
# # # # ### ##### # ######### # ####### # ### # # # ### ### # # # ########### # ### # ### #
# #   # #   #   # # #   #   # #     # # #   # # # #     # #   #   #           #   # #     #
# ##### # ### # # # ### # # ### ### # # ### # ### # ##### # ####### ############# # #######
#     # #   # # # #   # # #     #     # #   #     #     # #     #   #             # #     #
##### # ### # ### ### # # ####### ##### # ############# # ##### # ### ######### # # ### # #
# #   #   # # #     #   # #   #     #   # #   #       # #     # # #   #         # #   # # #
# # ##### # # # ### # ### # # ##### # ##### # # ##### # # # ### # ##### ############# # # #
# #     # #   #   # # #   # # #   # # #     #   #   #   # #     #     #             # # # #
# ##### # ### ### ### # ### # # # ### # ######### # ##### ########### # ######### # # # # #
#     # #     #   #   # #   #   #   #   #   #     # #   # #         # #     # #   # # # # #
# ### # ####### ### ### # ######### ##### # # # ### # # # ### # ### # ##### # # ##### # # #
# #   #       #     #   #       # # #     #   # #   # # #   # # #   # #   #   # #   # # # #
### # ####### # ##### ######### # # # ######### # ### ##### ### # ### # ##### # # # # ### #
#   #     #   #   #   #       # # #   #       # # #       #     #   # #     # #   # #     #
# ##### ### ##### # ### ### # # # ##### ####### # # ##### ####### ### ##### # ##### ##### #
# #   # #   #   # #     #   # # #     # #   #   # #     #   #   # #   #   #   #       #   #
# ### # # ##### # ####### ##### ### # # # # # ### # ##### # # ### # ### # # ### ####### ###
# #   # #     #       #   #   #     #   # #   # # # #     #   #   #     # #   # #   #   # #
# # ### ##### # ####### # # # ######### # ##### # ### ####### # ######### ##### # # # ### #
# #   # #     # #       # # # #       # #     #     # #   #   # #       # #   #   #   #   #
# ### # # ##### # ####### # # # ### # # ##### ##### # # ### ### ##### # # # # ##### ##### #
#   #   #   #   # #       # # # #   # # #   #   # # # #       #       # # # #     #     # #
# # # ##### # ### # ####### # # # ### # # ##### # # # # ############### # # ##### ##### # #
# # #     # # #   #   #     #   #   # # #     # # # # # #   #         # #   #   # #   # # #
# # ####### # # ####### ########### # # ### ### # # # ### # # ### ### # ####### # # # # # #
# #         # #   #     #     # #   # #   # #   #     #   # # # # #   # #   #   # # # #   #
# ############### # ##### ### # # ####### # # ####### # ### # # # # ### # # # # # # # ### #
# #       #       # #     #   # #     #   # # #     # #   # #   # #   # # #   # #   # # # #
# # ##### ### ### # ### ##### # ##### # ### # # ### ##### # ### # ##### # ######### # # # #
# #   # # #   #   #   #     #       #       # # # # #     #     #   #   # #       # # # # #
# ### # # # ######### ##### ### ############# # # # # ############# # ### # ##### ### # # #
#     #   #   #     #       #   #     #     # # # #       #       # #   # # #   #   # #   #
####### ##### # ### ######### ### ### # ### # # # ####### ####### # ### # # # ##### # # ###
#     # #     # #           #   #   #   #   # #   #   #   #     # #     # # #       # #   #
# # # # # # ### # ############# ### ##### ### # ### # # ### ### # ####### # ### ##### ### #
# # # # # # #   #                 # #   # #   # #   # #     #     #   #   #   #       # # #
# # ### # ### ############### ##### # # # # # # # ### ### ####### # # ### ### ######### # #
# # #   #   #     #     #   #   #   # #   # # # #   # #   #   #     #       #   #       # #
# # # ##### ##### ##### # # ##### ### ##### # # ### # ##### # ############# ### # ##### # #
# # # #     #     #   # # #     # # # #     #   #   # #     #           #   #   #   #   # #
# # # # ### # ##### # # # ##### # # # # ######### ### # ############### ##### ### # ##### #
# #   #   # # #     #   # # #   # #   # #       # # #   #             # #   # # # #   #   #
# ####### ### # # ####### # # ### # ### ### # ### # ##### ### ######### # # # # # ### # ###
# #     # #   # # #       #   #   # #     # # #   #     # # #     #     # # # #   # # #   #
# # ### # # ##### # ####### ### ### ##### # # # ### ### # # ##### # ##### # # ### # # ### #
#   #   #   #     # #   #   #   # #     # # # #   # #   #     # #   #     # #   # # #   # #
##### ### ### # ### ### # ##### # ##### # ### ### ### ####### # ##### ##### ### # # ### # #
#   #   #     # #   #   #       #   #   #       #   # #       #         # #   # # #   #   #
# ##### ######### ### # ######### # # ####### ##### # # ############### # ### # # ### #####
#       #     #   #   # #         # # #     # #   # # #     #         # #   #   #     #   #
# ####### ### # ### ##### ##### ##### ### # ### # # # ##### # ####### # # # ######### # # #
#         #     #             #           #     #   #         #         # #             # #
###########################################################################################
