###############################################################################################################
#   #             #       #     #   #     #       #     #     #     #       #   #   #             #   #       #
### # ### ####### # ##### # ### # # # ### # ### ### # ### # # # # # # # ##### # # # # ##### ##### # ### ### # #
# # # # # #     # #   # #   #   # #   # #     #     # #   # # # # # # #       # # #   #   #   #   #     #   # #
# # # # # # ### # ### # ##### ### ##### ########### # # ### # ### ### ######### # ##### # ### # ######### ### #
#   # # # # # # # #     #   #   #     #     #     # # # # # #   #         #   #   #     #   # #           #   #
# ### # # # # # # # ##### # # # ##### # ### # ### ### # # # ### ######### ### ##### ####### # ############# ###
#   #   #     # # # #   # # # #     #   #   #   #   #     # # #         #           #       #     #       # # #
### ########### # ### # # # # # ######### ##### ### ####### # ######### ####### ######### ####### ####### # # #
# #             #     #   # # # #     #   #     # #     #   #     #   # #       #       #   #   #       # # # #
# ######################### ### # ### # ### ##### ##### # ### ##### # # # ####### ##### # ### # ####### # # # #
#       #   #             #   #     # #   # #   #       # #     #   #   # #       #   # # #   #   #     #     #
##### ### # # ####### ####### ##### # # ### ### # ####### ### # # ####### # ######### # # # ##### # ###########
#   # #   #   #     #       #     # #   #   #   #   #       # # #   # #   #   #     # # # #   #   #     #     #
# # # # ####### ######### ####### # ##### ### # ### ####### ### ### # # ##### # ### # # ##### ### ##### # ### #
# #   #     #           # #       #   #   #   # # # #   #   #     # #     # #   # # #       #   # #     # # # #
# ######### ######### ### # ####### ### ### ### # # # # # ### ##### ##### # ##### # ####### ### # # ##### # # #
#               #     #   #     #   #   #   #   # #   #   #       #   #       #   # #   #       #   #   # # # #
# ####### ##### # ### # # ##### # ### ### # # ### ######### ##### ### ####### ### # # # ############# # # # # #
# # #   # #   #   # # # # # #   #   # # # # #     #     #   #   #   #     #   #   # # #           #   #     # #
# # # # ### # ##### # # # # # ### ### # # # ##### ### ### ##### ### ##### # ### # # # ######### # # ######### #
#   # #   # #     #   # # # #   # #   #   #   #       #   #       #       #     # #       #   # # # #       # #
# ### ### # ##### ### # # # ### ### ##### ### ####### # ##### ### ########### ############# # ### # # ##### # #
# #   #   # #   #   # # #     #   #     #   #     # # #       # # #           #     #       #     # # #     # #
# # ### ### # ##### # # ######### ##### # ##### # # # ######### # # ######### # ### # ############# # ### ### #
# #   #     # #     # #         #       # #   # # # #     #   #   # #       # # # # #           #   #   #   # #
# ### ####### # ##### ######### ########### # ### # ##### # ### ##### ##### ### # # ##### ##### # ##### ### # #
# # # #   #     #   #       #   #       #   #   # #   #   #   #       #   #     # #     # #   #   #     # #   #
# # # # # ##### # # ####### # # ##### # # ##### # # # # ### # ######### # ####### ##### ### # ##### ##### ### #
#   #   #     #   #   #     # #       # # #     # # # # #   #         # #   #         #     #       #     #   #
### ######### ####### # ##### ######### # # ##### # ### # ##### ##### ##### # ####### ################# # # ###
# #   #     # #   # # #     #     #     # #       #     #     #   # # #     # #     #           #       # #   #
# ### # # ### # # # # ##### ##### ##### # ########### ####### ### # # # ##### # # ##### ### ### # ### ####### #
# #   # # #   # # #     #   #   #     # #           #   #   # #   # # # #   #   # #   #   # #   #   #         #
# # ##### # ### # ##### ### # # ##### # # ######### ### # # # # ### # # # # # ##### # ### # ### ### ###########
# # #     #     #   # #   #   # #     # #   #     # # # # #   #   #   #   #   #   # # #   #   # # #       #   #
# # # ### ######### # ### # ##### ##### # ### ### # # # # ##### # # ### ####### # # # # ##### # # ####### # # #
# # # # #   #       #     # #   # #     # #   # #   # # # #   # # # # #     #   #   # #   #   # #     # # # # #
# # # # # ### ####### ####### # # # ##### # ### ##### # ### # ### # # ##### # ####### ### # ### # ### # # # # #
# # # # # #   #     # #     # #   #     # # #       #   #   #     # #       # #     #   # #   #   #   # # # # #
# # # # # # ### ### # # ### # ######### ### # ##### # ### ######### ##### ### # ####### ##### ##### ### # ### #
# # # #   # #     # # # #   # #       # #   # #   #   #   #   #   #     # # # # #     #     #   #       #     #
# # # # ### # ### ### # # ### ####### # # ### # # ##### ### ### # ##### # # # # # # ####### ### # ##### ##### #
# # # # #   #   #       #   # #       #   # # # #   #   #     # #   # # #   # # # #   #   #     # #   #   #   #
# # # # # # ######### ##### # # ########### # ##### # # ### # # # # # # ### # # # ### # # ####### # # ##### ###
#     # # # #       # #   #   # #         #   #   #   #   # # # # #   #   # # #   # #   #         # #     # # #
# ####### # # ##### ### # ##### # ####### # ### # ##### # # # # # ####### ### # ### ############### ##### # # #
# #       # # #   #   # #     #       #   # #   #     # # # #   #       #   # # #         #     #   #   #   # #
# # ####### # # # ### # ##### # ####### # # # ####### # # # ########### ### # # # ##### # ##### # ### ####### #
# # #   #   #   #   #   #     #   #     # #   # #     # # #   #   #   #     # # # #     # #     #   # #       #
### # # # ######### ##### ##### ### ##### ##### # ##### # ### # # # # ####### # ### ##### # # ##### # # ##### #
#   # # # #   # #   #     # #   #   #     #     # #     #   #   #   #     #   #   # #   #   # #     #   #     #
# ### ### # # # # ### ##### # ### ### ##### # ### # ####### ############# ### ### # # # ### ### ######### ### #
# #   #     #   # #   #   #   # #   # #     # #   # #     # #     #   #       #   # # # #   #   #         #   #
# # ### ######### # ### ### ### ### ### ##### # ##### ### # # ### # ### ####### ### # # ##### ### # ####### ###
# #     #   #   # #   #       #   #   #   #   # #     #     # #   #     #     # #   # #     #   # #   #   #   #
# # ##### # # # # ### ####### # # ### ### # # # # ##### ##### # # ####### ### # # # # ##### ### ##### # # ### #
# #     # #   # # # #   #   # # #   #     # # # # #   #   #   # # #         # # # # #     #   #     #   # # # #
# ####### ##### # # ### # # # # ### ####### # # # # # ##### ### ### ######### # ### ##### # ####### # ### # # #
# #     # #     # #   #   # #   #   #   # # # # #   #     #   #     #   #     #     # #   #         # #   # # #
# # ### # # ##### # # ##### ##### ### # # # ### ######### ### ######### # ######### # # ############### ### # #
# # # # # #   #   # #   #   #   #     #   #                 # #       # #       #     # #   #   #       #   # #
# # # # # ### # ### ##### ##### # ################### ####### # # ### # ####### ### ### # ### # # ### ### ### #
#   # #   # #   # #     #     #   #     #       #     #     # # #   #         #   # #   # #   #   # #   #     #
# ### ##### ##### # ### ##### ##### ### # ##### ##### # ### # ### # # ########### # # ### # ####### ### ### ###
# #         #   #   #     # #       # #   #   # #   # #   # #   # # # #   #       # # #   # #         #   #   #
# ### ### # # # # ### ### # ######### ####### # # # # ### # ### ### # # # # ####### # # ### # ##### ##### ### #
#   # # # # # #   #   # # #     #             #   # #   # #   #     # # #   #     # # #   # #     # #   #   # #
### # # # ### ##### ### # # ##### # ####### ####### ##### ### ##### ### ##### ### # # ### # ##### # # # ### # #
# # #   #     #   # #   # #       # #     # #       #     # #     # #   #   #   #   #   # #       # # # #   # #
# # ### ####### # # ### # # ####### ### # # # ### ### ##### # ##### # ### # ### ####### # ##### ##### # # ### #
#   #   #       # #   # # # #   # #   # #   # #   #   #     #       # #   #     #       # #     #     # # #   #
# ####### ####### ### # # # # # # ### ####### ##### ### ### ######### # ######### ####### # ##### ##### # ### #
#     #   #     # #   #   #   #   # #       #     # #   #   #     #   #         #       #   #   #   # # #   # #
##### # ##### # # # ### ######### # ####### ##### # # # ### ### # # ################### ##### # ### # # ### ###
#   #   #     # # # # #   #   #       # #     # # # # #   #     # #   #             #   #   # #     # #   #   #
### ##### # ##### # # ### # # ####### # # ### # # # # ### ##### ##### # ########### # ### # # ####### ### ### #
#     #   #       # #   #   #     #     # #   # #   #   # #     #   # # #         # # #   # # #     #   #     #
# # ### ########### # ########### ####### # ### ######### ####### # # # ### # ### # # # ### # # ### # # ##### #
# # #   #       #   #     #     # #     # #     #         #       # # #   # #   # # #   #   # # #     #   #   #
# ### ### # ### # ### # ### ### # # ### # ##### ### # ##### ####### # ### # ### # # ##### ### # # ####### # ###
# #   # # # #     #   #       # #   #     #   # #   # #   #   # #   #   # #   # # #   #   #   # #   #   # # # #
# # ### # # ################# # ### ####### ### # ##### # ### # # ### # # ### # ##### # ##### # ##### # ### # #
#   #     # #         #   #   #     #   #         #   # #     # #     # #   # #     # # #     #       #   #   #
# ######### # ####### # # ########### # ####### ### # # ####### ####### ### # ##### # # # ############# # ### #
# #       #     #   # # #             # #     # #   # #       #           # #   #   # #   #     #     # # #   #
# # ##### ##### # # # # ############### # ### ### ### ##### # # ##### ##### ### # # # ##### ### # ### # # # ###
# # #   #     # # # #   #       #       # # #     # #     # # # #   # #   #   # # # #     # #     #   # # #   #
# # # # ##### # # # ####### ##### ##### # # ####### ##### # # ### # ### # ### ### # # ### # ####### ##### ### #
# # # #       #   #     #   #     #     # #             # # # #   # #   #   #   # # # # # # #   #       #   # #
# # # ################# # # # ### ####### # ########### # ### # ### # ### ##### # # # # # # # # ####### # ### #
#   # #         #   #   # # #   # #       # #         # #   # #   #   # # #   #   # # #     # #   #   #   #   #
##### # ####### # # # ### # ### ### ####### ### # ##### ### # ### ##### # # # ##### # ####### ### # # ### # ###
#   # # # #     # #   #   # #   #   #     #   # # #   #   #   # #     # #   #     # # #   #   # # # #     # # #
# # # # # # ##### ####### # # ### ### ### ### ### # # ### ### # ##### # ####### ### # # # # ### # # ##### # # #
# #   # #   #     #     # # #   # #     #   # #   # #       # #     #         #     #   # #   # # # #   # #   #
# ##### # ####### # ### # # ### # # ####### # # # # ######### # ### ######### ########### ### # # ### # ##### #
#       # #     #   #   # #   # # # #     #     # #             # # #       # #         #   #   #     # #   # #
######### # # # ##### ### ##### # ### ### ########### ########### # ####### # # ####### # ##### ####### # # # #
#   #   # # # # #   #   #   #   # #   # #           #   #   #     #         #   #       #       # #   #   #   #
### # # # # # # # ##### ### # # # # ### ########### # ### # ##### ##### ######### ############### # # #########
#   # #   # # # #           # # # #   #     #   #   # #   #     # #     #   #   # #   #   #       # #     #   #
# # # ####### # ########### # # # ### # ### # # # ##### ####### # # ##### # # # # # # # # ##### # # ### ### # #
# # #         # #       #   # # #     # # # # #   #     #   #   #     #   #   # #   #   #     # #     #     # #
# # ########### # ##### ##### ######### # # # ##### ##### # # # ####### ####### ############# # ############# #
# # #       #   #     #     #       #   #   #       #   # #   # #       #   # #       #   #   # #   #       # #
# ### ##### # ##### # ##### ##### # # ### ############# # ####### ####### # # ##### ### # # ### # ### ##### # #
# #   #     # #   # # #   #     # # #   #     #         #   #   #       # #       #     #   #     #   #     # #
# # ### ##### # # ### # ####### # # ### ##### # ####### ### # # ####### # ####### ################# ### ##### #
#     #         #     #           #     #       #         #   #           #                         #         #
###############################################################################################################
