#########################################
#     #   #           #       # #       #
##### # # ### ####### ##### # # # ##### #
#   # # #   #     #   #     # #   # #   #
# # # # ### ##### # ### ##### # ### # # #
# # # #   #     # #   # #   # # #   # # #
# ### # # ##### # ### # ### # # # # # ###
# #   # # #       #   #   #   #   # #   #
# # ### # # ######### ### # ########### #
#   #   # # #       #   # #         #   #
# ### ### ### ##### ### # ######### # ###
# #     #         #   #   #   #     #   #
# # ################# ####### # ##### # #
# # #         #     #   #     # #   # # #
# ### ####### # ### ### # ##### # # # # #
# #   #     # #   #     #     #   # # # #
# # ### ### # ### ####### ### ##### ### #
# #   #   # #   #   #   #   #     # #   #
# ### ### # ### ### # ##### ##### # # # #
#     #   #   #     #   #   #     #   # #
####### ############### # ### ### ##### #
#       #             # # # #   #     # #
# # ##### ####### ### # # # ### ####### #
# #     # #     # #   # # #   #       # #
# ##### # # ### # ### # # # ######### # #
# #   # # #   # #   #   # #         #   #
# # ### # # ### ### ##### ### # #########
# #   # # # #   # #     #   # # #       #
# ### # # ### # # ##### ### # ### ##### #
#     #       #   #   #   # #     # #   #
##### ########### # # # ### # ##### # ###
#   # #   #   #   # #   #   #       #   #
# # ### # # # ##### ##### ######### ### #
# #     # # #     #     #   #         # #
# ####### # ##### ##### ### ##### ##### #
#       #   #           #   #   # #   # #
# ##### ############### # ### # # # # # #
# #   #     #       #   # #   # # # #   #
# ### ##### # ##### ##### ### # ### ### #
#         #       #           #     #   #
#########################################
