#############################################################################################################################################
#     #   #           #       #         #               #   #           #                       #                 #       #         #       #
##### # # ### ####### ##### # # # ##### # # ########### ### # # ######### ##### ############### ########### ##### # ####### ##### ### # #####
#   # # #   #     #   #     # # #   #   # # #               # #     #     #   # #     #     # #             #     # #   #   #   #     #     #
# # # # ### ##### # ### ##### # ### ### # # ### ############# ##### # ##### # # # ### # ### # ########### ##### ### # # # ### # ########### #
# # # #   #     # #   # #   # # # #   # # #   # #     #     # #   #   #     # # #   #     # #       #     #   # #     # # #   #       #   # #
# ### # # ##### # ### # ### # # # ### # ##### # # ### # ### # # # ##### ####### ### ####### # ####### ##### # # # ##### # # # ##### ### # # #
# #   # # #       #   #   #   #     # #       # #   #     # #   #   #         #     #   #   #         # #   # # #   #   # # # #     #   #   #
# # ### # # ######### ### # ######### ######### ### ####### ####### # ####### ####### ### ########### # # ### # ##### ### # # # ##### ##### #
#   #   # # #       #   # #         #     #       #     #       #   # #     #         #   #         #   # #   #     # #   # # # # #   #   # #
# ### ### ### ##### ### # ######### # ### ##### ####### # ### ### ### # ######### # ### # # ####### # ### # ####### # # ##### # # # ### # # #
# #     #         #   #   #   #     # # #     # #       #   # #   # #   #         # #   # #     # # # #   #   #     # #     # #   # #   #   #
# # ################# ##### # # ##### # ##### ### ######### ### ### ### # ##### ##### ### ##### # # ### ##### # ##### ##### # ##### # #######
# # #         #     #   #   # # #   #       #     #       # #   #     # # #     #     # # #   # # #     #   # #       #     # #     # #     #
# ### ####### # ### ### # ### # # # # ############# ##### # # ##### ### # ##### # ##### # ### # # ####### # # ####### # ##### # ##### # ### #
# #   #   # # #   #     #   # #   # # #         #   #     # #     #     #     # #   #         # #   #   # # # #     # #   #   #   #   #   # #
# # ### # # # ### ######### # ##### ### ####### # ### ##### ##### # ######### # ### ######### # # # # # # # # # # ### ### ### ### ##### ### #
# #   # # # #   #   #       #   # # #   #     #   #   #       #   # #       # #   #     #   # #   # # # # #   # # #     # #     #     # #   #
# ### # # # ### ### # # ####### # # # ### # # ##### ### # ##### ### ### ##### ##### ### # ### ### ### # # ##### ### ##### # ######### # # ###
#     # #     #     # # #       # #   #   # # # #   #   #     # #       #     #   #   # #     #   #   #   #         #     #   #   #   # #   #
####### ##### ######### ### ##### ##### ### # # # ### ####### # ####### # ### # # ##### # ##### ### ######### ####### ####### # # # ### ### #
#   #       #         #   #   #       # #   #   # # # #   #   # #     # #   # # #       #   #   #   #       # #       #     #   # #       # #
# ### ##### ######### ### ### ##### # # # ####### # # # # # ### # ### # ### ### ########### # ### ### ##### # # ####### ### # ### ######### #
# #   #   # # #     #   #   # #   # # # #       # #     # #     # #   #   # #   #   #       #   #   # #   # # #       # # # # #     #   #   #
# # ##### # # # # ##### ### # # # ### # ####### # ####### ####### # ####### # ### # ########### ### # ### # # ####### # # # ### ### ### # # #
# # #   # # #   #       #   #   #     #       #   #     # #       #         # #   #               # #     # # #     #   # #   #   #   # # # #
# # # # # # # ########### ########### ####### ##### ### # ### ############# # # ################# # ##### # # # ######### ### # # ### # # # #
#   # #   # #       #         #   #   #   # #       #   #     #     #       #   # #         #   # #       # #   #           # # # #     # # #
# ### ##### ####### ### ##### # # # ### # # ######### ### ####### ### ######### # # ####### # # ##### ##### ##### # ####### # ### ####### # #
#   #     #     # #   #   #   # #       #           # #   #     #         #   #   #   # #   # #     # #     #     #     # # #   #       # # #
### ##### ##### # ### ### # ####################### # # ### ### ####### ### # ##### # # # ### ##### # # ##### ######### # # ### ####### # # #
# # #         # #   # #   #         # #         #   # # #   # # #     # #   # #   # # # # #   #     # # #     #       # #     #         # # #
# # # ### ##### # # # # ########### # # ##### ### ### # # ### # # ### # # ### # # ### # # # # # ####### # ######### # # ######### ####### # #
#   #   # #     # #   #   #   #     #       # #   # # # #   # #   # # # # # # # #     # # # # #         #           # #   #       #     # # #
# ##### # # ##### ####### ### # ############# # ### # ### # # ##### # ### # # # ####### # # # ######### ########### ##### # ####### ### # # #
#       # # #   # #           # #             #   # #   # # #       #     # # # #       # # #     # #   # #   #     #     #   #     # #   # #
######### # ### # ### ######### # # ######### ### # ### # # ### ### ####### # # # # # ### # ##### # # ### # # # ##### ##### ### ##### ##### #
#   #     #   # #   # #       # # # #       # # #     # # #   # #   #       # # # # # #   # #   # #   #   # # #     #     # #   # #       # #
### # ####### # ### ### ##### # ### ##### # # # ### ### ##### # # ### # ### # # ### ### ##### # # # ### ### # ##### ##### # # ### # ##### # #
#   # # #   # #         #   #   #   #   # #       # #   #     # #   # # #   # #   #   #   #   #   #     #   #     #     #   #   #   #   #   #
# ### # # # # ########### ####### ### # ########### # ### ######### # # ### # # # # # ### # ########### # ##### # ##### ####### # ### # #####
# #   #   # # #   #         #         # #     #     #   # #         # #   # # # # # #   # # #       #   # #   # # #   #       # # #   #   # #
# # ### ### # # # ######### # ######### # ### # ####### # # # ####### ### # # # # ### # # # # ##### ##### ### # ### # # ####### # ### ### # #
# #   # #   #   # #   #     #   #   #   # #   #     #   # # #       # # # # # # # #   # #   #   #   #   # #   #     #   #       # #   #     #
# ### # # # ##### # # # # ##### # # # ### # ####### # ### ####### # # # # # # ### # ####### ### # ### # # # # ######### # ####### # ####### #
# #   # # #     # # # # # #     # # #     #       # # #   #     # # #   # # #   # #   #   # #   #     #     # #       # # #     # #     # # #
# # ##### ####### # # # # # ##### # ######### ### # # ### # ### ### ### # ##### # ### # # # # ################# ##### ### ### ### # ### # # #
#   #   #     #   # #   # #   # # # #       #   # # #   #     #   # #   #     # #   #   #   # # #     # #       #       # #   #   #   # #   #
# ### # ##### # ### ### ##### # # # # ### ##### ### ### # ####### # # ##### # # ### ######### # # # # # # ############# # # # # ### ### # ###
#   # #       # # #   # #     #   # #   #     #     # # #   #     #     #   # #     #       # # # # #   # #           #   # # #   # #   # # #
### # ####### # # # # # # ######### # ##### # ####### # ### # ### ####### ######### # ##### # # # # ### # # ######### ##### ##### ### ### # #
#   # #   #   # #   # # # #   #   #   #   # #       # # #   # # # #     #       #   #     # # #   #   # # #     #   # #         #     # # # #
# ### # ### ### ### # ### # # # # ##### # ####### # # # ##### # # # ### ##### # # ####### # # ####### # # ##### # ### # ##### ######### # # #
# #   # #   # #   # #       #   #       # #     # #   #   #   #   # # # #   # # #   # #   #   #     # # #     #   #   #     # #     #   #   #
# # # # # ### ### # ##################### # ### # ### ### # ##### # # # # # # # ### # # ####### ### # ####### ### # ####### # # # ### # ### #
# # # #   #   #   #   #   #       #   #   # # # # # #   # #     # # # #   # # #   #   # #       # # #     # #   # #     # # #   #   # #   # #
# ### # ### ### # ##### # # ### # ### # ### # # # # ### # ##### # # # ##### # ##### ### # ##### # # ### # # ### # ##### # # ####### # ### # #
#     #   # #   # #     # #   # # #   # #   # # # #   # #   #   # #     # # # #     #   # #   # # #     #   #   #   # # #   #     #   # #   #
######### # # ### # ##### ##### # # ### ### # # # # # # ### # ######### # # # # ##### ### ### # # # ####### # ##### # # ### ##### ##### #####
#       # # #   # #   # # #     #   #   #   #     # # #   # # #           # #   #     #   #   # #   #   #   #     #   #   #     #           #
# ##### # # ### # ### # # # ######### ### ######### # ### # # # ########### # ### ##### ### # # ##### # ######### # ##### ##### ##### ##### #
#     # # #   # # #     # #       #       #       # #     # #       #     # #   # #   #     # #     # # #       #   #     #   #       #     #
### ### # ### # ### ##### # ##### # ####### ##### # ####### ### ##### ### # # ### # ##### ##### ### # # # ##### ##### ##### # ####### #######
# # #   #     #     #   # #   # #   #       #     # # #   #   # #     # #   # #   #     # #   #   #   # #   # # #   # #     # # #     #     #
# # # ####### ####### # # ### # ##### ####### ##### # # # ### # # ##### ##### # ##### ### # # ######### ### # # # # # # ##### # # ##### ### #
#   #   #   #     #   # # # # #     #       # #   # # # #     # #     #       #     #     # # #   #     #   #     #   #     # # #   #   # # #
# ##### # # ##### # ### # # # ### ####### ### # ### # # ############# # ########### ####### # # # # ### # ### ########### ### # ### # ### # #
#   # # # #     # #   #   #     # #       #   # #     # #     #     # #   #         #     # #   #   # # # #     #         #   #     #   # # #
### # # # ### ### ### ######### # # ####### ### # ##### # ### # ### # ##### ######### ### # ######### # # ### ### ######### ### ####### # # #
#   # # # # # #   # #         #   #   #   # # #     #   # # # # # # # #     #       # #   # #         # #   # #   # #     #   # #   #   # # #
# ### # # # # # ### ######### ####### # ### # # ##### ### # # # # # # # ##### ##### # # ### ####### # # ### ### ### # # # ### ### # # ### # #
#     # # # # #       #     # #     #   #   #   #   # #   #     #     # #     #   #   # #         # # #   #   # #     # #   #     #     # # #
####### # # # ####### ### # # # ### ### # # ##### # # # # ####### ##### # ####### ##### ####### # # ##### ### # ####### ### ########### # # #
#       # # #         #   # # #   #   # # # #     #   # #   # #   # #   # #     #     #       # # #       # # #   #   # #   #         # # # #
# ####### # ########### ### # # ### ### # # # ######### ### # # ### # ### ### # ### # ####### # # # ####### # ### # # # # ### ####### # # # #
# #     # # #   #       #   #   #   #   # # #         # #   #   #   #     #   #   # #     #   # # #   #     #   #   #   # # # #       #   # #
# # ### # # # # # ### ########### ### ### ########### # # ##### ### ####### ##### # ####### ##### ### ### ##### ### ##### # # # ########### #
# # # #   #   #     #           #     # # #     #   # # #     #   #   #     # #   #   #     #     # # #   #   #     #   #   # #           # #
# # # ############# ######### # ####### # # # # ### # ####### ### ### # # ### # ##### # ####### ### # # # # # # ##### # ##### ########### # #
#   #             #   #     # # #       #   # # #   #       #   #   #   #   #       # # #       #     # # # # # #     # #     #   #     # # #
# ### ### ####### ### # ### # ### ##### ##### # # ######### ### ### ####### ####### # # ##### ### ##### # # # ### ##### # ##### ### # ### # #
# #     # # #   # # # # # # #         # #   # # #         #   #   #         #   #     #       # #       # # #   # #       #   #   # #   #   #
# ####### # # # # # # # # # ########### # # # # ### ######### ### ######### # # ############### ####### ### ### # ######### # # # # ### ### #
#   #     # # # # #     #       #     # # #   #   # #     #   #   #   #   # # #                 #     # #   # # # #         # # #     #   # #
### # ##### # # # # ##### ####### ### # # ####### # # ### # ### ### # # # # # ################# # ### # # ### # # # ######### ######### ### #
# #   #   #   # # # #   # #       #   # # #       # # # #   #   #   # # #   #   #         #   # # # #   #   # #   # #       #     #     #   #
# ##### # # ### # ### # # # ####### ### # # ####### # # ##### ### ### ######### # ######### # # # # ####### # ### # ### # ####### # ##### ###
# #   # #   # # #     # # #   #   #     # #         # #     #       # #       # #     #     #   # # #     # #   # #     # #       #     #   #
# # # # ##### # ####### ##### # # ##### # ### ####### ### # ####### # # ##### # ##### # ##### ### # # # # # # # # ####### # ####### ### ### #
# # #   #     #     # # #     # #       # # # #       #   #       # # #     #         # #   # #   #   # # # # #     #     #     # # #     # #
# # ##### ### # ### # # # ####### ####### # # # ####### ######### ### ##### ######### # # # # # ####### ### # ####### ######### # # # # ### #
# # #     #   #   #   # #   #   #   #   # # # #   #     #     #   #     #   #   #   # #   # # #       # #   #   #           #   #   # # #   #
# # # ##### ##### ##### # # # # ##### # # # # ### # ####### ### ### ##### ##### # # ####### ######### # # ####### ########### ####### # # ###
# #   #   # #   #   #   # # # #     # # # #     #   #     #   #   #     #     # # #       #         #   #     #   #   #     # #     # # # # #
# ##### ### # # ### # ### # # ##### # # # ##### ##### ### ### ### ### # ##### # # ####### ### ### ##### ##### # ### # # ### # # ### # ### # #
#     #     # #   # # #   #   #   # # # #   #   #     # #   #   #   # #       # # #         #   # #   # #   #   #   # #   # #     # #   # # #
# ##### ##### ### # # # ####### ### # # ### # ####### # ### # # ### # ######### # ######### ### ### # # # # ##### ### ### # ####### # # # # #
#       #     #   # # #   #     #   # #   # #   #     #       #   # # #       # #   #     #   # #   #   # #       #     # #     #   # #   # #
# ############# # # # ### # ### # ### ### # ### # # ##### ####### # # # ##### # ### # ### ### # # ####### ############# # ##### # ### ##### #
# #         #   # #   # # # #   #     #   #   #   # #   #   #   # # #   #   #   # # # #   #   # # #     #       #     #   #   #   #   #     #
# ##### ### # ######### # ### ######### ##### ##### # # ### # # ### ##### # ### # # # # ### ### # # ### ####### # ### ####### ##### ### ### #
# #   # #   # #         # #   #   #   #     #   #   # #   # # #   #   #   #   # # #   # #   #   # # # #   #   #   # # #           # #     # #
# # # # # ### # ### # ### # ### # # # ### # ### ##### ### ### ### ### ### # ### # ##### ### # # # # # # # ### ##### # ##### ####### # ### # #
# # #   #   #   # # # #   #   # #   #   # #   # #     # #       #   # #   # #     #   #   #   # # #   # # #   #     #     #         #   # # #
# # ####### # ### # ### ##### # ####### # # ### # ##### ######### # # # ### # ##### # ### ### ### ### # # # # # ### ##### ####### ##### # # #
# # #     # #     #   #       # #     # # #   # # #     #       # # # #   # #   #   #   # #   #   #   # #   # # #   #   #       #     # # # #
# # ### ### ##### ### ##### ### # ##### ### # # # # ### # ##### ### # # # ##### # ##### # ##### ####### ##### # # ### # ####### ##### # # ###
# #   # #   #   #   #     # #   # #   #   # # #   #   # # #   #   # # # #     # # #   # #     #     #   # #   # # #   # #       #   # # #   #
# ### # # ### ##### ### # # # ### # # ### ### ####### # # # ##### # # ####### # # ### # ### # ##### # ### # ### ### ### # ####### ### # ### #
#     #   #     #   # # # # # #     #   #           # # # #       # #   #   #   #   #     # #     # # #   # #     #   #   #       #   #   # #
####### ####### # ### # # # # ##### # ############# # # # ### ##### ### # # ##### # ##### ### # ### # # # # # ### ### ##### ##### # ### ### #
# #     #     #     # # # # #     # #             # # # #   # #       # # #     # #     #     # #   # # # # # #     # # #   #     # #   #   #
# # ##### # # ##### # # # # ##### # ######### ### # # # ### # ##### # # # ##### ####### ### ##### ### ### # ### ##### # # ### ### # ##### # #
# #     # # #   #   # # # # #   # #     #   #   # #   # #   #       # #   #   #       #   # #   #     #   #   # #     # #   #   # #       # #
# ##### ### ### ### # # ### ### # ##### # ##### ####### # ########### ####### ####### # # ### # ####### # ### # # ##### # ##### ########### #
# #     #   #     # # #   #     #   # # #     #         #     # #     #       #   #   # #     #         #   #   # #     # #   # #       # # #
# # ##### ####### # # ### ##### ### # # ### # ############# # # # ####### ##### # # ##### ########### ##### ### # # ##### # # # # # ### # # #
# #     #     #   #   #   #   #   # # #   # #   #         # # # # #     # #     # #     #   #     #   #       # # #       # # #   # # #   # #
# ##### ### # # ####### # # # ### # # ### # ##### ####### ### # # # ### # # ##### ##### ##### ### # ##### ##### # ##### ### # ##### # ### # #
#     #   # # # #   #   # # # #   # #       #     #           # #   #   # # #   #     #     #   # # #   #   #   #     # #   # #     # #   # #
# ### ### # # # # # # ### # ### ### # ####### ################# ##### ### # # # # # ####### # # # # # # ##### ####### ### ### # ##### # ### #
#   #   # # # #   #   # # #   #   # # #     #         #     #   #     # #   # # # #     #   # # # # # #     #       # #   #   # # #     #   #
### ### # # # ######### # # # ### # ### ### ######### # ### ### # ##### # ### # ##### # # ##### # # # ##### # ####### # ### ### # # ##### ###
#   #   # # # #     #     # # #   # #   # #     #     # # #   # # #     # #   #     # # # #     # #   #     # #     #   # # #   #     # #   #
# # ##### # # ##### # ####### # ### # ### # ##### ### # # ### # # ### ### # ####### ### # # ##### # ### ##### # ### ### # # # ####### # ### #
# # #     # # #     # #       # # #       #   #   #   # # #   # #   #     # #     # #   #   #   # #   #       #   #   #   # # #   #     #   #
# ### ####### # ##### # ##### # # ####### ### # ### ### # # ### ### ##### # # # # # # ####### ### ############### ### ##### # # # # ##### ###
#   # #       #         #     # # #     #   # # #     #   # #     # #   # # # # # #   #         # #     #         # #   #   #   # # #     # #
### # # # ##################### # # ### ##### # ######### # # # ### # # ### ### ### ### ####### # # ### # ######### ### # ### ### ### ##### #
#   # # #   #   #             #   #   #     # # #         # # #   #   # #   #   #   #   # #     # # #   #   # #       #   #   # #   #   #   #
# ### ### # # # # ########### ### ### ##### # # # ######### # ### ##### # ### ### ### ### # ##### # # ### # # # ### # ##### ### ### ### # # #
#   #   # #   #       #     #     #   #   #   #   #       # # #   #   #   # #     # # #   #       # #   # # #   #   # #   # #   #     #   # #
# # ### ############# ##### ####### ### # ### ##### # ##### # # ### # ##### # ##### # # # ######### ### # # ##### ### # # # ### # ######### #
# #   #             #           # # #   # # # #     # #     # #     #       # #     # # #       #   #   # # #   #   #   # # #   # #         #
# # ############### ########### # # # ### # # ##### ### ##### ############# # # ##### ####### # # ### ##### # # ### ##### # # ### # #########
# # #     #     #   #           # # #   #   # #     #   #       #         #     #     #       #   #   #   #   # #   #   # #   #   # #       #
# # # # ### ### # ### ####### ### # ### ### # # ### # ### ####### ####### # ##### ##### ########### ### # ##### # ### # # ##### ### # ### # #
# #   # #   # #   #   #     #     #   # #   #   # # # #     #   #   #   # # #     #         #     #   # #     # #   # #         #   #   # # #
# ##### # ### ######### ### ######### # ######### # # ####### # ### ### # ### ############# # ####### # ##### # # # ############# ####### # #
#     #                 #             #             #         #         #                   #           #       # #                       # #
#############################################################################################################################################
