###########################################################################################
# #           #                         #     #               #     #             #       #
# ##### ##### # ############### # ####### # ### ####### ##### # ### # ######### # # ##### #
#       #   # # # #           # #         #   # #   #   #   # #   # #     #     # # #     #
########### # # # # ######### ####### ####### # ### # ### # # ### # ##### # ##### # ##### #
#       #   # #   # #       #       # #   # #       #   # #     # #     # #   #     #   # #
# ##### # # # ##### ####### ####### # # # # ####### ### ######### ### ### ### ####### # ###
#   #   # # # #     #       #   #   #   # # #   #     #           # #       # #   #   #   #
# # # ### # # # ##### ##### # # # ####### # # # ######### ##### ### ######### # # # ##### #
# # #     # #   #     #   # # #   #         # #     #   # #   #     #   # #   # # #   #   #
# # ####### ##### ### # # ### ##### ######### ##### # # ### # ##### # # # # # # # ### # ###
# #   #   # #   #   # # # #   #     #         #       #     # #       # # # # # #     #   #
# ### # # # # # ### # # # # ##### ### ##### ################# ######### # # # # ######### #
# #   # # #   #   # #   #   #   # #   #   # #   #   #         #       #   # # #     #   # #
# # ### ######### # ######### # ### ##### # # # # # # ####### # ##### ### # ####### # # # #
# #   # #         #     #   # #   #     #   # #   # #   #   #   #   #   # # #       # # # #
# ### # # ############# # # # ### # ### # ### ##### ##### # ##### ##### # # # ######### # #
# #   #   #           #   # #   # # #   # # # #   #       #     # #     # #   #   #     # #
# # ### ### ##### ### ##### # # # ### ### # # ### ############# # # ##### ##### # # ### # #
# #   #   # #   # #     #   # # # #   #     #       #           #   #       #   #   #   # #
# ### # ### # ### ####### ##### # # ######### ##### # ############# ####### # ####### ### #
#   # # #   #   #         #     # #           #   # # #           #       #   # #     #   #
### # # # ##### ########### ##### # ########### # ### # ######### ####### ##### # ##### # #
#   # # # #   #     #       # #   # #       #   #   #       #   #   #   # #   #   #   # # #
# ### ### # # # ### ####### # # ### ##### # # ##### ######### # ### # ### # # # ### # # # #
# #   #   # # #   #         # # # #     # # #   # #       #   #   # #     # #       # # # #
# # # # ### # ### ########### # # ##### # ##### # ####### # ##### # # ########### ##### # #
# # # #     #     #     #       #     # # #     #           #   #   #     #   #   #     # #
# # ############### # ### ######### # # # # ### ############# # ######### # # ##### ##### #
# #       # #       #     #         # #   #   # #         #   #       #   # #     #     # #
# ### ### # # ################### ####### ### ### ####### # ### ##### # ### ##### ##### # #
#   # #     # #                 # #     # # #   #       # # #   #     #   # #   # #     # #
### # ##### # # ############### # # ### # # ### ### ##### ### ########### # # # # # ##### #
# # # #   # #   #   #     #   # #   # #   #   #   # #     #   #         #   # # # # #   # #
# # # # # ####### # # # # ### # # ### ##### # ### # # ##### ### ####### ##### # # # # ### #
#   #   # #     # #   # # #   # # #   #     #   #   #   #     # #     #       # #   #     #
######### # # # # ##### # # # # # # # ######### ####### ##### # ### ######### # ##### #####
#       #   # # # #   # #   # # #   # #   #         # #     # #   #   #       #     #   # #
# ##### # ### # # # # # ####### ##### # # # ####### # ##### # ### ### # ### ########### # #
#   #   # #   # # # # #         #   #   #   #   #   # #   # #     #   # #   #           # #
### # ##### ### # # ############# # ########### # ### # # # ### ### # # ##### ########### #
#   #       #   # #               # #     #     # # #   # #   #     # # #     #           #
# ########### ### # ##### ######### # ### ### # # # # ### ### ####### # # ##### # ####### #
# #         #   # # #   #         #   #       # # #     #   # #       # # #     #       # #
# # ### ####### # # # ########### ############# # ######### # ### ##### # ############# # #
# #   # #     # # # # #     #   #   #         # #           #   # # #   #               # #
# ### # # # ### # # # # # # ### ### # ####### # ### ########### # # # ################### #
# #   #   #     # # #   # #     # #   #     # # # # #     #     #   #   #       #     #   #
# ##### ######### # # ### ##### # ##### ##### # # # # ### # ########### # ### # # ### # ###
#     #   #     # # # #   #   # #       #     #   # # #     #         # # #   #   #   #   #
# ### ### ##### # # ### # # # # ### ### # ####### # # ####### ####### # # # ### ######### #
# #   # # #     # # #   # # # #   #   # #   #     # #   #   # #         # # # # #     #   #
### ### # # ##### # # ### # # ### ##### ### ### ### ### # # # ########### # # # # ### # ###
#   #     # #     #   #   # # #         # #   # #   # #   # #   #         # #   #   #   # #
# ### ##### # ##### ####### # ######### # ### ### ### ##### # # # ######### ### ### ##### #
#   #       # #   # #       # #   #     #   #           #   # #   #       #   # #   #     #
### ####### # # ### # ####### # # ##### ### ########### # ### ##### ### # ### # # ### ### #
#   #     # # #     #       #   #     #       #   #   # # #   #     #   # #   # # #   # # #
# ### ### # # ############# ######### # ####### # # ### # ### ####### ### # ### # # ### # #
#     # # # #       #       #   #     # #       # #     #   # #       #   #   # # #     # #
# ##### # # ####### # ####### ### ##### # ####### ######### # # ####### ##### # # ####### #
#   #   # # #     #   #       #   # #   #     #           # #   #     # #     # # #       #
### # # # ### # # ##### ####### ### # ####### ########### # ##### # # # # ####### # ##### #
# #   # #     # # #     #       #   #     # #   #   #   # # #   # # # # #     #   #     # #
# ##### ####### # # # ### ####### ####### # ### # # # # # # # ### # ### ##### # ####### ###
# #   # #     # #   # #   # #     #   #   # #   # #   # #   #   # #   # #   # # #     #   #
# # # # ### # # ##### # ### # # ### # # ### # ### ##### ####### # ### # # ### # # ### ### #
#   # #   # # # #   # # #     #     # #     # # #   #     #     # #   # #   # #   # #     #
##### ### ### # ### # # ########### # ### ### # ### # ### # ##### # ### ### # ##### ##### #
#   #   #   # # #   # #   #   #   # #     #   #     #   # # #   # #     #   #       #     #
# # ### ### # # # ### ### # # # # ######### ########### # # # # # ####### ### ##### # #####
# # #     #   # #       # # #   #   #     #         #   # # # #   #       #   #   # #     #
# # # ### ### # ### ##### # ####### # ### # ####### # ### # # ####### ### # ### # # ##### #
# #   #   #   #   #   #   # # #     # # # # #     # # # #   # #       # # #   # # # #     #
# ### ##### ##### ### # ### # # ##### # # ### ### # # # ### # ##### ### # ### # ### # #####
# #   #   # #   #   # #     # # #     #   #   # #   # # #   #     # # #   #   #     # #   #
# ##### # # # # ### ######### # # ### ### # ### ##### # # ####### # # # ### ### ##### # # #
# #     #   # #     #         # # # #   #   #     #   #         #   #   #   # # #   # # # #
# # ######### # ##### ### ##### # # ### ##### # ### # ############# ##### ### # ### # # # #
#   #     # # # #   #   #       #     # #   # # #   #               #   # #         # # # #
# ### ### # # # # # ### ############# # # # # # # ################### # # # ######### # # #
# #     #   # # # #   #   #   #     # #   # # #   #         #       # #   # #         # # #
# # ### # ### # # ### ### # # # ### ####### # ##### ### ### # ##### # ##### # ######### # #
# # #   # #   # #   #   #   #   # #     #   # #     #   # # # #   # # #   # # #     #   # #
# ### # ### ####### ### ######### ##### # ### # ##### ### # ### # # # ### # # # ### # ### #
# #   # #   #       #     #           #   # # # #   # #   #   # #   #   #   #   #   # #   #
# # ### # # # ####### ##### ####### ####### # # # # # # # ### # ### ### ### ##### ##### # #
#   #   # # # #     #   #   #   # #       #   # # # # # #     # # #   #   # #   #   #   # #
##### ### ### # ### ### # ### # # ####### # ##### # # # ####### # ### ### ### # ### # ### #
#       #       #     #       #         #         #   #         #       #     #       #   #
###########################################################################################
