#################################################################################
#   #             #       #     #   #     #       #     #     # #     #   #     #
### # ### ####### # ##### # ### # # # ### # ### ### # ### # # # # # # ### # # ###
# # # # # #     # #   # #   #   # #   # #     #     # #   # # #   # #     # #   #
# # # # # # ### # ### # ##### ### ##### ########### # # ### # ### # ####### ### #
#   # # # # # # # #     #   #   #     #     #     # # # # # #   # #       #   # #
# ### # # # # # # # ##### # # # ##### # ### # ### ### # # # ### ######### ### # #
#   #   #     # # # #   # # # #     #   #   #   #   #     # # #         # #   # #
### ########### # ### # # # # # ######### ##### ### ####### # ######### # # ### #
# #             #     #   # # # #     #   #     # #     #   #     #   # # # #   #
# ######################### ### # ### # ### ##### ##### # ### ##### # # # # # # #
# #       #           #   #   #     # #   # #   #       # #     #   #   # # # # #
# # # ### # ####### # # # ### ##### # # ### ### # ####### ### # # ####### # # ###
#   # #   # #       # # #   #     # #   #   #   #   #       # # #   # #     #   #
##### # ##### ####### ### ####### # ##### ### ##### ####### ### ### # # ####### #
#     #       #     #     #       #   #   # #     # #   #   #     # #   # #     #
# ############# # ####### # ####### ### ### # # # # # # # ### ##### ### # # ### #
#   #   #   # # # #     # #     #   #   # #   # # #   #   #       #   #   # #   #
### # # # # # # # # # ### ##### # ### ### # ### # ######### ##### ### ##### #####
#   # #   # # # #   #     # #   #   # #       # # #     #   #   #   #     # #   #
# ### ##### # # ########### # ### ### # ####### # ### ### ##### ### ##### # # # #
#   # #     #   #           #   # #   #     #   #   # #   #       #       #   # #
# # # # ####### ### ### ####### ### ######### ##### # # ##### ### ######### ### #
# # # #   #   #   # #   #     #   #     #   # #   #   #       # # #           # #
# # # ### # # ### ### ### # # ### ##### # # # # # ############# # # ######### # #
# #   # #   # # #   #   # # # # #       # #   # #             #   # #       # # #
# ##### ##### # ### # # # # # # ######### # ### ##### ######### ##### ##### ### #
# #     #     # #   # # # # # #       #   # #   #   #   #     #       #   #     #
# ### # # ##### # ### # # # # # ##### # ### # ##### ### # ### ######### ####### #
# #   # # # #     # # # # # #   #     # #   #         #   # #   #   #       #   #
# # ##### # # ##### # # # # ####### ### ############# ##### ### # # # ##### # ###
#   #   # #   #     # # # #       #     #           #   #     # # #   #   #   # #
##### # # # ### ### # # # ##### # ##### # ######### ### # ### # # ##### ####### #
#     #   #   #   #   #   #   # # #     #   #     #     # #   #   #   #         #
# ########### ############# # ### # ####### # ########### # ####### # ##### ### #
# #     #     #     #       # #   # # #   # #             # #       #       # # #
# ### ### ##### ### # ####### # ### # # # # ##### ######### ##### ########### # #
#   #   #   #     #   #     # # #   # # # # #     #   #   # #     # #     #     #
### # # ### # ### ##### ##### # ### # # # # # ##### ### # # # ##### # # # # #####
#   # #     #   # #     #     #   # #   # # #     #     # # #     #   # # #     #
# ##### ##### ### # ### # ####### # ##### # ##### # ##### # ##### ##### ####### #
# #   # #   # #   #   # #   #     # #   # #       # #   #   #   #     # #     # #
# # # # # # ### ##### # ### ### ### # # # ######### # # ##### # ##### # # # ### #
#   # #   #     #   # #       # # #   #     #   #   # #       #       #   #     #
# ### # ######### # # ####### # # ##### ##### # # ### # ############### ##### ###
# # # # #         # # #   #     #       #     # #   # # #     #         #   #   #
# # # ### ######### ### # ########### ### ##### ### # ### ### ##### ##### # #####
# # # #   #       #     #           # #   #   #   # #       #     #     # #     #
# # # # ####### # ################# # # ### # ### # # ######### # ### ### ##### #
#   # #   #     # # #     #   #   # # #   # #   #   # #   #   # # #   #       # #
### # ### # ##### # # # # # # # # # ##### ##### ##### # # # # ### ##### ####### #
#   #     # # #   #   # #   # # #   #   #     #   #   # #   #   # #     #     # #
# ######### # # ### ### ##### # ##### # ##### # # # ### ####### # # ##### ### # #
#     #   # #   #   #   #   # # #     #       # # # # # #       # #     # # #   #
##### # # # # ####### ##### # # # ############# ### # # # ####### # ##### # ### #
#   # # #   #   #     #     # #   #   # #       #     # #       # # #     #     #
# # # # ####### # ##### ### # ##### # # # # ##### ##### ####### # # # ### ##### #
# # # # #     # #   #   # # #   #   # #   #       #     #     # #   # # # #   # #
### # # # ### # ### # ### # ### # ### # ########### ######### # # ### # # # # # #
#   #   # #   # #   # #     # #   # # #   #   #     #   #   # # #   # #   # # # #
# ####### # ### # ### # ##### ##### # ### ### # ##### # # # # # ##### ##### # # #
#         #   # # #   #         #   # #       #     # #   #   #     #       # # #
# ##### ##### # # # ########### # # # ####### ##### # ############# ####### # ###
# #   # #   # #   # # #       # # # # #     #     # #     #       #       # #   #
# ### # # # # ##### # # # # ### # # # # ### ### ### # ### # ##### ####### # ### #
#   # #   # # #     #   # # #     # #   #   # # #   #   #   # #   # #   # #   # #
### # ##### # # ### ##### # # ##### ##### ### # # ####### ### # # # # # # ##### #
# # #   #   # #   # #   # # # #   # #   # #   # #   #   #   # # # #   # #     # #
# # ### # ##### ### # # # ### # # # # ### ### # ### # # ### # # # ##### ##### # #
# #   # #     # #   # # # #   # # #   #   #   # # #   # #     # #   #   #     # #
# ### # ##### # # ### # # # ### # ##### ### ### # ##### ####### ### # # # ##### #
#   # #     #   #     # # #   # #     #   #         #   #       # # # # #     # #
### # ### # ########### # ### # ##### ### ########### ### ####### # # # ##### # #
#   #   # #       #     # #   #     #   #     #       #       #       #     # # #
# ##### ### ##### # ##### # ####### # ####### # ####### ##### # ########### # # #
# #   #   # #   # #     # #     #   #         #       #     # # # #   #   # # # #
# # # ### # # ### ##### # # ##### ################### ### ### # # # # # # # # # #
# # #   #   # #   #     #   #   # #     #           #   # #   #   # # # # # # # #
# # ### ##### # ### ######### # # # ### ### ####### ### # # ####### # # # ### # #
#     #           #           #     #       #           # #         #   #       #
#################################################################################
