#######################################################################################################################################################
# #     #             #     #           #         #       #               # #             #         #         #               #       #       #       #
# # ### # ### ####### # # ### ##### ### ### ##### ##### # ##### ######### # # ### ####### # # ##### # ####### # ### ######### # ### # # ##### # ##### #
# #   # # # #     # # # #       #   # #   #     #       #     #     #   # # #   #   # #   # # #   # # # #     #   # #     # # #   # #   #   # # #     #
# ### # # # ##### # # ##### ##### ### ### ### # ############# # ### # # # # ### ### # # ##### # ### # # # ####### # # ### # # ##### ##### # # # # #####
#     # #   #   # #   #   # #     #     #   # # #   #       # # #   # #   #   # # # # # #     #       #     #     #   #   # # #   #   #   # # # #     #
####### ### ### # # ### # ### ####### # ### ### ### # # ##### ### ### ##### # # # # # # # # ### ##### ##### # ######### ### # # # ### ### # # ####### #
#       #       # #     # #   #       #   #   #   #   #           # # #   # #     # #   # # #   #   # #   # # #       # #   #   #   #   # # #   #   # #
# ####### ####### ####### # ### ### ######### # # ################# # ### # ####### # ##### # ### # # # # # # # ##### # # ######### # # ### ### # # # #
# #   #   #   #   #   #     #     # #         # #   #         #     #   # # #   #   # #     #   # # # # # # #   #     # # #   #     # #   #   #   #   #
# ### # ### # # ### # ########### ### ######### ### # ####### # ### ### # # ### # ### ### ##### # # ### # ##### ####### # # # # ######### # # ####### #
#   #     # #   #   #   #       #   # #         #   # #       # #     # #   #   #   #   # #     # #   # #   #   #       # # #   #         # #         #
### # ##### ##### ##### # ##### # # # ######### # ### # ####### # ##### # ### ##### ### # # ##### ### # ### # ### ####### # ######### ##### ###########
#   # #   #     # #   # #     # # # #     #   # #     # #     # #     # # #     #   # #   #     #   #     # #   #     #   # #         #   #     #     #
# ### # # # ### # # # # ##### # # # ##### # # # ####### ### # # ##### # # ##### # ### ######### ### ####### ### ##### # # # ##### ##### ####### ##### #
# # # # # #   # #   # #   #   # # #   # # # # #     # #   # #   #   #   #       # #               #   #   #       #   # #         # #         #       #
# # # # # ##### ##### ### # ### # # # # # # # ##### # ### ##### # # ############# ##### ########### ### # ####### # ############### # ##### # ####### #
# #   # #     # #       #   #   # # # # #   # #         #     #   #               #   # #   #   #   #   #       # #   #       #       #   # # #   #   #
# ##### ##### # # ########### ##### # # ##### ### ########### ############# ####### # ### # # # # ### ######### ##### # ##### # ####### # # # ### # ###
# #     # #   #     #   #     #     #     # #   # #   #     #   #       #   #       #     #   #     # #       #     #   #   # #   #     # # #     # # #
# # ##### # ##### ### # # ##### # ####### # ### ### # # ### ### # ##### ##### ################### ### # ### ####### ### # # # ### ### ### # ####### # #
# # #     #     # #   #   #   # #     #   #   #   # #   #     # #   # #       # #         # #   # #   #   # #     #   #   # #   #     #   #   #     # #
# # # ######### ### ####### ### ##### # ### ##### # ######### # ### # ######### # ### ### # # # ### ##### # # # ##### ######### # ####### ### # ##### #
# # # #       # #   #           #     #     #     #   #     #     #   #             # #   # # #     #     # # #     #     #     # #     # #   #   #   #
# # # # # ##### # ### ####### ### ######### # ##### # # ### ##### ### ####### ####### ### # # ####### ##### # ##### ##### # ####### ### # # ##### # ###
#   #   #     #   #   #     #   #   #     # # # #   #   #   #   #   #       # #     #   #   # #         #   #     #     #   #       #   # # #     #   #
##### ####### ######### ### ### ### # ### ### # # ####### ### # ### ####### ### ### # # ### # ##### ### ##### ######### ##### ####### ##### # ##### # #
#   #   #   #           # # #     #     # #   #   #     # # # # #   #   # #   # #   # #   # #     # # # #     #       #     # #             #     # # #
### ### # # # ########### # ############# # ### ##### ### # # # # ### # # ### # # ### ### # ##### # # # # ##### ##### ### # # ### ############### ### #
#   # # # # # #   #                   #   # # # #   # #   #   # #     #     #   # # #   # #   #   # # #   # #   #   #   # # #   # # #           #     #
# # # # ### # # # ################### # ### # # # # # # ### ### ########### ##### # ### # ##### ### # ##### # ### # ### # # ### # # # ##### # ####### #
# #   # #   #   #   #     #         #   #   # # # #   #   #   #     #           # # #   # #     #   #     # #   # #       #     #   # #   # # #       #
# ### # # # ####### # ### # ####### ### # ### # # ##### # ######### # ########### # # ### # # ##### # # # # ### ### ################# ### # # # #######
#   # #   #   #   #   # #   # #     #   # #       #   # #       #   #   #         #   # # # # #   # # # #   # #   # #               #     # # # #     #
### ######### ### ##### ##### # ### ##### ### ##### # ##### ### # ### ### ########### # # # ### # # # # ### # ### # # ############# ##### # ### # # # #
#   #         #   #         # #   # #   #   # #     #     # #   #     #   #         # # # #     # # # # # # #   # # #     #       #     # #     # # # #
# ### ######### ### ### ### # ### ### # ### ### ######### # # ### ##### ##### ##### # # # ####### # ### # # ### # ####### ### # # # ##### ####### # ###
#   # #         #   #   # # #   #     #   #   #   #   #   # # # #   # #     # #   # #   #       # #   # # #   # #       #   # # # # #     #       #   #
# # # # # ##### # ### ### # ### ####### # ### # # # ### ##### # ### # ##### # # # # ##### ####### ### # # ### # ### ####### # # # # # ####### ####### #
# #   # #   #   #   #   #     #       # # # # # # #     #     #       #   #   # # # #   # #       #     #   #   # #         # # # # #   #   # #       #
# ######### # ##### ### ##### # ##### # # # # ### # ##### # ######### # # ####### # # # # # ### ######### ##### # ######### ### # # ### # # ### ##### #
#     #     #   # # # #   # #   #     # #   #     #     # #       # #   #         # # #   # # # #   #     #   #     #     #     # #   #   #   # #   # #
##### # ####### # # # ### # ##### ##### # ############# # ####### # # ########### # # ##### # # # # # # ### # ### ### ### # ####### # ####### # # # # #
# #   #   #       #   #   #         #   # #   #       # # #     # #   #   #   # # #   #   # #   # # # #   # #     #   #   # #       # #     #   # # # #
# # ##### ########### # ############# ##### # # ##### # # # ##### ##### # # # # # ### # # # ##### # ### # # ####### ### ### # ##### ### ### ####### # #
# #     # #         # #             # #     #   #   #   #   #   #       # # # #     # # #   #     #   # #     #     # #   # # # #   #   # # #       # #
# ##### # # ####### # ############# # # ######### # ######### # ### ##### # # ##### # # ### # ####### # ####### ##### ### ### # # ### ### # # ### # # #
# #   # #         #         #   #   #   #       # # #         #   #     #   #     # # # #   #   # #   #     #   #     #       #   #   #   #   #   # # #
# # # # ####### ########### ### # ####### ##### # # ### ######### ############### ### # # ##### # # ##### ### ### ### # ####### ### ### ####### ### # #
#   # #       # #         #     #         #   #   #     #       #   #     #     #     # #   #   # # #   # #   #   #   #   #   # #   # #     #   #   # #
##### ####### # # ####### # ######### # ### # ########### ######### # ### # ### # ##### ### # ### # # # # # ### ######### # # # # ### # ### # # ##### #
#     #   #   # #     # # # #       # # #   #   #     #     #       # # #   #   # #   # # # #     # # # # #   #         # # # # # #   #   # # # #     #
# ### # ### ####### # # # # # ##### ### ####### # # # # ### # ####### # ##### ### # # # # # ##### # # # ##### ######### # # # ### # ##### # # ### #####
# #     #   #     # # # # # # #   # #   #     #   # # #   #     #   # #     #   # # # # #   #     #   #     #   #     #   # #     #     # # #     #   #
# ##### # ##### # ### # # ### # ### # ### ### # ### ### ####### # # # # ### ### ### # # ##### ############# # # # ### ### # ########### # # ####### # #
#   #   #     # #     # #     #   # #   # #   # #   #   #     #   #   #   # #   #   # #   #   #     #       # # #   #   # #   #       # # #   # #   # #
### # ####### # ####### ######### # ### # # ##### ### ### ### # ######### ### ### ### # # # ### ##### ####### # ### ### ##### ### ### # # # # # # ### #
#   #   #     #   #   #     #     #   # # #     #       # # # # #       #   # #     # # # # #   #     #     # #   # # #       #   #   # # # #   # #   #
# ##### # ##### # ### # # ### # # ### # # ##### ##### ### # # ### ##### ### # ##### # ### # # # # ####### ### ### # # ######### ### ### # # ##### # # #
#   # # #   # # #   #   #     # # #   # # #   #     # #   # #         # #   # #     #   #     # # #       #   # #   #       #   #   #     #       # # #
# # # # ### # # ### ### ####### ### ### # ### ##### ### ### ########### # ### # ####### # ####### # ### ### ### ##### # ##### # # ####### ####### # ###
# # #     # # # # #   #   #   #   #   # #     #   #             #       #       #     # #   #     # #   #   #         #       # #   #   # #     # #   #
# # ####### # # # ### ### # # ### ### # ### ### # ############# # ############### # ### ### # ##### # # # ########### ####### # ### # # # # ### ##### #
# #         #   #   # # #   # #   #   #     #   #         #   # #             #   #   # #   #   #   # # #           # #     # # # #   # # # # #       #
# ########### ##### # # ##### # ### ######### ########### # # # ############# # ##### # # ##### ##### # ########### ### ### ### # ##### ### # ####### #
# #       #   #     # # #     # #   #       #   # #     #   # #   # #         #   # #   #   #   #   # #   #       #   # #     # #       #   #   #     #
# # ##### # ### ##### # # ##### # ### ##### ### # # # ####### ### # # ########### # ######### ### # # ### ##### ##### # ##### # # ####### ### ### #####
# #   # # # #     #   #   # #   #     #   #     #   #       # #     # #       # #     #       #   # # # #   #   #     #     #   #     #   #       #   #
# ### # # # ##### # ##### # # # ####### # ####### ##### ### # ### ### ##### # # ##### # ######### # # # ### # # # ####### # ######### ### # ####### # #
#     #   #       # #   #   # #     #   #   # #       # # # #   # #   #     #     # # # # #       #   #     # # # #     # # #         #   #     #   # #
####### ######### # # # ##### ##### # ##### # # ####### # # ### # # ### ######### # # # # # # ### ##### ##### ### # ### # # ##### ##### ####### # ### #
#     # #   #     # # #       #   #   #   #   #   #     #     # # #   #       # #   #   # # #   # #   #     #   #   #   # #     # # #     # #   # #   #
# # # # # ### ##### # ######### # ##### # # ### ### ##### ##### ##### # ##### # ### ##### # ### ### # ##### # # ##### ### ##### # # # ### # # ### # # #
# # # # #         # # #         # #     # # #   #   #     #     #     # #   # #     #     # # #     #   #   # #     # #   #     # #   #   # # #   # # #
# # ### # ######### # # ######### # ##### ### ### ### ##### ##### ##### # # # # ####### ### # ######### # ##### ### # ### # ##### # ### ### # ##### # #
# # #   # # #   #   #   #       # #     #     #   #   #     #     #   # # #   #         #   #       #   #       #   #   # #     # # #   # #   #     # #
# # # ### # # # # ### ####### ### ##### ####### ####### ##### ##### ### # ############# # ### ### ### ####### ######### ####### # ### ### # ### ##### #
# # # #   # # #   #   #       #   #   # #     # #     # #     #         #             # # #   #   #   #       #       #       # #     #   # #       # #
# # # # ### # ##### ### ### ### # # ### ### # # # ### # ### ##### ################### ### # ### ### ########### ### ######### # ####### ### # ##### # #
# #   #   # #     #     #   #   # #   #     # #   #   #   #     #     #   #         #     # #   # #             # # #       #   #     #     #   # # # #
# ####### # ##### ####### ### ### ### ####### ##### ##### ##### ##### # # # ####### ####### # ### ############### # # # ######### ### # ####### # # # #
# #     # #     #   # #   #   #   #         #     #     #       #     # #   #         #     #       #     #     # # # #   #       #   # #   #     # # #
# # ### # ### # ### # # ### ### ### ####### ##### ##### ######### ########### ####### # # # ######### ### # # # # # # ### # ##### # ### # # # ##### # #
#   #   #     #   # # #   #   # #   #     # #   # #   #         #           # #     # # # # #       #   #   # # # # #   #   #     # #   # #   #     # #
##### ######### ### # ### ### # # ### # ### # ### # # ### # ############### # ##### # ### ### ##### # ####### # # # ### ##### ####### ####### # ##### #
#   #   #     # #   #   # # # #   #   #   #   #   # # #   # #             # #     # #   #   # # #   # #   #   # # #     #   # #     #       # # #   # #
# ##### # ### # # ### # # # # ##### ##### ### # ##### # ### # ##### ####### # ### # ### ### # # # ### # # # ### # ####### # # # ### ####### ### # ### #
#       #   # # # #   # #   #     # # #     # # #     #   # # # #   #       #   # #   #   #   # #     # #   # # #       # # #   #   #     # #   #     #
# ######### # # # # # # ### ##### # # # ##### # # ### ### ### # # # # ########### # # ### # ### ####### ##### # ### ### # # ##### ### ### # # #########
#       #   #   # # # #   # #   # #   #       # # # # #   #     # # #     #       # # #   #   # #   #   #     #   # # # # #     #   #   # # #     #   #
####### # ####### ### ##### # ### ####### ##### # # # # ### ##### # ##### # ####### ### ##### # # # # ### ####### # # # # ### # ### ### # # ##### # # #
#   #   # #     #   #       #   #       #     # # #   #     # #   #     # #   # #     # # #   # # #   #   #     # # # # #   # #   #     #   #   # # # #
# # # ### ##### ### # ######### ####### ##### # # ########### # ######### # # # # ### # # # ### # ##### # # # ### # # # # ### ############### # # # # #
# # #   # #   #   # #       #   # #   #     # # #             #           # # # # # # # # #     #     # #   #   # # #   # #   #   #     #     #   # # #
### ### # # # # # # ####### # # # # # ##### # # # ########### ############# # # # # # # # ##### ##### ##### ### # # # ### # ### # # # # ### ####### # #
#   #   # # # # # # #         # #   #     # # # # #     #   #       #   #   # #   # #   #     #   # #     #   #     # #   #     #   # # #   #   #   # #
# ### ### # # # ### ########### ####### # # ### # # ### ### ##### # # # # ### # ### ######### ### # ##### ### ####### ############### # # ### # # ### #
#     # #   #   #   #     #   #   #     # #     #   # # #       # #   # #   # #     #   #   #   # #     #   # #     #                 # #   # #   #   #
# ##### ####### # ### ### # ##### # ##### ########### # # ####### ##### # ### ##### # # # # # # # # ### ### # # ### ################### # # # ##### ###
#     #     #   #   # # # #   #   # #   # #         #     #       #   # # #   # #   # #   # # #     # # # # # # # #     #     #   #   # # #   #   #   #
##### ### # # ##### # # # ### # ### # # # ### ##### ####### ####### # # ### ### # ### ##### ######### # # # ### # ##### # # # ### # # # # ##### ##### #
#   #   # #   #   #     #   #       # #       #   #     #   #   #   #   #   #   # #   #   #       #   # # #   #   #     # # #     # #   # #     #     #
### ### ##### # ######### # # ############# ### # ##### # ### # ####### # ### ### # ##### ####### ### # # ### ### # ####### ##### # ##### ##### # ### #
#     #     # # #       # # # #         #   #   # #     #   # # #     #   #     #   #   #       #   # #     #   # #   #     #     #   #         # #   #
# ######### # # # ##### # # # # ####### # ### ### ##### ### # # # ### ##### ### ##### # ### ### ### # ##### # ### ### ### ########### ########### #####
# #     #   # # #   #   # # # # #   # # # #   # #     #     # #     # #   #   #       #   # # # # # #       #     # #   #   #     #   #           #   #
# # ### # ### # ### # ##### ### # # # # # # ### ##### ##### # ####### # # ### # # ####### # # # # # ### ########### ### # # # ### # ### ########### # #
# #   #   # #   # # # #   # #   # #   # # #   #   #   #     # #       # #   # # # #   # #   #   # #   #   #   #     #   # # #   #   #     #     #   # #
# ### ##### ### # # # # # # # ### ##### ##### # # # ##### ### # ########### # # ### # # ##### ### ### ### # # # # ### ##### ### ####### # # ### # ### #
#   #     #   #   # #   #   #   # #   #   #   # # # #   # #   # #         # # #     # #       #     # #     #   # #   #       #   #   # #     #     # #
# ####### # # ### # # ##### ### # # # ### # ### # # # # ### ### # # ##### # # ####### # ####### ##### # ########### ### ######### # # ############### #
#     #   # # #   # # #   #   # # # #     # #   # #   #     #   # # #   # #   #       #   #   # #   # # # #     #   #   #       #   #         #       #
# ### # ##### # ### # # # ##### # # ####### # ### ########### ### # # # # ### # ######### # # # # # # # # # ### # ### # # ### # ############# # #######
#   #   #     # #   # # #   #   # #   #   # # #     #       # #   # # #     # # #     #     #   # # # #   #   #   # # #   #   #       #     # # #     #
### ##### # # # # ##### ### # ### ### # # # ### ### ### # ### # ### ####### ### # # ### ######### # # ####### ##### # ##### ######### # ### # # # ### #
#   #     # # # #         # #       #   #   #   #       # #   #   #     #       # # #   #         #   #       #   #       #   #       #   #   #     # #
# ### ##### ### ########### ####### ######### ############# ########### ######### ### ### ############# ####### ### ##### ### # ######### ########### #
# #   #   #       #     #       # #         # #   #         #       #   #       #     #   #     #       #     #     #   # #   # # #     # #           #
# ##### # ####### ##### # ##### # ######### # # # # ########### ### # ### ##### ####### ### ### # ### ### ### # ##### # ### ### # # ### # # ### ##### #
#       #     #         #   #           #   # # #   #   #       #   #   #     #   #   # # # # # # #   #     # #   # # #   # #     # # #   # #   #     #
############# ######### ### ############# ### # ####### # # ####### ### ##### ### # # # # # # # # # ### ##### ### # # ### # # ##### # ####### ### #####
#     #     #     # #   # #   #     #   #     #   #   #   #       #   #     # # #   # # # #   # # #   # #     #     # # #   # #     #         # #   # #
# ### ### ####### # # ### ### # ### # # # ##### # # # ########### ### # ### # # ##### # # ### # # ### ### ### # ##### # ##### # ####### ####### ### # #
#   #   #     #   #         # # # #   #   #   # # # #       #     #   #   # # #     #   #   # #   #   #   #   #   #   # #     #   #     #       # #   #
# # ### ### # # ########### # # # ######### # # # # ####### # ##### ####### # # ### ##### # # ##### ### ##### ### # ### # ####### # ##### ### # # ### #
# #   #   # # # #     #   # # #       # #   # # # # #   # # # #   #         # #   #     # # #     # # #     #   # # #       #     #   #   #   #     # #
##### ### # # # ### # # # # # ####### # # ### ### # # # # # # # # ######### # ##### ### # # # ##### # # ### # ### # ####### # ####### ##### ####### # #
#   # #     # #     # # #   #   #     # #   #   # # # # #     # #           #       #   # #   #   # #   # # # #   #       # # #     #     #       # # #
# # # ####### ####### # ##### # # ##### ### ### # # # # ### ##### ################### ######### # # # ### # ### ######### ### # # # # ### # ##### ### #
# # #   #         #   #   # # # # #       # # #   #   #   # #   #   #               #           #   # #   #     # #     #     # # # #   # #     #     #
# # ### ######### # ##### # # # # # ##### # # ##### ##### ### # ### # ############# ################# # # ####### # ### ####### # # ### # ######### ###
# #   #     #     #   #   # # # # #     # # #   #   #   #   # #   # #     #   #         #   #       # # #           #         # # # # # #         # # #
# ### ##### # ####### # ### # ### # ### # # # # # ### # ### # ### ####### ### # ######### # # ### ### # ####### ##### ##### ### # # # # ######### # # #
# #         #     #   # #   #     # #   # # # # #   # #     #   #       # #   #           #   #   #   # #     # #   #   #   #   # # # #   #   #   #   #
# ########### ##### ### ### ######### ### # ### ### # ### ##### ####### # # # ################# ### ### # ### # # # ### ##### ### # # ### # ### #######
# #         # #     #       #   #     #   #   #     #   # #     #     #     #         #     #   #   #   # # # #   #   #   #     # # #     # #   #     #
# # ####### # # ########### # # ### ### ##### # ####### # # ##### ### ############### # ##### ### ### ### # # ########### # ##### # ### ### # ### ### #
#   #   # # # # #     #       # #   # #     # # #     # # #     #   #   #   #   #   # # #     #   # #   # # #     #     #   #     #   #     #       # #
# ### # # # # # ### # ### ##### # ### ### ### # # ### # ##### ##### ### ### # # # # # # # ### # ### ### # # ##### # ### ### # ####### ##### ####### # #
#     # # # # #     #   # #   # # #       #   # # #   #   #   #     # #   #   #   # # # #   # #   # #   # #   #   #   #   # #   #   #     #   #   # # #
####### # # ########### ### # # # ######### ### # ### ### # ### ##### ### ### ##### # # ### # ### # # ### ### # ### # ### ### # # # ##### ##### # # # #
#     #   #           #     # # # #         #   #   # # #   # #     #       #     #       # # #   #     #   # #   # # # #   # #   #   # #       # # # #
# ### # ######### ### ####### # # # ######### ##### # # ##### ##### ####### ##### ######### # # ### ####### # ### # # # ### # ####### # ######### # # #
# #   # #     #   # # # #     #   #         # #     #     #     # #     # # #   # #         # #   # #       # #   # # #     # #   #   #         # # # #
# ##### # ### # ### # # # ##### ########### # ### ####### ### # # ##### # # # # ### ######### ### # # ####### # ##### # ####### # # ### ##### # # # # #
# #     # #     #       # #     #           # #   #     #     #       # # #   #     #         #   # # #       # #     #   #     # #   #   # # # # # # #
# # ##### # ############# ####### ########### # ### ################# # # ### ############# ### ### # ##### # # # ####### # ##### ### ### # # ### # # #
# # #     # #         #   #   #   #   #   #   # # #     #           # # #     #           #   #   # #     # #   # #   #   # #   #   #   # # #     # # #
# # # ####### ####### # ### # # ### ### # # ### # # ### # ####### ### # ####### ######### ####### ####### # ##### # ### ### # # ### ### # # ######### #
#   #               #       #   #       #       #     #         #     #                 #                 #       #         # #         #             #
#######################################################################################################################################################
