###########################################################################################
# #       #             #     #         #                 #           #         # #       #
# # ##### ##### # ##### # # # ### ##### ########### ##### ##### # ### # # ##### # # ### ###
#   #   #     # # #   # # # #     #   #   #   #     #   # #   # # #   # # # #   #   # #   #
##### ####### ### ### # ### ######### ### # # # ##### # # # # ### # ##### # # ### ### ### #
#   #   #   #     #   #   #   # #       #   # #   # # #   # #   # #   #   #   #   #     # #
# # # # # # ####### ##### ### # # # ######### # # # # ##### ### # ### # ### ### ####### # #
# # # # # #   #         # #   # # #       #   # # # # #       # # # # # #   #     #     # #
# # # # # # ### ####### # # ### # ####### # ### # # # # ##### # # # # # # ####### # # ### #
# # # #   #   #       # #   #   #   # #   #   # # #   # #   # #   #     # #     # # # #   #
# ### ####### ####### # ##### # ### # # # ### ### # ### # ### # ######### # # # # # ### # #
#           #     #   #       # #   # # #   #     # # #   #   # #       # # # # #   #   # #
# ######### # ### # ####### ### # ### # ########### # ### # ##### ##### # ### # ##### #####
# # #   #   # # # # #     # #   #     # #           #   # #       #   # #   # #     #     #
# # # # ##### # # # # ### # ####### ### # ############# # ######### # # ### # ##### # ### #
#   # #   #   #   #   # # #         #   #       #       #     #   # # #   #   # #   # #   #
##### ### # ### ####### # ########### ######### # # ######### ### # # ### ##### # ##### # #
#     # #   # # #     #   #     #   #         # # # #   #   #     # #   # #   #   #     # #
# ##### ##### # # # # # ### # # # # ### ##### # ### # # # # ##### # ### # # ### ### ##### #
# # #           # # # # #   # # # # #   # #   #   #   # # # #     #   # # #   # # #     # #
# # # ####### ### # ### # ### ### # # ### # ##### ##### # # # ####### # # # # # # # ### ###
# # # # #   #   # #     # #   #   #   #   #   # # #     # #   #     # #   # #   #     #   #
# # # # # # ##### ######### # # ####### # ### # # # ##### ##### ### # ##### ############# #
# #     # #       #         # #   #   # #     # # #         #   # # #   # # #             #
# ##### # ######### ### ##### ### # # # ####### # ######### # ### # ### # # ##### ####### #
#   #   #         # #   #   # #   # #         # #         # #   #   #   # #     #     #   #
### # ########### ### ### # # # ### ######### # ######### ##### # ### ### ##### ##### # ###
#   #       #   #   #   # # # # #   #       #   #       #       #     #       #     # #   #
# ########### # ### # # # # ### # ### ##### ### ##### ################# ##### ##### # #####
#     #   #   #     # # # #   # # #     #   #   #     #     #     #   # #   #   #   # #   #
# ### # # # ########### # ### # # # ##### ##### # ##### # # # # # # # ### # ### # ### # # #
# #   # #   #     #     # # # # # #   #   #   #   #   # # # # # # # #     #     # #     # #
# # # # ####### ### # ### # # # ##### # # # # ### # # # # ### # # # ############# ####### #
# # # # #   #   #   #   #   # #       # # # # # # # # # #     # #   #     #     # #     # #
### # # # # # ### ##### # ### ######### ### # # # # # # ####### ### # ### # ### # # ### # #
#   # # # # #       # #   #       #   # #   # #   # #     #     #   # # #   # # #   #   # #
# ### # # # ####### # ##### ##### # # # # ### ##### ####### ######### # ##### # ##### ### #
#   # #   #       #     #   #   # # # # # # #     #   #   #   #       #       #     # #   #
# # ############# ####### ### # # ### # # # ##### # ### # ### # ####### ##### ### ### # # #
# # #       #     #     #   # #       # #   #   #   #   #     # #     #     # #   #   # # #
### # ##### # ##### ### ### # ######### ### # # ##### ######### # ##### ##### # ### ##### #
#   #     #   #     #       # #         # # # # #   #     #     #       #     #     #     #
# ####### ##### ########### ### ####### # # # # # # ##### # ##### ####### ############# ###
#       #   # #       #     #   #   #     #   # # #     #   #   # #     #   #         #   #
# # ####### # # ##### ####### ### # # ######### ####### ####### # ##### ### # ##### # ### #
# #   #     #   #   #   #     #   # # # #     # #       #     #     #     #   #   # #     #
# ### # ##### ### ##### # ####### ### # # ### # # ##### # ### ##### # ######### # # ##### #
#   #   #         #     #     #   #     #   # #   #   # # # # #   #   #   #     # #   # # #
### ############### # ####### # ### ##### ### ##### ### # # # # # ##### # # ##### # # # # #
# #   #             # #     # #       #   #   #       #   # #   #       # # #   # # # #   #
# ### # ############# # ### # ######### ### ### ##### ##### ############# # # # # ### ### #
#   # #       #     # #   # #     #     # #     #   #     #             # # # # #   #   # #
# # # ### ### ### # # ### # ##### # ##### ####### # ### # # ######### ### # # ##### ### # #
# # #   #   #   # #     # #     #   #         #   #   # # #     #   #     # #     # #   # #
# # ### ### ### ######### ##### ########### # # # ##### # ##### # ######### # ### # # ### #
# #   # #     #   #         # #   #       # #   # #     #   #   #     #     #   # # # #   #
# ### # ####### # # ####### # ### # # ### # ##### # ####### # ##### # # ### ##### # # ### #
# #   #       # #   #   #     #   # #   #   #   # #     #   #   #   # #   #     # # #   # #
# ########### ##### # # ##### # ### ### ####### # ##### # ##### # ### ### ##### # # ### ###
#       #   #     # # #     # #       #   #   #     #   # #     # #     # #     # #   #   #
# ##### # # ##### # # ##### ######### ### # # ##### # ### # ##### ##### ### ##### ### ### #
#     #   #     # # #   #         #     # # #   # # # #   #     #     #   # #     # #     #
##### ####### # # ##### ######### ####### # ### # # # # ####### # ### ### # # # # # ##### #
# #     #   # # #     #         # #     #   #   #   # # #     # #   # # #   # # #   #   # #
# # ##### # ### ##### # ####### # # ### # ### ####### # ##### # ##### # ####### ### ### # #
#   #     #       # # # #       # # #   # #   #       # #   # # #     #         # # #   # #
# ### # ######### # # # # ####### # # ##### ### ####### # # # # # ####### ### ### # # # # #
# # # # #   #   #   # # # #   # # # #     #   # #         # # #   #     # #   #   # # # # #
# # # # # # # # ##### # # # # # # # ##### ### # ########### # ####### # ### ### ### # ### #
#   # # # #   # #   # # #   # # # #   # #     #       # #     #       # #   #         #   #
# ### # # ##### # # # # ##### # # ### # ##### ####### # # ##### # ##### # ### ######### ###
# #   # # #   # # #   # #   # # #   # #     # #     # #   #   # #   #   #   #     #     # #
### # ### # ### # ##### # # # # ### # # ### # # ### # ##### # # ### ### ### ####### ##### #
#   # #   # #   # #   # # #   #       # # #   # # # #       #     #   #   #   #   #       #
# ### # ### # ### # # ### ##### ####### # ##### # # # ############### ### ### # # ####### #
#   # # #   #     # #     #       #   #       # # # # #     #   #   # #       # # #   #   #
### ### # # ####### ############### # ######### # # ### ### # # # # # # ####### # # # # ###
#   #   # #     #       #           #         # # #   # #     #   #   # #     # #   # #   #
# ### ### ##### # ##### # ########### ####### # # ### # ######### ##### # ### # ##### ### #
#     #     #   # # #   #     #   #   #     # # #   #   #   #     #   # # # #   #   #     #
# ####### # # ### # # # ##### # # ##### ### # # # ##### # # ####### # ### # ##### # #######
# #     # # #   #   # # #   # # # #   #   # #   #     # # #         # #   #   #   #       #
# # ### # # ### ### # # # # # # # # # ### # ####### # # # ########### # ### # # ####### ###
#   # # # # # #   # # # # # #   #   #     #       # #   #   #       # #   # # #   #   #   #
##### # # # # ### ### # # # ##################### # ####### ### ### # ### # ##### # ##### #
#   #   # # #   #     #   # #         #           #       #     #   #   # #         #     #
### # ##### # # ########### ##### # ### ### ####### ############# ##### # ########### ### #
#   #       # # #     #   #       # #   #   #     # #         #   #   # # #   #       # # #
# ########### # # # ### # ######### # ####### ### ### ####### # ### # # # # # # ####### # #
#             #   #     #           #           #           #       # #     #   #         #
###########################################################################################
