#########################################
# #     #             # #   #           #
# # ### # ### ####### # # # # ##### ### #
# #   # # # #     # # #   #     #   #   #
# ### # # # ##### # # ##### ##### ### ###
#     # #   #   # #   #   # #     # #   #
####### ### ### # # ### # ### ##### ### #
#       #       # #     # #   #         #
# ####### ####### ####### # ### #########
# #   #   #   #   #   #     #     # #   #
# ### # ### # # ### # ########### # # # #
#   #     # #   #   #   #       # #   # #
### # ##### ##### ##### # ##### # ##### #
#   # #   #     # #   # #     # #     # #
# ### # # # ### # # # # ##### # ##### # #
# # # # # #   # #   # #   #   # #   # # #
# # # # # ##### ##### ### # ### ### # # #
# #   # #     # #       #   #   #   #   #
# ##### ##### # # ########### ### # ### #
# #     # #   #     #   #     #   #   # #
# # ##### # ##### ### # # ####### ##### #
# # #     #     # #   #   #     # #     #
# # # # ####### ### ######### # # # #####
# # # #       # #   #   #     #   # #   #
# # # ##### # # # ### # # # ### ### # # #
#   #   # # # #   # # #   # #   #   # # #
####### # # ####### # ##### ### # ##### #
# #   # # # #         #   #   # # #     #
# # # # # # # ######### # ### ### # #####
# # #   # #   #         #   # #   #     #
# # ##### ####### ##### ##### # ### ### #
# # #           # #     #     # #     # #
# # ####### ### # # ##### ##### ### ### #
# # #       # # # # #   # #   #   # #   #
# # # ####### # # # # # # # # ### ### ###
# #   #       # # #   # #   #   #   #   #
# ##### # ##### ####### ##### ##### # # #
#   #   # #     #         # #     # # # #
# # # ### # ##### ####### # ### ### ### #
# #     #         #           #         #
#########################################
