#############################################################################################################################################
#   #             #       #     #   #     #       #     #     #         #     #   #   #           #                   #     #     #         #
### # ### ####### # ##### # ### # # # ### # ### ### # ### # # # ####### ### # # # ### # ####### ### ####### ######### ### # # # # ##### ### #
# # # # # #     # #   # #   #   # #   # #     #     # #   # # #     #       #   #     #     #   #     #     #     # #     # # # #     #   # #
# # # # # # ### # ### # ##### ### ##### ########### # # ### # ### # ############# ######### # ### ##### ##### # # # ####### ### ##### # # ###
#   # # # # # # # #     #   #   #     #     #     # # # # # #   # #           #   #         #     #   #   #   # #   #     # #   # #   # #   #
# ### # # # # # # # ##### # # # ##### # ### # ### ### # # # ### ######### ### ##### ############### # ### # ### ##### ### # # ### # ####### #
#   #   #     # # # #   # # # #     #   #   #   #   #     # # #         # #   #                 #   #   # #   #       # #   # #   #     #   #
### ########### # ### # # # # # ######### ##### ### ####### # ######### # # ### ################# ##### # ######### ### ##### # ####### # ###
# #             #     #   # # # #     #   #     # #     #   #     #   # # #       #       #       #   # #         # #         #       # #   #
# ######################### ### # ### # ### ##### ##### # ### ##### # # # ######### ##### # ####### ### ######### # ######### # # ### # ### #
#       #         #       #   #     # #   # #   #       # #     #   #   # # #       #   # #   #   #               #           # # #   #     #
### ### ### ##### ####### ### ##### # # ### # ### ####### ### # # ####### # # ######### # # # # ### ########################### # # ####### #
#   #     # #   #           #     # #   #   #   #   #       # # #   #     # #   #     # # # # #       #   #   #               # # # #       #
# ####### # # # ######### ####### # ##### ### # ### ####### ### ### # ##### ### # ### # # ### # ####### # # ### ############# # # ### #######
# #   #   # # # # #       #       #   #   #   #   # #   #   #     # #   #     #   # # #       #   #     # #   # #   #       # # # #   # #   #
# # # # ### # # # # ####### ####### ### ####### # # # # # ### ##### ### ##### ##### # ############# ##### # # # # # # # ### # # # # ### # # #
#   # # #   # #   #       #     #   #   #       # #   #   #       #   #     #   #   # #   #       # #     # #     # # # # # #   # #   #   # #
##### # ### # ########### ##### # ### ### ####### ######### ##### ### ##### # # ### # # # # ##### # # ############# ### # # ##### ### # ### #
#     #     # #       #   # #   #   # #     #     #     #   #   #   #     #   # #   # # #       # # #           #   #   #   #   #     #   # #
# ########### # ### ### ### # ### ### # ### ### ##### ### ##### ### ##### ##### # # # # ######### # ########### # ### ### ### # ########### #
# #       #   #   #     #   #   # #   #   #   # #     #   #       #       #       # #       #   # # #       #   # #     #   # #     #       #
# # ### ### # # ##### ### # ### ### ######### # ### # # ##### ### ######### ######### ####### # # # # ##### # ### # ### ### # ### # # ##### #
# # # # #   #   #   # #   #   #   #     #     #     # #       # # #           #     # #       #   # # #     #   # # #   # # # #   #   #     #
# # # # # ####### # # # ##### ### ##### # ##################### # # ######### # ### # # ########### # ### ##### # ### ### # # # ### ##### ###
# #   #     # #   # # # #   #   #       # #             #     #   # #       # # # # # #             #   #   #   #   # #   # # #   # #   #   #
# ######### # # ### # ### # ### ######### # ########### # ### # ##### ##### ### # # ##### ##### ####### ### # ##### # ### # ### # ### # ### #
#   #   # # # #   # #     #     #     #     #   # #   #   #   #       #   #     # #     # #   #   #     # #   # #   #   # #   # #   # #   # #
### # # # # # ### # ##### ####### ### # ##### # # # # ##### # ######### # ####### ##### ### # ##### ##### ##### # ##### # ### ##### # ### # #
#   # # # #   #   #     # #       # #   #     #   # #   #   # #     #   #           # #     #       #     #   #   #     #     #   # #   # # #
# ### # # ### # ####### # # ####### ######### # ### ### # ### ### # ######### ##### # ############### ### # # # ### ##### ##### # # # ### # #
#     # #     # #   #   # #         #         # #   #     # #   # #     #     #   #   #   #   #       #   # # #   # #   #     # # #   #   # #
# ##### # ##### # # # ### ######### ### ####### # ######### ### # ##### # ##### # ### ### # # # # ##### ### ##### # # # ##### # # ##### ### #
# # #   #     # # # # # # #       #   # #     # # #   #       #   #   # # #     # # #   #   #   #     #     #     #   #     # # # #   # #   #
# # # ####### # # # # # # # ##### ### # ### # # # # # # # ### ##### # # # # ##### # ### # ######### # ####### ####### ##### # # # # # # # ###
#   # #       # # # # #   #   # #     #   # #   #   # # #   # #   # #   # # #   # # #   #   #     # # #       #     # #     #   #   #   #   #
### # # ####### # # # ####### # ######### # ####### # ### # ### # # ##### # # ### # # ##### # ### ### # ######### # ### ################### #
#   # # #     #   # #   #     # #         #   #   # #   # # #   # # #   # #   #   #   #     # # #   # # #       # #   #       #         #   #
# ### # ##### ##### ### # ##### # ##### ####### # ##### ### # ### # # # # # ### ### ### ##### # ### # # ### ### # ### ####### ##### ### # ###
# # # #           # # #   #       #   #       # #       #   #   # #   # #   #   #   #     #   #   #   # #   # # # # #   #   #     #   # # # #
# # # ######### ### # ##### ####### # ####### # ######### ##### # ##### ### # ### ### ##### ### # ### # # ### # # # ### # # # ### # # # # # #
#   #         # #   #         #   # # #       #   #   #       # #     #   # # # # #   #   # #   # #   # # #   #   #   #   # #   # # # # # # #
### ##### ### # # ######### ### # # # # ##### ### # # # ### ### # ####### # # # # ##### # # # ##### ### # # # ##### # ##### ### # # # # # # #
#   #   # #   # #     #   # #   #   #   #   # #   # #   # # #   #       # # # #       # # # #       # #   # # #     #     # #   # # # # # # #
# ### # ### ### ##### # # ### ### ####### # # # ### ##### # # ####### ### # # ####### # # # # ####### ##### ### ######### # ##### # # ### # #
# #   #     #   #   #   #   # #   #   #   # # # #   #   # #   #   #   #   # #   #   #   #   #       # #     #   #   #   # #     # # #     # #
# # ######### ### # ####### # # ### # # ### # # ### # # # ##### ### ### ####### # # ### ########### # # ### # ### # # # # ##### # # ####### #
# # #       # #   #         # #   # #   #   # #   #   # #         # #   #       # #   # #   #   #     # #   #   # # # #       #   #       # #
# # # ##### ### ############# ### # ##### ####### ##### ### ##### # # ### ########### # # # # # ####### # ##### # # # # ################# # #
# # #     # #   #   #         # # #     #         #   #   #     # #   #             # # # #   #         #     # # # # # #         #     #   #
# # ### ### # ### # ##### # ### # ##### ########### ##### ##### # ##### ##### ##### # # # ################### # ### # ### ##### ### # ##### #
# #     #   # #   #     # # # #   #   # #   #     #       #   # #     # #   # #   # #   #       #             #   # #     #     #   # #   # #
# ####### # # # ####### ### # # ### ### # ### # # # ####### # # # ### ### # # ### # ########### # ### ####### ### # ##### # ##### ### # # # #
#   #     # #   # #     #   #   #     # #     # # # #       #   # #   #   # #     #   #     #   # #   #     #   # # #   # # #     #   # #   #
# ### ### ####### # ##### ### ### ### # ### ### # # ##### ####### # ### ### ##### ### # ### # ### ##### ### ##### # # # # # # ##### # # #####
# #   #   #       # #       #   #   # #   # #   # #     #   # #   # #   #   #   # # # #   #   # # #     # #         # # # #   #     # #   # #
# # ### ### ### ### # ##### ### ##### ### # # ######### ### # # ### # ### ### ### # # ### ##### # # ##### ########### # ##### # ##### ### # #
# #   # #   #   #   #   #   # # #   #   # # #         #   # # # # #   #   #   #   # #           #                 #   #     # #     #   #   #
# ### ### ### ### ##### # ### # # # ### # ######### # ### # # # # ##### ### # # ### ########### ############### ### ####### ####### ### ### #
# # #   #   #   # #   # # #   # # #     #   #   #   #   # # # # #     #   # # #     #         #     #   #       #   # #     #     # # #   # #
# # ### ### ### # # # ### # # # # ##### ### # # # ### ### # # # # ### ### # ####### # ####### # ##### # ######### ### # ##### ### # # ### # #
#     #     # # # # #     # # # # #   #   # # # #   # #   #   # # #   #   #       # #     # # # #   # #         # #   #     #   #   #   # # #
##### ####### # # # ####### ### # ### ### # # # # # ### ####### # ##### ### ### ### ##### # # ### # # ######### # # # ##### ### ##### ### # #
#   #   #     # # #       #     # #   #   #   # # # #   #       #       # #   #     #   # # # #   #   #       #   # # #     #   #         # #
# # ### ##### # # # ##### ### ### # ### ####### # # # ### ####### ####### ### ######### # # # # ######### ######### ### ##### ############# #
# #   #   #   # # # #   #   # #   #       #   # # #   #   # #     # #         #         # # #   #         #       #   #   #     #           #
# ### ### # # # # # # ##### # # ### ####### # # # ##### ### # ##### # ######### ### ##### # ##### # ##### # # ##### # ### # ### # ###########
#   #   #   # #   #   #     #   #   #       #   #   #   # #   #       #       #   # #     #   #   # #     # # #     #   # #   # # #         #
### # # ##### ####### # ######### ### ############# # ### # ######### ### # # ### ### ##### # # ### # ##### # # ##### ### ##### # ### # ### #
#   # # #     #   #   #   #     # # #       #     # #   #   #       #   # # # #   #   #     #   #   #   #   #   #   #   # #   # #   # # #   #
# ### # # ##### # # ##### ### ### # ####### ### # # # # # ##### ### ### ### # # ### ### ######### ####### ####### # ### # # # # ### # # #####
#   # # # #     # #   #   #   #   # #     #   # # # # # #       # # #   #   # #   #   #     #   # #   #   #       #   #   # # #   # # #     #
# ### ### # # ####### # ### ### ### # # ##### # # # # # ######### # # ### ### ### ### ##### # # # # # # ### ######### ##### # ### # ### ### #
# #   #   # #         #   # #   # #   #     # # #   # # #           #   # # #   #   #     #   # #   # #   # #   #   #   #   #     #   # # # #
# # # # ### ########### # # # ### # ##### # # # ##### # # ############# # # ### ### ##### ########### ### # # ### # ### # ### ####### # # # #
# # # # #   #     #   # # # # # #   #     # # #     # # # #           # # #   #     #   #       #       # # # #   #       #   #     # #   # #
# # # # # ### # ### # ### # # # # ### ####### ##### ### # ####### ##### # # ####### # # ####### # ##### # # # # ######### ##### # # # ### # #
# # # # # #   # #   #     # # #     # #   #   #   #   # #       #     # # #       #   #       # # #   # # # # #     #   # #     # # #   # # #
### # # # ##### # ######### # # ##### # # # ### # ### # ####### ##### # # # ### # ####### ##### # # # # # # # ### ### # ### ##### ##### ### #
#   # # # #     # # #       # #   #   # # #     #   # # #     # #     #   #   # # #   #   #     #   # # #   # #   #   # #   #   #     #   # #
# ##### # # ##### # # ##### # ##### # # # ######### # # # ### # # # ########### # # # # ### ######### # ##### # ### ### # ### # ##### ### # #
#   #   #   #     #   #   # #   #   # # # #       # #   #   #   # # #       #   # # # # # #         # # #     # # #   #   #   # #   #   #   #
### # ####### ##### ### # # ### # ### # # # ##### # ####### ##### ### ### # # ### # ### # ######### # ### ### # # ### ##### # ### # ### ### #
#   #       # #   # #   # #   # # #   # #   #     # #       #     #   #   #   # #   #   #   # #     # #   #   #   # #     # #     #   #   # #
# ######### # # ### # # ##### # # ### # ####### ### # ######### ### ### ####### ### # ### # # # ##### # ### ##### # ##### ########### ### # #
# #   #     # #   # # #     #   #   # #       #     #     #   #   #   #   #         # #   # # #     # #   # #     #     #         #     # # #
# # # # ##### ### # # ##### ####### # ####### ########### # # ### ### ### ######### # ### # # ##### # # ### # ######### ######### # ### # # #
#   # # # #     # # #   #   #     # #       # #         #   #   #       #         # #     #       # # # #   #   #       #       # # #   #   #
##### # # # ### # # ##### # # # # # ##### ### # ### ### ####### ################# ########### ##### # # # # ### ### ### # ##### # # # #######
#     # #   #   # #   #   # # # #   # #   #   #   # #       # #       #     #   #             #   # #   # # # # #   #   # #   # #   #   #   #
# # ### ##### ### ### # ### ### ##### # ### ##### # ####### # ####### # ### # # ### ########### # # # ### # # # # ### ### ### # ####### ### #
# # #   #     #         #     #   #   # # # #     # #   #           # # # # # #   # #   #     # #   # #   #   # #   #   #   # #       #   # #
# ### ### ##### ############# ### # # # # # ##### # # # ####### ##### # # # # ### ### # # ### # ####### ##### # ### ####### # # ##### ### # #
#   #     #   #     # #     # #   # # # # #     # #   #       # #   #   #   #   #     #   # # #       # #   # # #   #       # # #       #   #
# # ####### # ##### # # ### # # ##### # # ##### ##### ####### ### # ##### ### # ########### # ####### # # # # # # # # ####### # ### ####### #
# #     #   #   # #   # # # #   #     # #     #     #       #     #     # #   # #           #       # # # #   # # # #       # #   #   #     #
##### # # ##### # ### # # # ##### ### # ##### ##### # ######### ##### ### # ### # ##### ########### # # # ##### # ######### # ### ##### #####
#     #   #       #   # #     #   #   #       #     # #       # #   #     #   # # #   #     #   #   # # # #   # #         # #   #   #   #   #
# ############### # ### ##### ### ####### ##### ##### # ##### ### # ##### ##### ### # ##### # # # ### # # # # # ### ##### # # # ### # ### ###
#     #         # #   #   #     # #   #   #   # #   # # #   #   # #     # #     #   #     #   # # #   # # # # #   # #     # # # #   # #     #
# ### # ####### ##### ### ##### # # # # ### # # # # # # # # ### # ##### # # ##### ####### ##### # # # # ### # ### # # ##### ### # ### # ### #
#   #   #   #   #       #   #   #   #     # #   # #   #   #   #   #     #   #     #     #   #   # # # # #   # #   # #   # #     # #   #   # #
### ##### # # ### ######### # ########### # ##### ########### ##### ######### ##### ### ### # # # ### # # ### # ### ### # ##### # # ##### # #
#   # #   # #     #   #     #         #   #   #         # #   #     #     #   #   #   # #     # #     #     # # #   # #     #   #   #   # # #
# ### # ### ######### # ##### ####### # ##### ######### # # ### ##### ### ### # # ### # ##### ####### ####### # ### # ##### # ####### # ### #
# #   #   #     #     #     # #   #   # #   #   #         # #   #     #       # #     #   #   #       #     # #     #     # #   #     #     #
# ### ### # ##### # ####### ### # # ##### # ### # ######### # ### ######### ### ######### ##### ####### ### # ### ####### # ### # # ####### #
#   #   # # #   # #   #   #   # # #       # #   # #   #   # #   #         # #   #       # #     #     # #   #     #     # # # # # #     # # #
### # # # # # # # ### # # ### # # ######### # ### # # # # # ### ####### # # # ######### # # ####### ### # # ####### ### # # # # ##### # # # #
#   # #   #   # # #   # #   # # #   #     #   #   # #   # # # #   #   # # # # #         # #     #   #   # # #         # # # # #     # # # # #
# ########### # # # ### ### # # ### ### ### ####### ##### # # ### # # # # # # ### ### ### ##### # # # ### ### ######### # # # ##### ### # # #
# #   #     # #   # #   #   # # # #   #     #     # #     # #   #   # # # # #   # # # #     #   # # #   #     #   #     #   # #     #   #   #
# # # # ### ####### # ### ### # # ### ####### ### # # ##### # # ##### # # ##### # # # # ##### ### # ### ######### # ####### # # ##### #######
#   #   # #     #   #   #     #   #   #     # # # # #   #   # #   #   # # #       #   #     # #   #   # #       # #       #   #     #       #
######### ##### # # ### ##### # ### # # ### # # # # ### # ### # ### ##### # ############### # # ####### # # ### # ####### ### ##### # ##### #
#   #   #       # #   # #   # # #   # # # #   # #   # #   #   #   #     #   #     #       #     #     # # #   #         #   #   # # #     # #
# # # # # ####### ### # # # ### # ##### # ##### ##### ##### ##### ##### ##### ### # ##### ##### # ### # ### # # ########### ### # # ##### # #
# # # # # #         # #   #     #   #   #           # #     #     #   #       # #   #   # #   # #   # #   # # # #   #       #   # # #     # #
### # # # # ####### ############### # ### ####### # # # ##### ### # # ######### ####### # # # # ### # ### ### # # # # ####### ### # # ##### #
#   # #   # #     #   #     #     # #   # #       # #   #   # #   # #                   #   # #   # #   #     # # #   #     #   # # #   #   #
# ### ##### # ### ### # # # # # ### ### # # ####### # ### # # ### ### ######### ##### ####### ##### ### ##### ### ##### ### ### # # ##### # #
#     #     # # # # # # # # # #   #   # # # # #     # # # # #   #   #     #   #   #   #       #     # #     # #   # #     #       #     # # #
# ##### ##### # # # # # # # ##### # ### # # # # ##### # # # # # ### ##### ### ### ### # ### ### ##### # ##### # ### # ################# # # #
# #   #       # # # # # # # #   # #     # # # # #       # # # # # #     #       #   # # #   #   #     #       # # #     #         #     # # #
# ### ######### # # # # # # # # # ####### # # # # ####### # ### # ##### ####### ### ### ##### ### # ########### # # ##### ####### # ##### ###
# #           #   # # # # #   # #     #   # #   #   #     # #   #   # # #   #   # #   #     # # # #     #   #   # # #       #     #   #     #
# # ### ####### ### # # # ##### # ### ##### # ####### ##### # ### # # # # # # ### ### ##### # # # ##### # # # ### # # ####### ### ### ##### #
# # #   #       #   # # #     #   # #   #   # #       # #   # #   #   #   # #     # #     # # #   #     # # #   #   # #   #   #   #   #   # #
# # ##### ####### # # # ##### ##### ### # ### # ####### # ### # # ######### ##### # ##### # # # ### # ### # ### # ### ### # ### ### ### # # #
# #           #   # # # #   #   #   #   # #   # #       # #   # # #       # #         #   #   # #   # #   # #   # #       # # #   #     # # #
# ########### # ### # # # # ### # ### ### ### # # ##### # # # # ### ##### # ######### # ######### ##### ### # ##### ####### # ### ####### # #
#       #       #   #   # #     #   # #     #   #   #   # # # #       #   #       #   #         #       #   #       #       #   #   #   #   #
####### ### ############# ####### # # # ### ####### # ### ### # ####### # ####### # ######### # # ####### # ######### ####### # ### ### ### #
#     #   #   #           #     # #   # #   #     # #     #   #     #   #   #   # #   #       # # # #     #   #     # #       #   #     #   #
# ### ### ##### ########### ##### ##### # ### ### # ####### ######### ##### ### # ##### ####### # # # ####### ##### # # ######### ##### # ###
# #     #   #   # #     #         #   # # #     # # #       #         #   #   # # #     #       #   # #     # #     # #       #     #   #   #
# ##### ### # ### # ### # ######### # ### ##### ### ##### ### ### ####### ### # # # ##### ######### # ### ### # ### # ######### ##### ##### #
#   #     #   #   # #   #   #   #   #     #     #   #     #   #   #     #       # #   #   #       # #   # #   # # # #   #     #         #   #
# # ########### ### # ##### # # ### ####### ##### ### ##### # ##### ### ######### ### # ####### # ##### # # ### # # ### # ### ########### ###
# #                 #         #     #                 #     #         #               #         #       #       #     #     #               #
#############################################################################################################################################
