###############################
#     #   #           #       #
##### # # ### ####### ##### # #
#   # # #   #     #   #     # #
# # # # ### ##### # ### ##### #
# # # #   #     # #   # #   # #
# ### # # ##### # ### # ### # #
# #   # # #       #   #   #   #
# # ### # # ######### ### # ###
#   #   # # #       #   # #   #
# ### ### ### ##### ### # ### #
# #     #         #   #   # # #
# # ################# ##### # #
# # #         #     #   #   # #
# ### ####### # ### ### # # # #
# #   #     # #   #     # # # #
# # ##### # # ### ####### # # #
# #   #   # #   #   # #   #   #
# ### # ### ### ### # # #######
#     #   # # #     # # #     #
######### # # ####### # ### # #
#         #           # #   # #
# ### ############### # # ### #
# #   #     #         #   #   #
# # ####### # ####### ##### ###
# #       #   #     #     #   #
# ####### ##### ### ######### #
#   #   #   #   # #         # #
### ### ### # ### ######### # #
#         #               #   #
###############################
