#############################################################
#   #                       #       #   #     #           # #
### ##### ####### ######### # ### # # ### # ### ##### ### # #
# #     # #     #   #   #   #   # #   #   # #   # #   #     #
# ##### # # ### ### # # # ##### # ##### ### # ### # #########
#     # # # # # # # # #   #   # #       #   # #   #   #     #
### # # ### # # # # # ##### # # ######### ### ### ### # ### #
#   # #     #   #   #       # #     #   # #   #   #   #   # #
# ########### ### ########### ##### # # # # ### # # ##### # #
#           # # #           #     # # #   #     # #       # #
##### ##### # # ### ####### ##### # # ### ####### ######### #
#   #   #   # #     #     #     #   # #         # #       # #
# # ### ##### # ##### ### ########### ########### ### # ### #
# # #   #     #     #   #           #         #       # #   #
# # # # # ############# ########### # ####### # ######### # #
# #   # # #   #         #         # #       #   #         # #
# ##### # # # # ######### ######### ####### ##### ######### #
# # #   # # #   # #                 #     #   # # #   #     #
# # # ### # ##### # ################# ### ### # # ### # #####
# # #   #   #     # #       # #       # #   #   #   #   #   #
# # ### ##### ##### # ##### # # # ##### ### ### ### ### # # #
# #     #   #       # # #   # # # # #       #     #   #   # #
# ####### # # ####### # # ### # # # # ############### ##### #
# #   #   # # #   #   # #   #   # #   #       #       #     #
# # # # ### # # # # ### ### # ### # ### ##### # ####### #####
# # #   # # #   #   #     # # #   # #       #   #     # #   #
# # ##### # ######### ##### # # ### # ##### ######### # # # #
#   #     #     #   #       # #   # # #     #       # # # # #
# ### ### ##### # # # ####### ### # ### ##### ##### # # # # #
# #     #     # # #   #   #   # # # #   #     #   #   # # # #
# ####### ### # # ##### ### ### # # # ### ##### # # ### # ###
#   #   # #   #   #     #       # #   #   #     # # #   #   #
### # # ### ####### ### # ####### ##### ### ##### ### ##### #
# #   #   #     #   # #   #     # #   #   # #   #   # #     #
# ####### ##### # ### ##### ### # ### # # # ### ### # ### # #
#       #     #       #     #     #   # #   #   # #   #   # #
# ### ####### ####### # ########### ### ##### # # ##### ### #
#   #       #   # #   #     #   #       #     #   #     #   #
########### ### # # ####### # # # ########### ### # ##### ###
#             # #     #     # # #     #   #   # # #   # # # #
# ##### ####### # ##### ##### # ##### # # # ### # ### # # # #
#   # # #   #   #   #   #     #     #   #   #   #     #   # #
# # # # # # # ##### # ### ######### ########### ####### ### #
# # #   # #   #   # #       #     #           #     # #     #
# # ##### ##### # # ####### ### # ########### # ### # ##### #
# # #   # #     # # #   #   #   #       #     # #   #     # #
# # # # # # ##### ### # ### # ##### ##### ##### ### ##### # #
# #   #   #   # #     #   #   #     #     #   #   #       # #
# ########### # ######### # ######### ##### # # # ##### ### #
# #   #       #       #   # #     #   # #   # # #     # #   #
# # # # # ##### ### ### ##### ### # ### # ### # ##### ### ###
# # #   #     # # #   # #     # #   #     # # # #   # #   # #
# ########### # # ### # # ##### ##### ##### # # # ### # ### #
#     #       #   #   #   #         #       #     #   # #   #
##### # ######### # # ######### ########### ####### ### # # #
#   # #   #     # # #           #         #   #   # #   # # #
# ### # # ### # ### # ########### ##### ##### # # # # ### # #
#     # # #   #     # #         # #     #   # # #   #     # #
# ####### # ########### ####### # # ##### # # # ########### #
#         #                   #   #       #   #             #
#############################################################
