#################################################################################
#   #             # #           # #       #     #         #     #       #   #   #
### ########### # # # ### ##### # # # ##### # # ##### ### ### # ##### # # # # # #
# #     #       # #   #   #     #   #     # # #   #   # #     #   #   # # #   # #
# ##### # ####### ##### ### ######### ### # # ### # ### ######### # ### ##### # #
#     # # #     #     # # # #   #   # # #   #   #   #   #         # #       # # #
# ##### # # ### ##### # # # # # # # # # ####### ##### # # ######### # ##### ### #
#   #   # # # #   #   # # #   #   # #     #     #     #   #   # #   # #   #   # #
# # # ### # # ### # ### # ######### ##### # ##### ######### # # # # ### # ### # #
# # #   # #     # #     #         # # #   # #   # #       # # #   #   # #   # # #
# # ### # # ##### ########### ### # # # ### # ### # ### # # # ####### # ### # # #
# #   #   # #     # #       #   # # #   #   #     # #   #   #       #     # #   #
##### ####### ### # # # ### # ### # ##### ### ##### # ############# ####### ### #
#             #   #   # #   # #   #       # # #   # # #           #       #   # #
# ############# ### ### # ### # ########### # # ### # ####### ### ####### ### # #
#     #   #   #   # #   # #   #   #           #     #   #   # #   #     #     # #
##### # # ### ### ### ### ####### # ################### # # # ##### # # ####### #
#     # #   #     #   # #   #     #     #   #           # # #     # # # #     # #
# ### # ### # ##### ### ### # ### ##### # # # # ####### # # ##### # # ### ### # #
#   # #   # #   #   #     # #   # #   # # #   #   #     # #     # # #     #   # #
# # ##### # ### # ### ##### ### ### # # # ####### ##### # ##### # # ####### # # #
# # #     #   #   #   #     #   #   #   # #     #     # # #   # # #       # # # #
### # ####### ####### # ##### ### ####### # # ####### ### ### # # ##### ### # # #
#   #     #   #     #     #     #   #     # #       #         # #   #   #   # # #
# ### ##### ### ### ##### ##### ### # ##### ####### ########### # # # ### ##### #
# #   #     #   # #     # #       # # #   # #     #   #     #   # #   #   #     #
# # ### ### # ### ##### # # ##### # # # # ### ### # ### ### # ##### ### ### #####
# # # #   # # #     #   #   #     # #   #   # #     #   # # #     #   # #   #   #
# # # ### # # # ### # ####### ##### ####### # # ##### ### # ##### # ### # ### ###
# # # #   # #   # # # #         #   #     #   #   #   #   #       # #   # #     #
# # # # ######### # # # ####### # ### ### ####### # ### # ######### # # # # ### #
# # # #             # # #     # # # # # #         # #   #         # # # # #   # #
# # # ############### ### ### ### # # # ########### # ######### # ### ### ### # #
#   #   #   #       # #   # #     # #   # #       # # #     #   #   #   #   # # #
# ### # # ### ##### # # ### ####### ### # # # # ### # ##### # ##### ### ### # # #
#   # #   #   #   # # # # #     #       #   # # #   #       #   # # #   # # # # #
### # ### # ### ### # # # # # # ####### ##### ### ######### ### # # # # # # ### #
# # # #   # #   #   # # #   # # #     #       #   #       # # # #     #   #   # #
# # # # ### # ### ### # ##### # # ### ### ##### ### ### ### # # ######### ### # #
# #   #   # #         #   #   #   #   #   #   # #     #   #   #         # # #   #
# ####### # ######### ### # ####### ### ### # # ######### ### ######### # # ### #
#   #   # # #   #   #   #   #     # # # #   # #   #       # # #     #   #   # # #
# ### # # # # # # # ### ##### ### # # # # ### ### # ##### # # ### ### ##### # # #
#     # # #   #   #   #     # #   # #   # # # #   #   #     # #   #   # #     # #
# ##### # ####### ### ##### # # ### # ### # # # ##### ####### # ### ### # ##### #
#   #   #   #   # #   #   # # # #   #   # # #   #     #       # #   # #     #   #
# ### # ### # # ### ##### # ### # ####### # ####### ### ####### # ### # ##### ###
# #   # #   # #     #   #       # #       #   #     #   #     # #   # #   #   # #
# # ##### ### ####### # ####### # # # ##### # ### # # ### ### # ### # ### # ### #
# # #       # #     # #     #   # # # #     # #   # #     #     #   # #   # #   #
# # # ####### # ### # ##### # ### ### # # ### # ### ####### ##### ### # ### # # #
# #   #   #   #   # #   # # #   #     # # #   #   # #     # #     #     #   # # #
# ##### # # ### ### ### # # ### ######### # ##### # # # ### # ##### ##### ##### #
#       # #   # #     # # #   #     #   # #     # #   # #   #   #   #   #       #
######### ### # # ##### # ### ##### # # # ##### # ##### # ##### # ### # ####### #
#     #   # #   #   #       # #   #   # #   # # #   #   #   #   #   # #       # #
# ### # ### ####### # ####### # ####### ### # # # # ### ### # ##### # ### ##### #
# #   #         #   #   #   # #     #   #   #   # #   # # # #   #   # # #     # #
# ### ######### # ##### # # # # ### # ### ### ####### # # # ### ##### # ##### # #
#   #         # #     # # #   #   #     #   #   #     #   # # #       #     #   #
# # ########### ### # # # ############# ### ### # ####### # # ######### #########
# #         #   # # # # # #           #   # # #   #       #   #       #         #
# ######### # ### # # # # # ######### ### # # ##### ######### # # ##### ####### #
# #       #   #   # # # #   #       # # # # #               # # #       #     # #
# ##### ######### # ### ####### ### # # # # ####### ######### # ########### # # #
#     #     #     #     #       #   # #     #     # #       # #     #       # # #
##### ##### # # # ####### ####### ### ####### ### ### ##### # ##### # ####### # #
#   #     #   # #   #   #   #     # # #     #   #     #   #   #   # #       # # #
# # ##### # ### ### ### # # # ##### # # ### ### ####### ####### # # ##### # ### #
# #   #   # #   # #   #   # #   #   #   # #     #               # #     # # #   #
# ##### ##### ### ### ### # ### # # ##### ################# ##### ##### ### # # #
#     #       # #   #   # #   # # #   #   # #         #     #     #   #   # # # #
# ### ######### # # ### ##### # ### # # # # # ### ### # ##### ##### ##### # # ###
#   #     #       # #   #     # #   #   # #     # # #   #   # #     #       #   #
### # ##### ####### # ### ##### # ####### ####### # ####### # ##### # ######### #
#   # #       #     # #   #     # # #     #   #   #         # #   #   #         #
# ### # ####### ##### # ### ##### # # ##### # # ### ####### # # # ### # ####### #
# # #   # #     #     #   # #     # # #     # # #       #   # # #   # # # #     #
# # ##### # ##### ####### # ##### # # ##### # # # ##### ##### # ### ### # # #####
#         #               #       #         #   #     #         #       #       #
#################################################################################
