#######################################################################################################################################################
#   #             #       #     #   #     #       #     #     #   #         #               #       #                 #     #     #         #         #
### # ### ####### # ##### # ### # # # ### # ### ### # ### # # # # # # ####### # ########### # ####### ##### ######### ### # # # # ##### ### ##### # ###
# # # # # #     # #   # #   #   # #   # #     #     # #   # # # #   # #       # #       # #   #       #     #     # #     # # # #     #   #     # #   #
# # # # # # ### # ### # ##### ### ##### ########### # # ### # ### ### # ####### # ##### # # ### ####### ##### # # # ####### ### ##### # # ##### ##### #
#   # # # # # # # #     #   #   #     #     #     # # # # # #   #   #     #   #   #   # #   #     #   #   #   # #   #     # #   # #   # #   #   #     #
# ### # # # # # # # ##### # # # ##### # ### # ### ### # # # ### ######### # # ####### # ##### ##### # ### # ### ##### ### # # ### # ####### # ### ### #
#   #   #     # # # #   # # # #     #   #   #   #   #     # # #         # # #         #         #   #   # #   #       # #   # #   #     #   # # #   # #
### ########### # ### # # # # # ######### ##### ### ####### # ######### # ##### # ############### ##### # ######### ### ##### # # ##### # ### # # # ###
# #             #     #   # # # #     #   #     # #     #   #     #   # #       # #       #       #   # #         # #         # #     # #   # #   #   #
# ######################### ### # ### # ### ##### ##### # ### ##### # # ### ####### ##### # ####### ### ######### # ######### # ##### # ### # ### ### #
#               #         #   #     # #   # #   #       # #     #   #   # # #       #   # #   #     #             #           # #     #     #   #   # #
# ### ######### # ####### ### ##### # # ### # # # ####### ### # # ####### # # ######### # # # # # ### ######################### ### ########### # ### #
# # # #   #   # #       #   #     # #   #   # # #   #       # # #   # #     #   #     # # # # # #     #   #           #           #     #       # #   #
# # # # # # ### ##### # ######### # ##### ##### ### ####### ### ### # # ####### # ### # # ### # ####### # # # ####### # ######### # ##### ######### # #
# #   # # #         # #   #       #   #   #       # #   #   #     # #         #   # # #       #   #     # # # #   # # # #         # #   #     #     # #
# # ### # ### ##### ##### # ####### ### ### ##### # # # # ### ##### ######### ##### # ############# ##### # # # # # # ### ##### ##### # ##### # # ### #
# #   # #   # #   #   #   #     #   #   #       # #   #   #       #   #     # #     # #   #       # #     # #   # #       #     #     #   #   # # #   #
# # ### ### ### # ### # ####### # ### ### ##### # ######### ##### ### ##### # # ### # # # # ##### # # ########### ####### ####### ##### # # ##### # ###
# # #   # # #   # #     #   #   #   # # # # #   # #     #   #   #   #     #   # # # # # #       # # #           #   #   # #       #   # # #     # # # #
# ### ### # # ### ####### # # ### ### # # # # ### ### ### ##### ### ##### # ### # # # # ######### # ########### ### # # # # ######### # # ##### # # # #
#     #   # #   # #       # #   # #   #     #   # #   #   #       #       #     #   #       #   # # #       #   #   # #   # #         # # # #   # #   #
# ####### # # ### # ####### ### ### ####### ### # # # # ##### ### ########### ####### ####### # # # # ##### # ### ##### ### ### # ##### # # # ### #####
# #   #   #   #   #   # #     #   #     #   #   #   # #       # # #           #     # #       #   # # #     #   # #   #   # #   # #     # # # #   #   #
# # # # # ##### ##### # # ####### ##### # ### ##### ########### # # ######### # ### # # ########### # ### ##### # # # ### # # ### # ##### # # # # # # #
#   #   #   # #         #   #   #       #   # #   # #         #   # #       # # # # # #             #   #   #   #   # #   # # #   # #       # # #   # #
########### # ######### ### # # ############# # # # # # ##### # ##### ##### ### # # ##### ##### ####### ### # ### ### ### # # # ### ######### # ##### #
# #       #       #   #   # # #   #         # # #   # # #   # #       #   #     # #     # #   #   #     # #   # # # #   # #   # # #           #     # #
# # ### ######### # # ### # # # # # ### ### # # ##### # # # # ######### ######### ##### ### # ##### ##### ##### # # ### ####### # ############# ##### #
# # # #         # # # #   #   # # #   #   # # #     # # # #   #       #               #     #       # #         #     #       # #             # #     #
# # # ##### ### # # # ######### # ### ### # # ####### # ##### ##### ### ######### ################### # ##### # ##### ##### # # ### ######### ### ### #
# #     # # #   # # #     #     # #   #   # #         #     #       #   #     #   #               #     #   # #     #     # # #   #       #       #   #
# ##### # # ##### # ##### # ##### ### # ### ##### ######### ######### ### ### # ### ########### # # ##### # ### ### ##### # ##### ####### ######### ###
#     #   #   #   #   #     #   #   # #   #     #   #     #   #       # # #   #   # #   #       # #     # #   # # #   # # #     #   #   #     #     # #
# # # ### ### # ##### ####### ##### ##### ##### ##### ### ### # ####### # ### ### # # # # ####### ####### ### # # ### # # ##### ### # # # ### # ##### #
# # #   # #   # #   # #   #   #   #     #   # #       # #   #           #   #   #     # # #   # # #       # # # #       # #       #   # #   # #   #   #
# # ### # # # # # # # # # ### # # ##### ### # ######### ### ############# # ### # ####### # # # # # ####### # # ######### # ########### ### # ### # # #
# # #   # # # #   # #   #   # # #     #     #   #         #   #   #     # # # # # #       # #   #   #       # #     #     #   #       # #   # #   # # #
# # ##### # ####### ##### # # # ##### ####### # # # # ####### # # # ### ### # # ### ####### # ####### ### ### ### # # ####### # # ### # ##### # ### ###
# #       #   #     #   # # #       #     #   #   # # #     #   #   # # #   # #   # #       # #   #   # #   #   # # # #   # #   #   # #     # # #     #
# ########### # ##### # ### ######### ### # ####### ### ### ######### # # ### ### # # ##### # # # # ### ### ### # # # # # # ####### ####### # # # ### #
#       #     # #   # #   #         #   # # #     # #   #   # #         #   #   #   # #     # # # # #     #   # # #   # # #       #       #   # #   # #
######### ##### ### # ### # ##### # ### # # ##### # # ### # # # ########### # # ##### # ####### # # ### ### # # # ##### # # ##### ##### ####### # ### #
#     #   #         # #   # #   # #   # # # #     #     # # # #   #   #     # #     # #     #   # # #   #   # # #   #   #   #   #     #     # # # #   #
# ### # ### ######### # ##### # # ### # ### # ### ####### # # ### # # # # ####### # # ##### # ### # # # # ### # ### # # ##### # ######### # # # # # ###
# # # #         #     #       # # #   #     # # # # #     #     # # #   # #       # #     #   #   #   # # #   #   #   # #   # #         # #   # # #   #
# # # ######### # # ########### ### ### ##### # # # # ####### ### # ##### ### ##### ########### ####### # # ##### ####### # # ######### # ### # ##### #
# # #       #   # # #     #         #         #     #   #   # #   # #   #   #   # #       #     #       # # #     #   #   #   #     #     #   # #   # #
# # ####### ##### # # ### ############################# # # ### ### ### ### # # # ####### # ##### ####### ### ##### # # ######### ### ####### # # # # #
# #       # #   # # #   #   #   #             #     #   # #     # #     # # # # #     #   #   #   #   # #     # #   #   #         #   # #   # #   #   #
# ### # # # # # # # ### ### # # # ########### # ### # # # ####### ##### # # # # # ### # ##### # ### # # ####### # # ##### ### ##### ### # # ######### #
#   # # # # # # # # # #   #   #   #     #   #   #   # # # #   #       #   # # # # #   #       #     # #           #     # # #     #   # # #         # #
### # # ### # # # # # ### ############# # # ##### ### ### # # # ##### ### # # # ### ######### ####### ##### ########### # # ##### ### # # ####### ### #
#   # #   # # #   # #   #   #   #       # #   #   #       # # #     #     # # # #   #       # #   #   #   #           # #     #   #   # #       # #   #
# ### ### # # ##### ### ### # ### # ##### ### # ### ######### ##### ####### ### # ### ##### # # # # ### # ##### ####### ##### # # # ### ####### # # ###
# #   # # #   #   # #   # # #   # #   #   #     # # # #       # #   #   #   #   #         #   # # #     #     # #     # #     # # # #         # # #   #
# # ### # ##### ### # # # # # # # ### # ######### # # # # ### # # ### # # ### # ############### # ########### ### ### # ####### # # # ######### # ### #
# #   # # #   #       #   # # #     # # #   # #   # #   # #   # # #   # # #   # #   #     #     #       #   # #   # # #       # # # #   #   #   #   # #
# ### # # # # # ########### # ####### # # # # # # # # ### # ### # ##### # # # ### # # ### # ####### ### # # # # ### # # ##### # # # ### # # # ##### # #
# #     #   #     #       # #   #     #   # #   #   # #   # #   # #     # # #   # #   # # #       # #   # # #   # #   # #     # # # #   # #   # #   # #
# ##### ########### ##### # ### # ####### # ### ####### ### # # # # # ### ##### # ##### # # ####### # ### # ##### # ### # ##### ### # ### ##### # ### #
# #   # #       #   #     # #   #   #   # #   #       #   # # # # # # #   #     # #     #   #       #     #   #   #   # #     #     # #   # #   #     #
# # # # # ### # # ### ### # # ##### # # ##### ####### ### # # ### # # # ### ### # ##### ##### ######### ##### ### ### # ##### # ##### # ### # # #######
#   # # #   # # # #   # # # #   #   # #       #     # #   #   #     # #   # # # # #     #   #     #   # #   # #   #   #     # # #     #   #   #   #   #
# ### # ##### ### # ### # # ##### # # ######### ##### # ####### ######### # # # # # ### # # ##### # # ### # # # ### ### ##### # # ### ### ##### # # # #
# # # #   #   #   # #     # #     # #   #   #         #         #   #     # #   #   #   # #     # # #   # # #   #   #   #   # # #   #   #       # # # #
# # # ### # # # ### # ##### # ##### ### ### # ######### ######### # # ##### ######### ### ### ### # ### # # ##### ####### # # # # # ### ######### # ###
#   # #     # # #   # #       #   # #   #   # #       #   #     # #   #   #         # #   #   #   #   #   # #     #     # #   # # # #   #     #   #   #
### # ####### # # ##### ####### # # # ### ### # # ### ### # ### # ### # # ####### # # # ### ### ##### ##### # ##### ### # ##### # # # ##### # # ##### #
# # #       # # #   #   #   #   # # # #     # # # #     #   #   #   # # #   #   # #   #   # # #     # # #   # #     # #   #   # # # # #     # # #   # #
# # ####### ### ### # ### # # ### # # ### # # # # ##### ### ####### # # ### # # ### ##### # # ### # # # # ### # ##### ####### # ### # # ####### # # # #
#   #     #     # #   # # #   #   # #   # #   # #     # # # #       # #   #   #   # #     #   # # # # # #     # #     #       #     #   #     #   #   #
# ### # ######### ##### # ##### ####### # ##### ##### # # # # ##### ##### ####### # # ####### # # ### # ####### # # ### # ############# # ### ####### #
# #   #         #       #     #         #   # #   # # #   # #     # #   #   #     # # #         #     # #       # #     #             # # #     #     #
# # ########### # ##### ##### ############# # ### # # ### # ##### # # # ### # ##### # ### ############# # # ##### ############### ##### # # ### # #####
# #     #     #       #     # #   #     #   #       # # # #   # # # # #     #     # #   #   # #     #   # #   #             # #   #     # # #   # #   #
# ##### # ### # ####### ### # # # # # # # ######### # # # ### # # # # ########### # # # ### # # ### # # # ### ####### ##### # # ### ##### # # ### # # #
#     # # # # #   #   # #   # # # # # # #     #   # # #     #   # # # #         # # # # #     # # #   #   # #       # #   #   #   #   #   # # #   # # #
##### # # # # ##### # ### # # ### # # # ##### # # # # ##### ### # ### # ####### # # ### # ##### # ######### ####### # # # ### ### ### # ### # # ### ###
# #   # # # #   #   # #   # #   #   # #     # # # # #   # #   # #     # #       # #   # # #   #   #               # # # # # # # #     #   # # #   #   #
# # ##### # ### # ### # ### ### # ### ### ### # # ##### # ### # ######### ####### ### # ### # ### ######### # ##### # # # # # # ######### # # ### ### #
# # #     #   #   #   # #   # # #   #   # #   # #       #   # # #   #     #       # # #   # #             # #     # # # # #   # #       # # #   #   # #
# # # ##### # ##### ### # ### # ####### ### ### ######### ### # # # # ##### ####### # ### # ############# # ##### # # # # # ### # ##### # # ####### # #
# #   #     #   # #     #   # #   #   # #   # #   #       #   #   # #     # #     # #   #     #   #     # #     # # # # # #     #     # # # #   #   # #
# ######### ### # ######### # ### # # # # ### # # # ##### # ####### ### # # # # # # ### ####### # ### # # ### ### # ### # # ##### ##### # # # # # ### #
#         # #         #   # #   # # # # # #     # # #     #       #   # # # # # # # #   #     # #   # #   #   #   #   # # # #     #   # # #   # #   # #
####### # # # ####### # # # ### # # # # # # ##### # ######### ####### ### # # # # # # ### ### # ### # ######### # ### # # # # ##### # # # ##### ### # #
#       # # # #     #   # #   # #   # # # # #   # #           #       #   # # # #   # #   # # #   # # #       # #   #   # # # #   # #   #   # #   #   #
# ####### # ### ### ######### # ##### # # # ### # # ########### ####### # # ### ##### # ### # ### # # ### ### # ### ##### ### # ### ### ### # # ##### #
# #       # #   # # #   #       #   # # # #     # #   #     #   #       # #   # #   # # #       # # #     # #   # #     #       #   # #   #   #       #
# # ####### # ### # # # # ####### # # # # ##### # ### # ### # ######### # ### # # # # # # ##### # # ####### ##### ##### ######### ### ### ### #########
# #         #     # # #   #       #   # #   #   #   # # # # # #       # #   # #   #   # # #   #   # #           #         #     # #       # # #       #
# ############### # # ##### ########### ### # ##### # # # # # # ##### # ### # ### ##### ### # ##### # ########### ######### ### # # ####### # # # ### #
# #             # #   #   #       #   #   # #   # # # # # # #   #   # #   # #   #   # #     #   #   #         #         #   # #   #         # # #   # #
# # ########### # ####### ####### ### # # # ### # # ### # # ##### # # # # ##### ### # # ####### # ### ####### # ######### ### ####### ##### # ### # # #
# #   #     #   # #         #   #   #   #   # #   #       #     # # # # #   #   #   #       #   #   #   #   #   #         # #     #   #   # #   # # # #
# ### # # ### # # ##### ### ### ### # ####### # ############# ### # # ##### # ##### ######### ##### ##### # # ### # ####### # # ### ### # # ### # # ###
# #   # #   # # # #     #     #   # # #     #   #   #       #     # #   #   #     #         # #   #       # #   # # #   #     #     #   # # #   # #   #
# # ####### # ### # ######### ### # # # ### # ### # # ##### # ##### ### # # ##### ######### # # # ######### # ### ### # ######### ### ### ### ####### #
# #       # #     # #     #       # #   # # #   # # #   #   #     #   # # # #     #         #   #   # #     # #   #   # #       #   # # #     #       #
# ####### # ####### # ### ##### ### ##### # ### # # ### # ####### # # # # ### ### ##### ##### ##### # # ####### # # ### # ##### ### # # ######### ### #
#     #   #       #     #     # #   # #     #   # #   # #       # # # # #   #   # #   #   # # #   # # #     #   # #   #   # #   #   #   #         # # #
# ##### ### # ### # ##### ### # # ### # ######### ### # ####### ### # # ### ### ### # ### # # # # # # ##### # ### ### ##### # ######### # ### ##### # #
#     # #   # # # # #   #   # # #   #             #   #       # #   # # #   # # #   #   # #   # # # #     #   # #   #     # #     #     # #   #   #   #
##### # ##### # # # # # ##### # ### ############### ##### ### # # # ### # # # # # ##### # ##### # # ### ####### ### ##### # ##### # ####### ##### # ###
#   #   #     #   # # #       #   #     #   #     # #   #   # #   # #   # #   #   #   # #   #   # #   #   #       #   # #       # #   #   # #     #   #
# # ### # ####### # # ### ############# # # # ### # # # ##### ####### ### ##### ### # # ### # ### # # ### # # ####### # ####### # ### # # # # ### ### #
# #   #   #     # # #   # #   #       # # # # # #   # #       #           #   #   # # #   #   # # # #   #   # #     #     # #   #   #   # # #   #   # #
# ### ##### ### # ### # # # # # ##### # # # # # ##### ####### # ########### # ### ### ### ##### # ##### # ### # ### ##### # # ##### ##### # ### ##### #
# #       # # # #   # # # # # # #     # # # #     #   #     # #   # #       #   #     #   #     # #     # # #     #         #   # #       #   #   #   #
# ####### # # # ### ### # # # # # ##### # # ##### # ####### # ### # # ######### ####### ### ### # # ##### # ################### # ########### # # # ###
#     # #   # #   #     # # #   #       # #       #     #   #   #   #   #     # #       #   #   # # #   #   #                   #             # #   # #
# ### # ##### ### ####### # ######### ##### ####### ### # ##### ### ### # ### # # # ####### # ### # # ##### # ################### ####### ##### ##### #
# #   #         #   #     # #       # #   #     #     # #       #   #   # #   #   # #     # # #   # #       #   #               # # #     # #   #     #
### ####### # ##### ####### # ##### ### # ##### ####### # ####### ### ### # # ####### ### # # # ### ### ####### ####### ### ##### # # ##### # ### ### #
#   #     # # #     #       # #   #   # #     #       # #       # #   #   # # #         # # # # #     #   #   #   #   #   #         # #     #     #   #
# ### # # ### # ##### ##### # # # ### # ##### ####### # ######### # # # ### ### ######### # ### ##### ##### # ### # # ############### # ### ####### ###
#   # # #   # # #     #   # #   #   #   #     #     # #           # # #   #     #   #     #   #   #   #   # #   #   #     #     #     # # #     #   # #
### # # ### # # # ### # # # ####### ##### ##### ### # ############# # ### ######### # ####### ### # ### # # # ########### # ### # ##### # ### # # ### #
#   # #   #   # # #   # # # #   #   #     #       # #   #           #   # #       # #       #       #   #   #     #   #   #   # #   #       # # #   # #
# # ##### ##### # # ### # # # # # ### ##### ##### ##### # ############# # # # ### # ####### ######### ######### ### # # ### # # # # ####### # ##### # #
# # #   # #     # # # # #     # # #   #   #   # #     # #   #           # # #   #       # #   #       #       #     #   #   # # # #   #   # #       # #
# ### # # # ####### # # ######### # ### # ### # ##### # ### # ########### ### # ####### # ### # ####### ##### ############### # ##### # # # ######### #
#   # # #         # #   #   #   # #   # #           # # #   # #         #   # # #     # #   # #       #   #       #           #       # # # #     #   #
# # # # ######### # # ### # # # # ### ########### ### # # ### # ####### ### ### # # ### # # # ####### # # # ####### # ################### # # # # # # #
# # # #   #     #   #   # #   # # # #   #   #   # #   # #   # # # #       #     # #       # #   #   # # # # #       #             #     # # # # #   # #
### # ### ### # # ####### ##### # # ### # # # # ### ### # # # # # # ############# ####### ### # # ### # # ### ################### # ### # # # # ##### #
#   # # #   # #   #     # #     # #   #   # # #     #   # # #   #   #   #   #     #     # #   # #   # # #   # #       #       #   # #     # # # #     #
# ### # ### ####### ### # # ##### ### ##### # ####### ##### ##### ##### # # # ##### ### ### ### ### # ##### # ### ### # ### ### ### ####### # # # #####
#   #   #   #     # # # # #   #   #     #   #   #           #       #   # #   #   # # #     # #     #     #       # #   #   #   # #     #   # # #     #
### # ### # # ### # # # # ### # ### ### # ##### # ################# # ### ##### # # # ####### ##### ##### ######### ##### ### ### # ### # ##### # #####
#   # #   # # # #   # #   # #   #     # #     #   #     #       #     #   #     # # # #       #         #       #   #   # #   #     #   #     # # #   #
# ### # ##### # ##### ##### ##### ### # ##### ##### ### # ##### ##### # ### ####### # # ##### # ############### # ### # # # ### ##### # ##### # ### # #
#     #   #   #   #             #   # #   # #       # #   #   # #   # #     #       #   #   #   # #           # #     #   #   # #   # #     # #     # #
# ####### # ### # # ##### ##### ##### ### # ######### ##### # # # # # ### ### ####### ##### ##### # ####### # # ##### ####### # ### # ####### ##### # #
# #   # # #   # #       # #   #   #   #   #           #     # #   # #   # #   #     # #   #       # #     # # #     #   #   # # #   #       # #   # # #
# # # # # ### ########### # ##### # ### ######### ### ### # ####### ##### # ### ##### # # ### ### # # ### ### ##### ### ### # # # ######### # # # ### #
# # #   #   # #     #     #   #   #   #   #       #       # #       #     # #         # #     #   # # # #     #     # #   # # #   #         # # #   # #
# # ### # ### # ### # ####### # ##### ### # ####### ####### # ### ### ##### # ####### # ##### ##### # # ##### # ##### ### # # ### # ### ##### # ### # #
# #   # #     #   #   #       # #     #   #       # #     # # #   #   #   # # #     #   #     #     # #       #     #     # # # # #   # #     # #     #
# # # ########### ##### ####### # ##### ### ##### ### ### ### ##### ### # # ### ### ########### ##### ##### ####### # ##### # # # ### ### ##### ##### #
# # #     #       #   #   #   #   #   # # #   # # #     #   #     # #   # # #   # #           #   # # #   # #     # # #     # #     #   #   #       # #
# ### ### # # ##### # ### # # ##### # # # ### # # # ####### ##### # # # ### # ### ########### ### # # # # ### # # # # # # ### ######### ### ####### # #
#   # # #   # #     #     # #       # # #       #   #     #     # # # #   # #   #         #   # # # # # #   # # # # # # #   # #   #   #   #         # #
### # # ##### # ########### # ######### ############# ### ### # # # # ### # ### # ####### # # # # # # # ### # # # # # ##### # # # # # ### ########### #
# # #     #   #         #   #         #               #   #   # #   # #   #     # #       # #   # # #   # #   # # # #       # # #   #     #         # #
# # ##### # ### ####### # ########### ################# ### ### ####### # ######### # ##### # ### # ##### ##### # # ######### # # ######### # ####### #
# # #   # #   #     # # # #     # #   #     #       #   #     # #       # #     #   # #     # #   #       # #   # #     #     # # #   #     #     #   #
# # # # ##### ##### # # # ### # # # ### # ### # ##### ####### # # ####### ### # # ### # ####### ##### ### # # ######### # ##### ### # # ######### # ###
#     #       #       #       #   #     #     #               #   #           #   #   #               #     #             #         #           #     #
#######################################################################################################################################################
