#####################################################################################################
#   #             #             # #       #     #         #     #       #               # #         #
### ########### # # ##### ##### # # # ##### # # ##### ### ### # ##### # # ### ######### # # ### #####
# #     #       # #   #   #     #   #     # # #   #   # #     #   #   # #   #         # # # # #     #
# ##### # ####### ##### ### ######### ### # # ### # ### ######### # ### ##### ####### # # # # ##### #
#     # # #     #     # # # #   #   # # #   #   #   #   #         # #       #   # #   #   # #   # # #
# # ### # ### # ##### # # # # # # # # # ####### ##### # # ######### # ##### ### # # # ##### # # # # #
# # #   # #   #   #   # # #   #   # #     #     #     #   #   # #   # #   #   # # # # #     # #   # #
# ### ### # ##### # ### # ######### ##### # ##### ######### # # # # ### # ### # # # ### ##### ### # #
#   #   # #   #   #     #         # # #   # #   # #       # # #   #   # #   # #   #   #       #   # #
### ### # ### # ########### ##### # # # ### # ### # ### # # # ####### # ### # ### ### ######### ### #
#     #   #   # # #       #   #   # #   #   #     # #   #   #       #     # #   # # #     #     #   #
# ######### ### # # ### # ##### # # ##### ### ##### # ############# ####### ### # # ##### # ##### # #
# #       #   #   # #   #       # #       # # #   # # #           #       #   # # #   #   # #     # #
# # # ##### # ##### # ########### ######### # # # # # ####### ########### ### # # # ### ### # ##### #
#   #       #       #     #     # #           # #   #   #   #           #     # # #   # #   #   #   #
# ####################### # ### # # ################### # # # ######### ####### # ### # # ##### # ###
# #         #     #     # # #   # #     # #             # # #     #   #       # #     # #   # # # # #
# ### # ### # ### # # # # # # ### ##### # # ### ####### # # ##### # # ##### # # # ##### ### # # # # #
#   # # #     #   # # # #   #   # #   # # # # #   #     # #     #   #   # # # # # #   # #   # # #   #
### ### ####### ##### ######### ### # # # # # ### ##### # ##### ####### # # # # ### # # # ### # #####
#   #   #   #       #   #       #   #   #   #   #     # # #   # # #       # # #   # # # # #   # #   #
# ### # # # ####### ### # ####### ####### ### # ##### ### ### # # # ####### ##### # # # # # ### # # #
# #   # # # #   #       # #     #   #   #   # #     #         # #       #   #     # # #   #   #   # #
# # ### # # # # ####### # # ### ### ### ### # # ### ########### # ####### ### ##### # # ### # ##### #
# # #   # # # #   #     #     #   # #     # # # # #   #     #   # #       #   #     # #   # #     # #
# # ##### # # ### ############### # # ### # # # # # ### ### # ##### ##### # ### ##### ### # ##### # #
#   #     # #   #           #     # #   # # # # #   #   # # #     # #   # # # #   #   #   # #     # #
##### ##### ### ########### # # ### # # ### ### # ### ### # ##### # # # # # # # # ### # ### # ### # #
#     #   #     #             # #   # #   #   # # #   #   #       #   # # # #   #   # #   # # # # # #
# ##### ######### ############# # ####### ### # # # ### # ######### ### ### ### ### # ### ### # # # #
# #   #           #     #     # # #     #   #   # # #   #   #     #   #   #   #   # #   #     #   # #
# ### # ####### ##### ### ### ### # ### # ####### # # ##### # # ##### ### ### ### # ### ####### ### #
# #   # #     #       #   # #     # #     #       # #     #   # #     #   # # #   # # #       # #   #
# # ### # ### ####### # ### ####### ##### # ####### ##### ##### # ##### # # # ##### # ####### ### ###
# #     #   #   # #   # #       #       # #     #   #   #   #   #   #   #   #   #   #   #   #   #   #
# ######### ### # # ### # ### # ####### ##### ### ### # ### # ##### # ##### ### # ### # # ##### ### #
#           #   # #   # #   # # #     #       #   #   # #   #     # #   # # # #   #   # # #   #     #
# ########### ### ### # ##### # # ### # ####### ### # # # ####### # ### # # # ####### # # # # ##### #
#         #   #       #   #   #   #   #   #   # #   # # #     # # #   # #       #     #   # #       #
######### # ### ######### # ####### ### ### # # ### # # ### # # # ### # ######### # ##### # #########
#   #     #   # #       #   #     # #   #   # #   # # #   # # #   #   #           #   #   # # #     #
# # ######### # # ##### ######### # # ### ### ### # # ### ### # ### ################# ##### # # ### #
# #           #   #   #   #       # #   # # # #   # # # #     # #   #     #   #     #       # # # # #
# ################# # ### # ### ### ### # # # # ### # # ##### ### ### ### # # # ### ######### # # # #
#     # #     #     #   #   #   #   #   # # #   #   # #     # #   # #   # # # #   #         #   # # #
# ### # # # ### ####### ##### ### ####### # ######### # ### # # ### # # # # # ######### # ### ### # #
# # # #   #     #   #     #   # # #       #   #       #   #   # # #   # #   #         # # #       # #
# # # ### ######### # ### # ### # # # ##### ### # ####### ##### # # ### ############# # # # ####### #
#   #   # #         # # # #     # # # #         #   # #   # #   # # # # #         #   # # #   #     #
####### # ##### ### # # # ##### # ### # ########### # # ### # ### # # # ### ##### # ### ##### # #####
#       # #     # # # # #   #   #     #   # #     # #       # #       #   # #     # #         #     #
# ####### # ##### # # # ### # ########### # # # ### ####### # ####### ### # ### ### ### ########### #
#   #   # #   #   # # #     # #       #   #   #   #     #   # #   # # # # #   #   #   # #         # #
# # # # # ### ### # # ####### # ##### # ### ##### ##### ### # # # # # # # ### ### ### # # ####### # #
# # # #     #   #   #         #     # # #   # #       #   # #   # #   # #   #   #   # # #   #   # # #
# # ####### ### # ################### # # ### # ##### ### ####### # ### ### # # ##### # ### # ### # #
# #     # #   # #           #         # #     #   # #   #   #     # #   #   # # #     # # # # #   # #
##### # # ### # ########### # ####### # ##### ### # ### ### # ##### # # # ##### # ##### # # # # ### #
#   # # #   #   #     #     # #   #   #     #   # #   #   #   #   # # # #     # #   #     # # #     #
# # ### # # ##### ### # ##### # # ### ##### ##### # # ### ##### ### # ####### # ### ####### # ##### #
# #     # #   # #   # #   #     #   # #   # #     # #   #   # #     # #     # #     #       #     # #
# ####### ### # # # ##### # ####### ### # # # ####### # ### # # ##### # ### # ##### # ####### ##### #
# #       # #   # # #     #   #     #   # #   #       # #   # # #     # # # #     #   #   #   #     #
# # ####### ### # # # ##### ### ### # ### ##### ######### ### # # # ### # # ##### ####### # # # #####
# #     # #   # # #   #   # #   # # # #     #   #   #   # #   # # #       #   #   #       # # #   # #
# ##### # # # # # ##### # ### ### # # # ##### # # # # # # # # # # ######### # # ### # # ### # ### # #
#     # #   #   #     # #     # #   # #       #   #   #   # #   #   #     # # #   # # # #   #     # #
##### # ############# # ####### # ### ##################### ######### ### # # ### ### # # ######### #
#     #   #   #     #   #       #   #   #   #         #   # #         # #   # # # #   # # #     #   #
# ##### # # # # ### ####### # ##### ### # # ### ##### # # # # ######### ##### # # # ##### # ### # # #
# #     #   # # # #         # #     #   # #   #     # # # # #   #             # # #       #   #   # #
# ######### # # # # ########### ##### ### ### ##### # # ### ### ### ##### ##### # # ######### ##### #
#         # # # # #           #   # #   # #   #   # # #   #   #   # #   #       # # #       # #   # #
######### # # # # ########### ### # ### # ### # # # # ### ### # # ### # ### ##### # # ##### # # # # #
#     #   # #   #         #   #     #   #   #   #   #   #   # # # #   #   # #     #   #   # # # # # #
# ### # ### ##### ####### # ### ##### ### # ########### # # # ### # ##### ### ######### ### # # # # #
# #     #   #   #       # #     # #   #   # #   #     # # # #     #   #   #   #   #       #   # # # #
# ####### ### # # ##### # ##### # # ####### ### # # ### ### ### ##### # ### ### ### ##### ##### ### #
#     #       # # #   # # #   # # # #     #   #   #   # #   #   #     #     #           #     #     #
# ### ######### ### # # ### # # # # # ### ### ####### # # ### ### ########### ##### ####### ### #####
# # # #     # #   # # #   # # #   #   # #     #       # #     #   # #     #   #   # #       #   #   #
# # # # ### # ### # # ### # # ### ##### ####### ####### ####### ### # ### # ### # ### ##### # ### # #
#   #   # # #       #     # #   # #           #         #       #   # # #   # # # #   #     #     # #
### ##### # ############# # ### ### # ####### # ######### ####### # # # ##### # # # ### ########### #
# # #     #     #         #   #     #     # # #           #     # #   #   #   # #   # #     #     # #
# # # ######### ############# ########### # # ############# ### # ##### # # # # ##### ##### # ##### #
#   # #     # # #           #     #     # # # #     #   #   # #   #     # # # #   #           #     #
# ### # # # # # # ######### ##### # ### # # # # ##### # # ### ##### # ### # # ### ########### # #####
#   #   # # # #   #       #   #   # # # # #     #     #   # #     # # # # # #   #         #   # #   #
### ##### # # ##### # ### ### # ### # # # ####### ######### # ### # # # # ##### ######### ##### # # #
# #       # #       # #   # #   #     # #         #             #   # # #   #         # #     # # # #
# ######### # ####### # ### ##### ##### ############### ############# # ### # ####### # ##### # # # #
# #       # #       # # #       # #   #               # #   # #       #   # #   # #   #   #   # # # #
# # ### ### # ####### # # ##### # # # ########### ### # # # # # ####### ### ### # # ##### # ### ### #
#   # #     # #       #   # #   # # #   #         # # #   #   # # #       #   # # # #     #   #     #
# ### ######### ########### # ### # ### # ######### # ######### # # ##### ### # # # # ### ### ##### #
#   #           #   #       #   # # # # # # #       # #       # # #     # #   # #   # # #   #       #
### # ########### ### ##### ### ### # # # # # ### ### # ##### # # ##### # # ### # ### # ### #########
#     #                   #         #     #     #       #       #       #       #     #             #
#####################################################################################################
