#########################################
#       #       #           #         # #
####### ### ### # ### ##### ### ##### # #
#       #   #   #   #   #   #   #   #   #
# ####### ####### ##### # ### ##### ### #
# #     #     #   #     #     #       # #
# # # ### ### # ### ########### # ##### #
# # #     #   #   # #     #     # #   # #
# ### ##### # ### # # ### # ### # # # # #
#   # #   # # # # #     # # # # # # #   #
### # ### # # # # ####### # # # ### #####
# # #     # #   # #   #   #   #         #
# # ### ### ### # # # # ##### ###########
#   #   #   #   #   # # # #   # #       #
# ####### ########### # # # ### # ##### #
#       #     #       # #       # #   # #
####### ### # # ####### # ####### ### # #
#     #   # #   #       # #     #     # #
# ####### ####### ### ##### ### # ##### #
#         #     # #   #     # #   #   # #
# ######### ### # ##### ##### ##### # # #
# #       # #   #   #   #     # #   # # #
# ### ### # # ##### # ##### # # # ### # #
#     # #   #     # #   #   #   #   #   #
####### ######### # ### # ##### ### ### #
#   #     #     # #     #     #   # #   #
# # # # ### ### # ### ####### ### # ### #
# # # #     # # #   # #     # #   #   # #
# ### ####### # ### # # ### # # ##### # #
# #   #       #     #   #     #   #   # #
# # ##### ### ########### ######### ### #
# #   #   #   #         #   #       # # #
# ### # ### ### ##### # ### # ####### # #
#   # # #   #       # #   # # #       # #
# # # # # ### ####### ### # # ### # ### #
# # # # # #     #     #   # #   # #     #
# ### # # ####### ##### ####### # #######
# #   # # #       #   #     #   #   #   #
# # ### # # ####### ####### # ##### ### #
#       #   #                 #         #
#########################################
