#####################
#       #   #       #
####### # # ####### #
#       # #         #
# ####### ###########
# #   #         #   #
# # # # ####### # # #
# # # # #     # # # #
# ### # # ### # # # #
#   #   # #   #   # #
### # ### # ##### # #
# # # # # #     # # #
# # # # # ##### # # #
#   #   #   # # # # #
# ####### # # # ### #
#       # # # #   # #
####### ### # ### # #
#     #   # #     # #
# ####### # # ##### #
#           #       #
#####################
