#################################################################################
#       #       #     #   #   #                   #     #                 # #   #
####### ### ##### ### # # # # # ##### ### ####### # ### # # ############# # # # #
#       #   #   #   #   # # #   # #   #   #     # #   # # # #     #     # #   # #
# ####### # # # ### ##### # ##### # ####### ### # ### # # ### ### ### # # ##### #
# #       # # # #   #   # # #     # #   #   #   #     # #   #   #   # # # #     #
# # ### # ### # # ### # # # # # ### # # # ### ######### # # ### ### # ### # ### #
# # #   # #   #   # # # #   # #   #   #     # #   #     # #   # # # #     #   # #
# ### ### # ####### # # ######### ########### # ### ##### ### # # # # ##### # ###
#   # #   #   #     # #           #     #     #       #     # # # # # #     #   #
### # ####### ##### # # ######### ##### # ########### ####### # # # # ### ##### #
# # # #     # #   #   #   #   # #     # # #       #           #   # #   #     # #
# # # # ### # # # ##### # # # # ##### # # # ##### ##### ####### ### ### ##### # #
#   #     # #   # #   # # # # #     # # # #     #   #   #       #   #   # #   # #
# ####### # ##### # # # # # # ##### # # # ##### ### ##### ####### ### ### # ### #
#       # #     #   # # # # # #   #   # #   #   # #       #   # # # #   #   # # #
####### ### ######### # # # # # # # ### # # # ### ######### # # # # ### # ### # #
#     #   #       #   # #   #   # #     # # # #       #     #   # #   # #     # #
# ####### ####### # ### ######### ##### # ### # # ### # ### ##### # ### ####### #
#         #     # #   #   #   #   #   # #     # # #   # #   #   # #   #       # #
# ######### ### # ### ##### # # ##### # ######### # ### ##### # # # # ####### # #
# #       # #   #   #   #   # #     # # #         #     #     # # # #     #   # #
# ### ### # # ##### ### # ### ##### # # ##### ######### # ##### # # ##### # ### #
#     # #   #     #   #   # #     # #   #   #     #     # #       # #   # # #   #
####### ######### # # ##### ##### # ### # # ### # ##### # # ####### ### # # # # #
#   #     #     # # # #   #   #   #   #   #   # # #   # # #   #   #   # #   # # #
# # # # ### ### # ### # # # # # ### # # ##### ### # # # # ##### # ### # ####### #
# # # #     # # #   # # # # #   #   # # #   #   #   # # #       # #   #         #
# ### ####### # ### # # # # ##### ### ### # ### ##### # ######### # ####### ### #
# #   #       #     #   #     #     #   # # #         # #       # #     #   #   #
# # ### ##### ####### ####### ##### ### # # ########### ### ##### ##### # ##### #
# #   # #   #     # # #   #     # # # #   #   #       #   # #     #     #     # #
# ### # # # ##### # # # # ##### # # # ####### ##### # ### # # ##### ####### # ###
#   # # # #       #   # #   # # #     #     # #     # #   # # #   #       # #   #
# # # # ##### ######### ### # # # ##### ### # # ####### ### # # # ####### ##### #
# # # #     #           #   #   # #   #   #   #         #   #   # #     #       #
# ### ##### ############# ##### ### # ### ##### ######### # ##### # ####### #####
# #   #     #   #       #     #     # #   #   # #   #     #     # #         #   #
# # ### ##### ### # ######### # ##### # ### # # # # ########### # # ######### # #
# # #     #   #   #         # # #   # # #   # # # #             # # #   #   # # #
# # ##### # ### ####### ##### ### # # # # ### # # ####### ##### # # # # # # # # #
# #   #   #   #     #   #   # #   # #   # #   #   #   #   #   # # # # # # #   # #
# ### # ### # ### ### ### # # # ### ##### # ##### # # ##### # # # ### # # ##### #
#   #   #   #     #   #   #   #   #     # #   #   # # #     # # #     #       # #
# # ##### ######### # # ######### ##### ### # # ### # # ##### ##### ########### #
# #     #     #     # #     #     #   #   # #   #   #   #   # #   #     #     # #
# ##### ##### # ########### # ####### ### # ##### ####### # # # # ##### # ### # #
# #   #   #   # #         #   #       # # #     #   #   # #   # # #   # # # #   #
# # ##### # ### # ##### # ##### # ### # # # ##### # # ### ##### # # # # # # ### #
# #       # # #   #     # #     # #     # # #   # # #     #   # # # #   # #   # #
# ### ##### # ##### ### ### ##### ##### # # # # ### # ##### # # # ####### # # # #
#   #     #   #   #   # #   #   #     # # # # #     #   #   #   #       # # #   #
### ### ##### ### ### ### ### ####### # # ### ######### ### ########### # #######
#   #   #           # #   #         # # #     #       #   #     #       # #     #
# ### ### ########### # ### ### ### # ######### ### # ### # ### # ####### # ### #
# #   #       #       # #     # #   #         #   # # #   # # # # #       # # # #
# ##### ####### ####### ####### # ########### ### # ### ### # # # # ####### # # #
#       #     # #     # #   #   #     #         # #   # #   # # #   #         # #
# ####### ### # # ### # # # # ####### # ######### ### # ### # # ##### ######### #
#     # # #     # #   #   # # #     # #     #       # #   # # #     # #     #   #
##### # # # ##### # ####### # # # ### ##### # ####### ### # # ##### # # # ### # #
#   #   # # #     # #   #   # # #   #   #   # # #     #   #       #   # #   # # #
# # # ### # # ##### # # # ### ##### # ### # # # # ### # ######### ######### # ###
# #   #   # #     # # #   #       # # #   # #   # #   # #   #   #           #   #
# ##### ##### ##### # ####### ### # # # ####### # ##### # # # # ########### ### #
#   # #       #     # #     # # # #   # #       #     #   # # # #       #     # #
### # ######### ##### # ### # # # # ### # ########### ##### ### # # ##### ##### #
#   #         #     # #   # #   # #   #   #   #       # #   #   # #     # # #   #
# ########### ##### # ### # ### # ### ##### # # ##### # # ### ### ##### # # # ###
#                 #   #   #   # # # #     # # #   # #   # #       #   #     #   #
################# ##### ##### # # # ##### # ##### # ### # # ####### ########### #
#               #   #   # #   # # #       #   #   #   # # #   #   # #     #     #
# ######### ####### ### # # ### # ##### ##### # ##### # # ### # # # # # # # ### #
# #         #       #   #   #   #     # #   # # #   #   # # #   # #   # # #   # #
### # ####### ####### ##### ### ##### # # # # # # # ##### # ##### ##### # ### # #
#   # #   #   #   #       #   # #     #   # # #   #       # #   # #     # #   # #
# # ### # # ### ### ##### ### ### ######### # ############# # # # # # ##### ### #
# # #   # #   #         # # #   #   # #     #   #         #   #     # #   # #   #
# ### ### ### ########### # ### ### # # ##### # ##### ### ############# # # # ###
#       #                 #         #         #       #                 #   #   #
#################################################################################
