#######################################################################
#       #             #         #     #     #   #                     #
####### # ####### ##### ####### # # ### # # # ### ######### ######### #
#       #       # #     #   #   # #   # # #   #   #     #   #       # #
# ####### ##### ### ####### # # # ### # # ##### ####### # ### ##### # #
# # #   #   # #     #   #   # # # # #   #       #       #   #     # # #
# # # # ### # ####### # # # # # # # ############### ### ### ####### # #
# #   #   # #     #   #   # # # # #     #   #       #   #   #   #   # #
# ### # ### # ### # ######### # # # ### # # # # ######### ### # # # # #
#   # #     # #   #     #   # # # #   # # # # # #       #     # # # # #
### # ####### ### ##### # # # # # ### ### # # # # ##### # ##### # ### #
# # # #         #       # #   # #   # #   #   # #     # # #     # #   #
# # # ####### # ##### ### ##### ### # # ####### ##### # ### ##### # ###
#   #       # # # #   #   #       # #   # #   # #     #   # #   #   # #
# ######### ### # # ### ### ####### # ### # # # # ####### # ### # ### #
#       #   #   #   #   #   #     # #     # #   #   #   #   #   #     #
####### ### # ### ### ##### # ### # ##### # ### ### # # ##### ####### #
#     #   #   #   # # #   # #   #   #   # #   #   # # #       #       #
# ####### ####### # # # # # ### ##### ### ### ### # ##### # # # #######
#         #     #   #   # #   # #   #       # # # #     # # # #   #   #
# ######### ### ### ##### ### # # # ####### # # # ##### ### ##### ### #
# #       # #   #   #   #   # # # #       # # #       #   # #   #   # #
# ### ### # # ##### ### ### ### # ####### ### # ######### # # # ### # #
#     # #   #     #       #   #   #       #   # #         # # #   # # #
####### ######### ####### ### ##### ####### ##### ######### # # # # # #
#   #     #     # #       #   #   # # #     #     #   #   #   # # #   #
### # # ### ### # ### ##### # # # # # # ### # ##### ### # # ### # ### #
#   # #     # # #   #     # #   # # # #   # #     #     # # #   # #   #
# ### ####### # ### ##### # # ##### # ### # ##### ##### # # # ### # ###
# #   #       #     #     # # #     # #   #     # #   # #   # #   #   #
# # ### ##### ####### ##### ### ##### # ####### # # # ####### ####### #
# #   # #   #     #   #   #   #     # # #   # # #   #       #         #
# ### # # # ##### # ### # ### ##### # # # # # # ########### # #########
#   # # # #       #   # #   #   #   #   # #   #   #       # # #       #
# # # # ##### ######### ### # # # ##### # ### # ### # ### # # # #######
# # # #     #           #   # # # #   #   #   # #   #   # # #   #     #
# ### ##### ############# ##### # # # ####### # # ##### ### ##### ### #
# #   #     #       #   #     #     #       # #       #   #     # # # #
# # ### ##### ##### # # ##### # ########### # ########### ##### # # # #
# # #     #   #   #   #     # # #   # #   # #   #             #     # #
# # ##### # ### # ##### ##### ### # # # # # ##### ####### ##### ##### #
# #   #   #     # #     #   # #   # #   # # #     #   #   #   # # #   #
# ### # ######### # ##### # # # ### ##### # # ### # # ##### # # # # ###
#   #   #     #   #   #   #   #   #     #   # #   # # #     # # # #   #
# # ##### # ### ##### # ######### ##### ### # # ### # # ##### # # ### #
# #     # #   # #     #     #     #   #   # # # #   #   #   # #   #   #
# ##### # ### # # ######### # ####### ### # # # # ####### # # ### # # #
# #     # # # # #         #   #         # #   # #   #   # #   #   # # #
# # ##### # # # ##### ######### # ####### # ##### # # ### ######### # #
# #     # # #   #   #         # # #     # # #   # # #     #         # #
# ##### # # ##### ####### ##### # # ### # # # # ### # ##### ### ##### #
#     #   # #     #     # #     #     # # # # #     #   #     # #   # #
##### ##### # # ### ### # # ########### # ### ######### ##### # ### # #
#   # #   #   #     #   #   #       #   #     #       #   # # #   # # #
# ### # ### ######### # ##### ####### # ######### ### ### # # ### # # #
#     #       # #     #     #   #   # #   #       # # #   #     # # # #
# ########### # # ########### # # # # ##### # ##### # # ### ##### # # #
#   #       #   #       #     #   # #       #     #   # #   # #   #   #
### # ##### ### ####### # ######### ############# # ### ### # # ### ###
# #   #     # # # #   # #   #   #         #       # # #   #   #   #   #
# ##### ##### # # # # # ### # # # ####### # ####### # ### ### ### #####
# #   #     #     # #   #   # #   #     # #   # #   # #   #     #     #
# # # ##### ####### ##### ### ######### # ### # # ### # ############# #
#   #     #       # #       #     #     # #   #       # #   #       # #
# ####### ####### # # ########### # ##### # ######### # # # # ##### # #
# #     # #     # #   #       #   #   #   # #   #     #   # # #     # #
# # ### # # ### # # ### ##### # ##### # ### # # ########### # # ##### #
# # #   # #   #   # #   #   #   #     # # #   #         #   # #   #   #
# ### # # ### ####### ### ####### ##### # ############# # ### ### # # #
#     # #             #                               #       #     # #
#######################################################################
