#############################################################
#   #             #       #     #   #     #       #     #   #
### # ### ####### # ##### # ### # # # ### # ### ### # ### # #
# # # # # #     # #   # #   #   # #   # #     #     # #   # #
# # # # # # ### # ### # ##### ### ##### ########### # # ### #
#   # # # # # # # #     #   #   #     #     #     # # # # # #
# ### # # # # # # # ##### # # # ##### # ### # ### ### # # # #
#   #   #     # # # #   # # # #     #   #   #   #   #     # #
### ########### # ### # # # # # ######### ##### ### ####### #
# #             #     #   # # # #     #   #     # #     #   #
# ######################### ### # ### # ### ##### ##### # # #
#     #       #           #   #     # #   # #   #       # # #
# ### # # ### ######### # ### ##### # # ### # # # ####### ###
#   # # # # #           #   #     # #   #   # # #   #       #
# # # ### # ############# ####### # ##### ##### ### ####### #
# # #     #         #     #       #   #   #       # #   #   #
# # ####### ##### # # ##### ####### ### ##### ### # # # # # #
# # #       #   # # #   # #     #   #   #     #   #   #   # #
# # # ####### # # ##### # ##### # ### ##### ############### #
# # #   #   # # # #     #   #   #   # #     #   #       #   #
# # ### # # ### # # ####### # ### ### # ##### # # ### # # ###
# #   #   #   # #   #       #   # #   #       #     # # #   #
# ### ####### # ##### ### # ### ### ##### ########### # ### #
#   # #     #     #     # # # #   #     #   #       # #   # #
# ### # ### ##### # ##### # # ### ##### # ### ##### # ##### #
# #   #   #   #   #   #   # #   #       # #   #       #   # #
# # ##### # ### ####### ### # # ########### ########### # # #
# #   #   #             #     #       #     #       #   #   #
##### # ################# ############# # ### ##### # #######
#     # #             #   #       #     # #   #   # #   #   #
# ##### # ########### ##### ##### # ##### # ### ### ### # ###
# #   # #   #     # #           # # #   #   #   #     # #   #
# # ### ### ### # # ############# # ### ####### # ### # ### #
# #       # #   #   #       #     # #           # # # #   # #
# ######### # ####### ##### # ### # # ######### # # # ### # #
# #         # #       #   # #   # # #         # # #   # #   #
# # ######### # ######### # # # # # ##### ### ### ### # ### #
#   #         #   #     # # # # # #     # # #   #   #     # #
# ### ##### # ### # ### # # ### # ##### # # ### ### ##### # #
# #     #   #   #   # # #       #   #   #   # #   #     # # #
# ####### ##### ##### # ############# ##### # ### ##### ### #
# #     # # #   #     # #   #       #     #     #     #     #
# # ### # # # ### ##### # # # ##### ##### ##### ##### #######
# #   #   # # #       # # #   #   #     #     #     #   #   #
# # # ##### # ####### # # ##### # ### ####### # ##### # ### #
# # #     #   #       #   #     # # #       # # #     #   # #
# # ##### # ### ##### ##### ##### # ####### # ### ####### # #
# # #     #   #   #   #   #   # # # #       #   #   #       #
# ### ####### ### # ### # ### # # # # ######### # # ####### #
#   #       #     # #   #     #   # #           # #   #   # #
### ####### ####### # # ####### ### ############# ### # # ###
# #   #   #     #   # # #     #   #       #   #   # # # #   #
# ### # # # ### # ##### # # ##### ##### # ### # ### # # ### #
#   #   # # # # #   #   # # #   #       #   # # #   #     # #
# # ##### # # # ### # ### ### # ########### # # ### ####### #
# #     # #   # # # # #   #   # #       #   #       #   #   #
# ##### # ##### # # # # # # ### # ### ### ########### # # # #
#   #   #     # # #   # #   # # # # #   #   #   #   # #   # #
### # ####### # # ##### ##### # # # ### ### # # # # # ##### #
#   #           #             #       #       #   #   #     #
#############################################################
