###############################################################################################################
#   #                         # #                   #           #       #       #               #       #     #
### ##### ####### ##### ##### # # ############# ### # ### ##### # ### # ####### # ####### ##### ### ##### ### #
# #     # #     # #     #   #   # # #         #   #     # # #   # #   #     #   #   #   #   # #   #         # #
# ##### # # ### # ####### # ### # # # ####### ### ####### # # ### # ####### # ##### # ##### # ### ### ####### #
#     # # # # # #     #   #   # #   # # #     #       #   #   #   # #       #     #   #     #   #   # #       #
# ##### ### # # # ### # ##### # ### # # # ########### # ### ####### ####### ### ### ### # ##### ### # # #######
#     #     #   #   #   # #   #   # # # #         #   #   # #     #       #   # #   #   # #   #   # # #   #   #
# ### ####### ##### ##### # ####### # # ######### ####### # # ### # ##### ### # # ### ##### # ### # # ### # # #
# # #       # #           # #   #   # # #           #     #   # # #   #   #   #     # #     #   # # #   #   # #
# # ####### # # ########### # # # ### # # ######### # ######### # ##### ### ######### # ####### # # ######### #
#     #     # #   # #     #   #     # # # #       #   #         #       # #           #   #   # #           # #
##### # ##### ### # # ### ########### # # # ##### # ##### ##### ######### ### ########### # # # ########### # #
# #   # #     #     #   #           # # # # # #   # #   #   #           #     #     #     # # #     #     # # #
# # ### # ############# ########### # # # # # # ##### # ##### ######### # ##### ### # ##### # ##### # # # # # #
# #   # # #   #         #         # # #   #   #   #   # #   #   #       # # #   # #   # #   #   #   # # # #   #
# # ### # # # # ######### ######### # # ##### ### # ### # # ### ######### # # ### ##### # ##### # ##### # ### #
#   #   # # #   # #                 # #     #   #   #   # #   # #           #   #             # #     # #   # #
##### # # # ##### # ################# ##### ### ##### ### ### # # ############# # ############# ##### # ##### #
#     # #   #     # #       # #     #   #     #   #   #   #   #   #   #     #   #         #         # #     # #
# ##### ##### ##### # ##### # # ### # # ### ##### # # # ### ### ### # # ### # ### ######### ######### # ### # #
# #     #   #       # # #   #   #   # #   # #     # # # #   #   # # # #   # # #   #       #   #       # # #   #
# ####### # # ####### # # ### ### ### ### ### ##### ### # ### ### # # ### # # ##### ##### # # # ####### # #####
# #   #   # # #   #   # #   # # #   # # #   #   # #   # #   #     # # #   # #       #   # # # #     #       # #
# # # # ### # # # # ### ### # # ### # # ### ### # ### # ### ####### # # ### ######### ### # # ##### ####### # #
# # #   # # #   #   #     # #   # # #   #     # #   # #   #   #     #   # #   #       #   # # #   #   # #   # #
# # ##### # ######### ##### ### # # ### # ##### # ### ### ### # ####### # # ### # ### # ### # # # ### # # ### #
#   #     #     #   #       # # # #   # #         #     #   # # #     #   #     # # # # #   #   # #   #       #
# ### # ####### # # # ####### # # ### # ########### ####### # # # ### ### ####### # # # ######### # ######### #
# #   #       # # #   # #           #   #         # #       #   #   #   #   #     #   #     #     #     #     #
# ####### # # # # ##### # ############### ####### # # ########### # ### ##### ##### ####### # ### ##### ### ###
#   #   # # # #   #     #   #   #         # #     #   #   #     # # #   #     #     #     # # # # #   #   #   #
### # # ### ####### ### ### # ### ######### # ##### ### # # ### # # # ### ##### ####### ### # # # # ##### ### #
# #   #   #     #     # #   #   # #         #   #   #   #   # # # # # #   #             #   # #   #     #   # #
# ####### ##### # ### # # ##### # ### ##### ### ##### ####### # ### # ### # ############# ### # ##### # ### ###
#     # #     #     # # # #     #   # #   #   #       #       #   # #     # #             #   #   #   #   #   #
# ### # ##### ##### # ### # ### ### ### # # # ######### # ### ### # ######### ########### ### ### # ######### #
# # # #     #   # # #   # #   #   #   # #   # #         #   # #   #               #     #     #     #   #   # #
# # # ##### ### # # ### # ### ####### # ##### # ########### ### ##### ########### # ### ####### ##### # # # # #
# #           # #   # # #   # #       # #   # # #       #   #   #   # #   #   #   # #       #     #   #   #   #
# ##### ####### # ### # ### # # ####### # # ### # ##### # ### ### # # # ### # ##### # ##### ####### ######### #
#   # # #   #   # #   #       # #     #   #   # #   #   # #   #   # #   #   #       # #   #       #         # #
# # # # # # # ### # ######### # ### # # ##### # ### # ### # ##### # ### # ########### # # ####### ####### # ###
# # #   # #   #     #     #   #   # #       #   #   # #   # #     # #   #         #   # # #   # # #     # #   #
# # ##### ########### ### ####### # ########### # ##### ### ### ### # ########### # ### # # # # # # ### # ### #
# # #   # #           # #   #     # #   #     #   #     #   #   #   # #     #     # #   #   # #     #   #   # #
# # # # # # ########### ### # ####### # # ### ### # ### # ### ### ### # # ### ##### # ####### ######### ##### #
# #   #   #     #           #     #   # #   # #   # #   #     # # #   # #   #   #   # #     # #   #   #   #   #
# ######### ### ##### ########### # ### ### # # ### ########### # # ####### ### ##### # ##### # # # # ### # # #
# #     #     #     # #     #     # # # #   # #   #     #         # #   #     #   #     #     # #   #   #   # #
# # ### # ######### # # ### # ##### # # # ### ######### # ######### # # # # ##### # ##### # ### ####### ##### #
# #   # #   #       # # # #   #     # #   # # #         # #         # # # # #     #   #   # #   #       # #   #
# ##### ### # ####### # # ######### # ##### # # ####### # ######### # # # # # ####### # ##### ### ####### # ###
#     #   # #   #   #   #         # #       # # #       #   #     #   #   # # #       #       #   #     # #   #
##### # # # ### # # ##### ### ### # ####### # # # ######### # ### ### ####### # ############### ### ### # ### #
#   # # # # # #   #     #   #   #   #     # #   #     #   #   # #   # #     # # #     #       #       # #   # #
# ### # ### # ####### # ##### # # ### ### # ######### ### ##### ### ### ### # # # ##### ### ########### # ### #
#     #     #   #   # # #   # # # #   # # #   #       #   #       #   #   #   # #         #     #       #   # #
# ##### ##### ### # ### # # # # # # ### # ### # ####### # # ### ##### ### ### # # ############# # ####### # # #
#     #     #   # #   # # # # # # # #   #   #       #   # # #   #   #   # # # # #   #   #     # #     #   #   #
##### ##### # # # ### # # # # # ### # ##### ####### # ### # # ### # ### # # # # ### # ### ### # ##### ### #####
#   #   # # # # # #   #   # # #       #     #     # # # #   #   # #     # # # #   #   #   #   # #   #   # #   #
# ##### # # ### # # ####### # ######### ##### ### # # # ####### # ####### # # ### ##### ### ### # # ### # # # #
#     # #   #   # # #       # #   #     #   # # # #   # #       #   #     #     #     #   #   #   #   # #   # #
# ### # # ### ### # ### ##### # # # ### # # # # # ##### # ######### # ############### # # ### # ### ### #######
#   #   # #   #   # #   #   #   # #   # # #     #     # # #   #   # #   #           # # #   # #   # #   #     #
### ##### # # # ### # ### # ##### ### ### ####### ### # # # ### # # ### # ####### # # ### # # ##### # ### ### #
#   #   #   # #   # #   # #     # # # #   # #   #   # # # # #   # # #   # #     # # #   # # #   #   #     #   #
# ##### ##### ### # ### # ### ### # # # ### # # ##### # # # # ### # # ### ##### # ##### # # ### # ######### # #
# #   # #   #   # # #   # #   #   # #   #   # #       # # # # # #   #   #       #     # # # # # #     #   # # #
# # # # # # ### # # # ### ##### ### ##### # # ######### # # # # ##### # ####### ##### # ### # # # # # # # # # #
#   # # # #     # # # # #       #         # #   #     #     # # #     #       #   # #   #   #   # # # # #   # #
##### # # ####### # # # # ######### ### ####### # # ### ##### # # ######### ##### # ##### ### ##### # # #######
#     #   #     # #   #   #         #   #       # # #   # #   #     # #   #     #         #         # #       #
# ######### ### # ##### ####### # ####### ####### # # ### # ####### # # # # # # ### ################# ####### #
# #         #     #   #       # # #       #       #       # #     #   # # # # # #   #     #         # #   #   #
# ### # ########### # ####### # # # ##################### # # ### ##### # # # ### ### ### # ####### # ### # # #
#   # #     #   #   #       #   # #   #               #   #   # #       # # #     #   # # #   # #   #     # # #
### # ##### # # # # ############# ### # ############# ######### ######### ### ##### ### # ### # # ######### # #
# # # #     # # # #       #       #   # #   #         #         #       #   #   # # #         # # #         # #
# # ### ##### # ##### ### # ####### # # # # # ####### # ##### # # ### # ### ### # # ########### # # ######### #
# # #   #     #     #   #       # # # #   # #       # #   # # # #   # #   #   # # #       #     #   #       # #
# # # ### ######### ########### # # # # ########### ##### # # # ##### ####### # # ####### # ### ##### ####### #
#   #       #     #           #   # # # #         #   #   # # #       #       #     #   # #   #   #       #   #
# ######### # ### ########### ### # ### # ####### ### # ### # ##### ### ########### ### # ##### # # ##### # ###
# #     #     # #       #     #   #     #   #   # #   # #   #     # #   #       #       # #   # # #     # #   #
# ### # ####### ### ##### ##### ########### # ### # # # ### ##### # # ####### ### ####### # # # # ### ### ### #
#     #   #         #     #               # #       # #   #     # # # #     #       #   #   # # #     #     # #
######### # ######### ##### ############### ##### ####### # ### # ### ### # ##### ### # ### # ######### # ### #
#     #   # #     #   # #   #   #   #     #     # #       #   # # #   #   #     # #   #   # #   #     # # #   #
# ### # ##### ### # ### # ### ### # # ### ##### ### ######### # # # ### ####### ### ##### ##### # ### # # # ###
#   # # #     # #   #   #     #   #   # # #     #   #         # # #   #       #   # #     #   # #   #   # # # #
##### # # ##### ##### ### ##### ####### # # ##### ### ######### # ### ##### # ### # # ##### # # # # ### ### # #
#   # #   #       #       #   # #       # # #     #       #   # #   #     # #   #   # #     # # # #   # #   # #
# # # ##### ##### ### ##### # # # ### # # # # ##### ##### # # ##### ##### # ### ##### # ##### # # ### ### ### #
# # #       #   #   #   #   #   # #   # # # #   #   #   #   #     #       #   # #   # # #   #   #   #   #     #
# # # ####### ##### ##### ####### # # ### # ### # ##### ######### ############# # # # # # # ####### ### ##### #
# #   #     #       #     #       # # #     #   #           #   #           #   # # #   # # # #     # #       #
# ##### ##### ####### ########### # ### ##### ############# # ####### ### # # ### # ##### # # # ##### #########
# #     #     #       #         # #     #     #         #     #     # #   #   #   #   #   # # #       #       #
# ##### # ####### ### # ####### ######### ##### ### # ### ##### ### # # ####### ##### # ### # ####### ### # # #
#   #   # #       #   # #     #   #       #       # # #   # #   # # # # #       # #     #     #     #   # # # #
# # # ### # # ##### ### # ### ### # ############### ### ### # ### # # # # ##### # # ######### # ####### ### # #
# # #       # #   #   # #   # #   #   #       #   # #       # #     # # #     # # # #       # # #       #   # #
# # # ######### # # ### ##### # ##### # ### # # # # # ####### # ####### ####### # # # ##### # # # ####### #####
# # #     #     # # #   #   # #   #   # #   #   # #   #       #       #       # #   #     # #   #   #         #
### # ##### ##### ### ### # # ### # ##### ####### ### # ############# ####### # ######### # # ##### ######### #
#   # #   # #   #   # #   # #   #   #     #     #   # # #       #     #     # #           # # #     #     #   #
# ##### # # ### ### # ### # ### ##### ##### # ##### ### # ##### # ##### ### # # ########### ### ##### ### # # #
#       #         #       #           #     #           #     #         #     #           #           #     # #
###############################################################################################################
