#####################
#   #             # #
### ########### # # #
# #     #       # # #
# ##### # ####### # #
#     # # #     #   #
# # ### # # ### ### #
# # #   # #   #   # #
# # # ### # ### # # #
# # #   # # #   # # #
# ##### # # # ##### #
#     #   # #       #
# ### ##### #########
#   #     # #   #   #
### ##### # # # ### #
#   #   # #   #   # #
# ### # # ####### # #
#   # # #     #   # #
### ### ##### # ### #
#           #       #
#####################
