#########################################################################################################################
#   #                   # #                     #     #         #   #     #       #     #     #             #   #       #
### ##### ####### ##### # # ##### ############# # ### ##### ### # # # ### ### ### # ##### ### # ##### ##### # # ##### ###
# #     # #     # # #   # #     # #       #   # #   #       #   # #   # #     #   # #     # #       #   #   # #     #   #
# ##### # # ### # # # ### ##### # ##### # # # # ### ### ####### # ##### ####### ### # ##### ########### # ### ##### ### #
#     # # # # # # #   #     # # #     # #   #     #   # #     # #   # #       # #   # #     #   #       #     #   #   # #
# ### # ### # # # ### # ### # # ##### ### ####### # # ### ### # # # # # # ##### # # # # # ### # # # ########### # ### # #
#   # #     #   #   #   #     # #   #   # #     # # #     #   # # # #   # #   # # #   # # #   #   # #           #   # # #
# # ######### ### # ######### # ### ### ### ### # ##### ### ### # # ##### # # # # ####### # ##### ### ############# # # #
# #       # # # # #         # #       #   #   # #     #   #   # # # #     # # # #         # #   # #   #       #   # #   #
# ### ### # # # # ######### ######### ### ### # ##### ####### # ### # ### # # # ######### # # ### # ##### ### # ### ### #
#   #   #   # # # # #     #             #   # #     #   #   # #     # #   # # # #   #     # #     #       #   #   # # # #
# ##### ##### # # # # ### ############# ### # ##### ### # # # ####### ##### # # ### # ##### # ############# ### # # # # #
# #     #     #     #   #           #   #   #   # #   #   #   #       #   # # #   #   # #   #   #   #     # #   # # #   #
# # ### # ############# ########### # ### # ### # ### ####### ####### # # # # ### # ### # ####### # # ### # # ### # #####
# # #   # #   #         #         # # #   #   #     # #   # # #     #   # # #   # # #   #   #     # # # # # # #   #     #
# # ##### # # # ######### ######### ### ##### ##### # # # # # # ### # ### # # ### # # ##### # ##### # # # # # # ####### #
# #     # # #   # #                 #   #         # #   # #   # # # #   # # #     #   #     # # #   #   #   # #       # #
# ##### # # ##### # ################# ############# ##### # ### # # ##### # ######### # ### # # # ##### ##### ##### # # #
#   #   #   #     # #       #   #       #     #     #   # # #   # #     #           # # # # #   #     # # #   #   # # # #
##### # ##### ##### # ##### # # # ##### # ### # ####### # ### ### ##### ########### # # # # ### ##### # # # ### ### ### #
#     # #   #       # # #   # #   #     #   #   #       #   #     #     #     #   # # # # # # # #   #   #   #   #   #   #
# ####### # # ####### # # ### ##### ####### ##### ######### ### ### ### # ### # # # ### # # # # ### ##### ##### # ### # #
# #   #   # # #   #   # #   #   # #         #     #     #   #   #   #   # # # # # #   # # # # #   #     # #     #   # # #
# # # # ### # # # # ### ### ### # ########### # ### ### # # # ### # ##### # # ### ### # # # # ### # ### # # ### ### # ###
# # #   # # #   #   #     # # #     #       # # #   #     # # # # # #     # #   # #     #     #   #   #   #   #   # #   #
# # ##### # ######### ##### # ##### ### ### ### # ######### # # # ### ##### ### # # ########### ##### ##### # # ### ### #
#   #     #     #   #       #     #   # #       #         # # # #     #     #   # #   #       # #     #     # # #   #   #
# ### ### ##### # # # ####### ### ### # ########### ##### ### # ########### # ### ### # ##### # ### ######### # # # # # #
# #     #     # # #   # #   #   #       #         # #   #               #   # #     # # # #   #   # #         # # # # # #
# ####### # ### # ##### # # ### ######### ####### # # ################# # ### ### # # # # # ##### # # ######### # # # # #
#   #   # #   #   # #   # #     #         # #     #   #   #     # #     #   #   # #   #   #       # # #         # # # # #
### # # ### # ##### # # # ####### ######### # ##### ### # # ### # # ####### ### # ####### ######### # ####### ### ### # #
# #   #   # #   #     #   # #   # #         #   #   #   #   # # #           #   # #     #     #   #   #     # # # #   # #
# ####### ##### # ######### # # # ### # ### ### ##### ####### # ### ######### ### ### ####### # # ### # ### # # # # ### #
#     # #     #       #       # #   # # #     #       #       #   # #   #     # #   # #   #   # #     # # # #   # #   # #
# ### # ##### ####### ######### ### ### ### ############### # ### # # # # ##### ### # # # # ### ####### # # ##### ### ###
# # # #   # #   #   #             #   #   # #             # # #   # # # #   #         # # #   #   # #   #     #   # #   #
# # # # # # ### # # ######### ####### # # ### ####### ### # ### ##### # ### ######### # # ### ### # # # ##### # # # ### #
# #   # #     # # #     #     #       # #           # #     #   #   # #     #     # # # #   #   #   # # #   #   #     # #
# ### # ####### # # ##### ##### ############# ####### # ##### ### # # ##### # ### # # # # ##### ### # ### # # ##### ### #
#   # # #   #   # #         # # #       #   # #       #   #   #   # #     # #   # #   # #         # # #   # # #   # #   #
# # # # # # # ### ######### # # ### ### # # ### ######### # ##### # # ### ##### # # ### ######### ### # ### ### # ### # #
# # #   # #   #     #     #   #   # # # # #   #         # # #     # # # # #     # #   # #     #       # # #   # #     # #
# # ##### ########### ### ####### # # # # ### ######### ### ### ### # # # # ##### ##### # ### ##### ### # ### # #########
# # #   # #           # #   #     # # # # # #   #       #   #   #   # # #   #     #     # # # #   # #   #   # #         #
# # # # # # ########### ### # ##### # # # # ### # ##### # ### ### ### # ##### ##### ##### # # # # # # ##### # ### ##### #
# #   #   #     #           #     # #     # #   # # #   #     # # # # #     #     # #   # #   # # # # #     #   # #     #
# ######### ### ##### ########### # ####### # ### # # ######### # # # # ######### # # # # # ### # ### # ### ### # # ### #
# # #     #   #     # #     #     #   #     # #   # # # #         # # #   #       # # #   #     # #   #   # # # # #   # #
# # # # ### ####### # # ### # ##### # # ##### # ### # # # ######### # ### # ####### # ########### # ### # # # # ##### ###
# #   # #   #       # # # #   #   # # #         #   # # # #         #   # #     #   # #         #   # # # #   #     #   #
# ##### # ### ####### # # ##### ### # # ######### ### # # ######### ### # ##### # ### # ### ######### # # ######### ### #
#     #   # #   #   #   # #       # # #   #     #   #   #   #     #     # #   #   #   # #   #       #   #       #   #   #
##### # ### ### # # ##### # ##### # # ##### ### # # ### ### # ### ### ### # # ##### ### ##### ##### # ######### # ### ###
#   # # #     #   #     #     #   # #   #   # # # #   #   #   # #   #     # # #   #   #   #   #   #   #       #   # #   #
# ### # # # # ####### # ##### # ### ### # ### # ### ##### ##### ### ### ### # # # ### # # # ### # ####### # ####### # # #
#     # # # #   #   # # #   # # #   # #       #   #     #     #   #   # #   #   #     # #       #       # #     #     # #
# ##### ### ##### # ### # # # # # ### ########### # ### ##### # ##### ### ############# ############### # ### # ####### #
#     #   #     # #   # # # # # #   # #           #   #   #   # #   #   #     #   #     # #       # #   # #   # #   #   #
##### ### ##### # ### # # # ### ### # # ####### ####### # # ### # # ### # ### # # # ##### # ##### # # ### # ### # # # ###
#   #   #       # #   #   # #   #   # #   #     #     # # # #   # #     #   #   # #       # # #   #   #   # #     # #   #
# ##### ####### # # ####### # ### ### ### # ##### ### # # # ### # ######### ##### ######### # # ### ####### ####### ### #
#     # #   #   # # #       # #   #   # # # #   # # # # #       #   #     # #   #     #       #   # #     #       #     #
# ### # # ### ### # ### ##### # ### # # # # # # # # # ####### ##### # ##### # # ##### # ##### ### # # ### # ##### ##### #
#   #   # #   #   # #   #     #   # #   # # # #     #     #   #   # #     # # # #   #   #   #   # #   # # #   #   #     #
### ##### # ### ### # ### ### ### # ### # ### ####### ### # ### # # # ### # ### # # ##### # ##### ##### # ##### ### #####
#   #     #   #   # #   # # #     #   # #       #   #   # # #   # # #   #   #   # #   #   #   #   #     #       #   #   #
# ##### ##### ### # ### # # ####### # # ######### # ##### # # ### # ### ##### # # ### # ##### # ####### ######### ##### #
# #   # #     # # # #   # # #     # # # #       # #       # # # #   # #       # #   #   #       #     #       #   #     #
# # # # # ##### # # # ### # # # ### # # # ##### # ######### # # ##### ##### ####### ##### ####### ### ##### # # ##### # #
#   # #         # # # #   #   #     # # #   # # #   #   #   # #   #         #       # #     #   # #   #     # # #   # # #
##### # ######### # # # ############# # ### # # ### # # # ### # ### ######### # ##### # ##### # # # ### ####### # # # # #
#     #   #     # #   # #           # # #   # #     # # # #   #     # #   #   # #   #     #   #   #   #     #   # # # # #
# ######### ### # ##### # ######### # # # ### ####### # # # ####### # # # # ##### # # ##### ######### # ### # ### # # # #
# #         #     #   # # #       #   # # #         # #   # #     #   # # # #   # # # #     #       # # #   # #   #   # #
# ### # ########### # # # ##### # ##### # # ######### ##### # ### ##### # # # # # # ### ##### ##### # # # ### # ####### #
#   # #     #   #   # # #     # #   # # # #         #     #   # #       # #   #   #   # #   # #   #   # #   # #   #   # #
### # ##### # # # # ### ##### # # # # # # ##### ### # ######### ######### ### ####### # ### # # ##### ##### # ### # # # #
# # # #     # # # #   #   #   # # #   # #     #   #   #           #   # #   # #     #   #   # #       #   #     # # #   #
# # ### ##### # ##### ### # ### # ### # ##### ### ##### ##### ### # # # ### ### ### ### # ### # ####### # ##### # #######
# # #   #     #     #       #   # #   #   # #   #     #   # # # # # #     #   #   #   #   #   #   #     #   #   #       #
# # # ### ######### ########### # ####### # ### ##### ### # # # # # # ####### # # ### ##### ##### # ####### # ####### # #
#   #       #     #           # #       # #   # #     #   # # #     # #       # # #   #     #     #   #   # #       # # #
# ######### # # # ########### # ####### # ### # ####### ### # ##### ### ######### # ### # ########### # ### ####### ### #
# #     #   # # # #     #     #       #       #       # #   #     # #   #       # # #   # #     #     #   #     # #     #
# ### # ### ### # # ##### ####### ################### # ### ##### # # ####### # # # ### ### ### # ####### ##### # ##### #
#     #   #     #   #     #     # #         #         #   #     # # # #       #   #     #   # #   #         #   #       #
######### # ######### ##### # ### # ####### # ### ####### # ##### ### # # ############# # ### ##### ### ### # ##### #####
#     #   # #     #   #     #     # #     # #   # #       #     # #   # # #     #   #   #   #     # # # #   #     #     #
# ### # ##### ### # ### ########### # ##### ### ### ########### # # ### ### ### ### # ##### # # ### # # # ####### ##### #
# #   # #     # #   #   #   #     # #   #       #   #   #       # #   #       #   #     #   # #       # #       # #     #
### # # # ##### ######### # # ### # # # # ####### ### ### # ##### ### ####### ### ####### ### ######### ######### # #####
#   # #   #           #   #   # # # # #   # #     #       # #   #   #     #     # #     # #   #       #   #       # #   #
# ######### ######### # ####### # # ##### # # ##### ####### # # ### ##### ####### # ### # ##### ##### ### # ####### ### #
# #     # #       #     # #     # #     # # #   # # #     #   #   #       #     #   #   #       #   # #   #     #   #   #
# # # # # # ##### ####### # ### # ##### # # ### # # ##### ####### ######### ### ### # ### ####### ### # ####### ### # # #
# # # # #       #     #       #   #   # #   #   # # #   #   #         #   #   #   # # #   #   #   #   # #     #   #   # #
# # # # ##### ##### # ########### # # # ##### ### # # # ### # ######### # # # ### ### # ### # # # # ### # ### ### ##### #
#   # #     # #   # # #         #   #   #     #     # #     # #   #     #   # #     #     # # # #   #       # #   #   # #
##### ##### ### # ### # ####### ######### ##### ##### ##### # # # # ######### ##### ####### # ##### ######### # ##### # #
#     #   #     #   # # #     #   #       #           #     #   # #   #       #   #         #     #     #     #     #   #
# ##### ##### ##### # # # ####### # ####### ############### ##### # ### ### ### # ############### ##### # # ####### ### #
# #   #       #   #   # #     #   #   #       #           # #   #   #   # # #   # #   #         # #       # #     #   # #
# # ### ####### # # ### # ### # ##### ####### # ######### # # ####### ### # # ### ### # ### ### # ########### ### ### # #
# #       #     # # #   # #   #   #   #   #   #   #   #   # #       # #     #   #   # # #   #   #           #   #   # # #
# # ####### ##### ### ##### # ### # ### # ####### # ### ### # ##### # ####### ##### # # # ##### ########### ### ### # # #
# #   #   # #   #   # #     # # #   #   #         # #   #   #   #   #         #   # #   #     #           #   # #     # #
# ### # # # ### ### # # ##### # ##### ############# # ##### ##### # ########### # # # ####### ##### ######### # ####### #
#   # # #   #   # #   #     #     #     #           #     #       #     # #     # # #   #   #   #   #       # #   #   # #
# # ### ##### # # ######### ##### # ### ##### # ### ##### ############# # # ##### # ### # ##### ### # ### # # ### # # ###
# #     #     #   #         #   # #   #     # #   #     #   #             # #   #   #   #     #   # # # # # # #   # #   #
# ####### # ####### ### # ### # # ######### ### # ### ##### ############### # ####### ####### ### ### # # ### # ### ### #
# #       #   #     #   # #   # #   #     #   # #   # #     #         #     # #       #       # #     # #     #       # #
# # ####### # # ##### ##### ### ### # ### ### # ### # # ##### ####### # ##### # ####### # ### # ####### ############### #
# # # #   # #       #       #   #     # # #   # # # # # #     #   #   #   #     #   #   # # # #     #   #           #   #
# # # # # ### ############# # ######### # # ### # # # # ### ##### # ### # ### ### # ##### # # # # # # ### # ####### # # #
# #   # #   # #           # #     # #     # #   # # # # #   #     # #   #   # #   #       # # # # # #     #   # #   # # #
# ##### ### ### ######### ####### # # ##### # ### # ### # ### ##### ####### # # ########### # ### # ######### # # ### # #
#       #       #                 #         #     #       #                 #   #                 #           #       # #
#########################################################################################################################
