#########################################################################################################################
#     #   #           #       #     #       #             #   # #                           #     #   # #     #   #     #
##### # # ### ####### ##### # # ### # ### # ##### ####### # # # # ######### ############### ### # # # # # ### # # # ### #
#   # # #   #     #   #     # #   # #   # #   #   #   #   # # # # #       #   #   #       # #   # # # # #   #   #   #   #
### # # ### ##### # ### ##### # # ### ### ### # ### # # ### # # # # # ### ### # # # ##### # # ### # # # ### ######### # #
#   # #   #     # #   # #   # # #     #   #     #   # #   # # # # # #   # #   # # # #   # #   # # # #   #   # #     # # #
# ### # # ##### # ### # ### # # ####### ######### ### ### # # # # ##### # # ### # # # ### ##### # # ### # ### # ### # # #
# #   # # #       #   #   #   #     #   #           #   #   #   #     # # #     # # # #     #   #   #   #     #   #   # #
# # ### # # ######### ### # ######### ### ############# ############# # # ####### # # # ##### # ##### ####### ### ##### #
#   #   # # #       #   # #         # #   #       #     #   #       # # # #     # #   # #     #   #   #     #   # #   # #
# ### ### ### ##### ### # ######### # # ######### # ##### # # ##### # # # ### ### ##### # ##### ### ##### # ### # ### # #
# #     #         #   #   #   #     # # #       # #       # #   #   #   #   #   #     #   #   #     #   # # #   # #   # #
# # ################# ##### ### ##### # # ##### # ######### ### # # ####### # # ##### # ### # ### ### # # ### ### # ### #
# # #         #     #   #     # #   #     #       #       #     # # # #     # #     # # #   #   #     #   #   #   #     #
# ### ####### # ### ### # ### # # # # ############# ##### # ##### # # # ########### # ### ##### ####### ### ### #########
# #   #     # #   #     #   # #   # # #         #   #     #     # #   #         #   #     #   #     #   #     #         #
# # ####### # ### ######### # ##### ### ####### # ### ########### ### ######### # # ######### ##### ##### ############# #
# #   #   # #   #   #     # #     # #   #     #   #   #       #   #   #       #   # #             #         #         # #
# ### # # # ### ### # # ### ##### # # ### # # ##### ##### ### # ### ### # ######### ####### ##### ########### ####### # #
#     # #     #     # #   #   #   #   #   # # # #   #     #   # # # #   #         #       # #   #     #   #   #     #   #
####### ############# ### ### # ####### ### # # # ##### ### ### # # # ########### ####### # # # ##### # ### ### # # ### #
#       #               #   # #       # #   #   # #     #       #   #     #     #       # #   # #   # # #   #   # #   # #
# ##### # ############### # # ##### ### # ####### # # ####### ##### ##### # ### ### ### # ### # # # # # # ### ### ##### #
#     # #     #   #     # # # #   #   # #       # # #       # #   # #   # #   #   #   # #   # # # # #   # #     # #   # #
##### # ##### # # # ### # ### # ##### # ####### # ####### # # # # # # ### ####### ### ##### # # # ##### # # ##### # # # #
# #   #     #   # # # #   #   #     # #       #   #     # # # # # # #   # #   #   #   #     # # #       # # #   #   #   #
# # ####### # ##### # # ### ####### # ####### ##### ### # # ### # # ### # # # # # # # # ####### # ####### ### # # #######
# # #     #   #     #   #   #       #       #       #   # # #   # #     #   # # # # # #   #     # #   #   #   # # #     #
# # # ### ##### ######### ### ########### ########### ##### # ### ########### # # # ##### ### ### ### # ### ### # # ### #
#   #   #   #   #       # #   #         # #         # #     #   #           #   # #           # #     #       # #   #   #
# ### # ### # ### ##### # ### # ####### # # # ##### # # # ##### ########### ##### ############# ##### ####### # ##### ###
# #   # # # #         #       # #       #   # # #   # # # #     #         #           #   #     #       #   # # # #   # #
# ##### # # ######### ####### # # ########### # # ### # ### ##### ##################### # # # ### ####### # ### # # ### #
#     # #   #   #     #   #   # #           # #     # #   # #     #           #   #     # # #     #       # #   #   #   #
##### # ##### # # ##### # ##### ########### # ##### # ### # ### # # ######### # # # ##### ### ##### ####### # ### ### # #
# #   #     # # # #     # #     # #       # #   #   #   # #   # # # #     #   # # #   # #   # #     #     #   # # #   # #
# # ####### # # ### ##### # ##### # # ### # ### # ##### # ### ### # ### ### ### # ### # ### ### ##### ### ##### # ##### #
# #     #   # #   # #       #   #   # #   #     #     # #   # #   #   #   # #   #     #     #   # #     # #   #   #     #
# ##### # ### ### # ######### # # ### # ########### ### # # # # ##### ### # # ### ##### ##### ### # ##### # # # ### ### #
#       # #   # # # #         # #   # # #   #     # #   # # # #     #     # # #   #   #     #   #   #   # # # # #   #   #
# ####### # ### # # # ######### ##### ### # # # ### # ### ### ##### ##### # # # ### # ##### ### # ### # # # # # # ### ###
#     #   #   # #   # #       #     #     # # #     #   #     #     # #   # # #   # # #   #     # #   # # # # #   # # # #
##### # # ### # ### # ### # ####### # ##### # ######### # ##### ### # # ### # ##### # # # ######### ### # # # ##### # # #
# #   # # # # #     #     # #       #     #   #     #   #     #   # # # # # #   #   # # #     #     # # # # #       # # #
# # ### # # # # ########### # ########### ####### # # ####### ### # # # # # ### # ### ##### ### # ### # # # ### ### # # #
# #     #   # # #     #     #     #       #       # # #   #   #   #   #   #   # # # # #     #   # #     # # # # #   #   #
# ####### ### # # ##### ######### # ####### # ####### ### # ### ######### ### # # # # # ##### ### # ##### # # # ### ### #
#     # # #   #   #           #   #     #   #       #   # # # #           #   #   # # #       #   #     # #   #   # #   #
# ### # # # ####### ########### ####### # ######### ### # # # # ########### # ##### # ######### ####### # ### ### ### ###
# #     # #     #   #   #     # #     # #     #       # # # # #     # #     #       #         #       #     #   #   #   #
# ####### ##### # ### # # ### # # ### # ### ### ####### # # # ##### # # ########### ######### # ##### ######### ### ### #
# #     # #   #   #   # #   # #     # #   # #   #     # #   #   #   # #   #       #     #   # #   # # #       # # # #   #
# # ### # # # ##### ### ### # ####### ### ### ### ### # ### # # # ### ### # ##### ##### # # # ### # # # ### # # # # # ###
# # # #   # #       #     # #     #   # #   # #     # #   # # #   #     # # #   #   #   # #   # #   # #   # # #   # # # #
# # # ##### ############# # ##### # ### ### # # ##### ### # ##### ### ### # # ##### # ### ##### ### # # ### # ### # # # #
# #   #   #       #     #   #   #   # #   # #   #       # #     #     #   # #       #   # #   # #   #   #   #   # #   # #
# ### # ######### # ### ##### ####### # # # ##### ####### ##### ####### # # ### ######### # # # # ####### ####### ##### #
# #   #         #   # # #         #     #   #     #     #   # #         # #   # #         # # # # #     #       # #     #
# # ##### ##### ##### # ##### ### # ######### ##### ### ### # ########### ### # ##### ##### # # # ### ######### # ##### #
#   #   #     #       #     #   #   #   #             #   # #           # #   #       #     #   #   # #       # #   #   #
# ### # ############# ##### ####### # # ####### ####### # # # ########### # ########### # ##### ### # # # ### # ### # ###
# #   # #   #     #   #   #       #   #       # #   #   # # #   #         #     #       # #     # # #   # #   #   # #   #
# # ### # # # ### # ### # ####### ########### # # # # ##### ### # ########### # # ####### # ##### # # ### # ##### # ### #
#   # #   #   # # # #   # #       #     #   # # # # # #   #   #   #         # # # # #     #     # # # #   # #   # #   # #
##### ######### # # # ### # ########### # # # ### # # # # ### ##### ####### ### # # # ######### # # ### ### ### # ### # #
#     #     #   #   #   #   #           # #   #   #   # #     #     #           # # # #       #   #   # #       #   # # #
##### # # # # ##### ### ##### ######### # ##### ##### # ####### ################# # # # ### ### ##### # ####### ### # # #
#     # # #   #       # #     #         #     #   #   # #     #         #     #     # #   #     #     #       #   # #   #
# ### # # # ### ####### # ### ############### ### # ### # ##### ####### # ### ####### ########### ##### ##### ### # ### #
# #   # # # #   # #     # # #     #         # #   # #   #   #     #     # # #   #   # #     #     # #   #   #   # #   # #
# # ### # # # ### # ##### # ##### # ### ##### # ##### ### # # ##### ### # # ### # # # # ### # ##### # ### # ### # # ### #
# # # # # # #   # # #   #   #   #   # #         #   # # # # #   #   #   # # #   # # # # #   #   #     #   # #   # # #   #
# # # # # ##### # # # ##### # # # ### ########### # # # # # ### # ### ### # # ### # # # # ##### # ##### ### # ### # # ###
# #   # #     #   # #       # # #   #       #     #   #   # #   # #     #   # #   #   # #   #   #   #   #   # #   # # # #
# ##### ### # ### # ##### ### # ### # ### # # ######### ### # ### ######### # # # ##### ### # ##### # ### ### ##### # # #
#         # #   # #     # #   # # # # # # # #         #   # # # # #         # # #   #   # # # #     # # # # #     #   # #
# ######### # ### ##### ### ### # # # # # ########### ### # # # # # ######### # ### # ### # # # ##### # # # ##### ##### #
#     #     # #       # #   #   #   # # # #   #     # #   #   # #   #       # # # #   #   #   #       # #   #   #       #
##### # ####### ####### # ### ### ### # # # # # # ### ####### # ##### # ##### # # ##### # ############# ### # # # ##### #
#   # #   #     #     #   # # #     #   #   #   #   #       #     #   # #     # #       #       #         # # # # #     #
# ### ### # ##### ### ### # # ##### ############# # ####### ##### # ##### ##### ####### # ##### ##### ### # # ### #######
#     #   # #   #   #   #   # #   #   #     #   # #       #   #   #   #   #   # #     # #     #     # #   # #   #   #   #
# ##### ### # # ### ### ##### # # ### # ### # # ### ######### # ### # # ### # # # ### # ##### ##### # ##### # # ### # # #
#     #   #   #   # #     #   # # # # # # #   #   # #     #   #   # # # #   # #   # # # #   # #   # # #     # #   #   # #
# ##### # ####### # ##### # ### # # # # # ####### # # ### # ##### # # # ### # ##### # # # # # ### # # # ##### ### ##### #
# #   # # #     # #   #     #   # # #   #       # # # # #   #   # # # #   # #     #   #   # #   # # # # #   # # #     # #
### # ### # ### # ### ####### ### # ##### # ##### # # # ##### # # ### ### # ##### # ####### ### # # # # # # # # ### # # #
#   #   # #   #   # #   #     #   # #     # #       # #     # #       #   #   #   #   # #   # # #     # # # # #   # # # #
# ##### # ### ##### ### # ##### ### # ### ### ####### ### # ######### # ##### ### ### # # ### # ####### ### # # # # ### #
# #     #   #   #     #   #     #       #   # #       #   #       #   #     #   # #   # #     # #     #   #     # # #   #
# # ####### ### # ### ##### ############### # # ####### ######### # ####### # # ### ### # ##### # ### ### ######### # # #
# #           # #   #   #   #             # # #   #     #     #   # #   #   # #     # #   #   #   #     #           # # #
# ######### ### ### # # # ### ########### # # ### # ##### # ### ### ### # ### ####### # ### # # ### ### ######### ### # #
# #       # #   #   # # #     # #     #   #     #   #   # #   #   #     # #   #     #     # # # # #   #   #       #   # #
# # ##### # # ### ### # ####### # # # # ############# ### ### ### ####### # ##### # ####### # # # ### ### # ####### ### #
# #   #   # # #   #   #     #     # # #           #   #   #     #   #   # #       #   #     # # # #   # # # #   # # # # #
# ### # ### # # ### ####### ### ### ############# # # # ### # ##### # # # # ######### # ##### # # # ### # # # # # # # # #
#     #   # # #   # #     #   #   #             #   #     # # #   # # #   # #     #     # #   #   # #     #   #   # #   #
# ####### # # ### # # # ##### ### ########### ############# ### # # # ### ### ### ####### # ####### # ######### ### # ###
#       # # # #   # # # #     #   #         #           #   #   # # #   # #   # #   #     #   #     # #         #   # # #
######### ### # ### # # # ######### ####### ######### # # ### ### # ### # # ### ### # # ##### # ##### # ######### ### # #
#     #   #   #   # # #   #         #     #         # # #   #   # #   # # #     #   # # #   # #     # # #   #   #   #   #
# ### # # # ####### # ##### ######### # ########### # # ### ### # ### # # # ##### ##### # # # # ### # # # # # # ### ### #
#   # # # #     #   #     # #     #   #           # # # # #     #   # # # # #     #     # # # #   # # #   #   # #   # # #
# # # # # ##### # ####### # # ### # ####### ### ### # # # ######### # # ### # ##### # ### # # ##### ########### # ### # #
# # #   # #   # # #     #   # # #   #     # #   #   # #   #   #     # #     #     # #     #       #           # # #   # #
# # ##### # ### # # ### ##### # ####### # # # ### ### ### # # # ##### # ######### ############### ######### # # # # ### #
# #   #     #   # # #   #   #     #     # # #   # #     # # # #     # #       #   #         #   #         # #   # #     #
# ### ##### # ### # # # # ####### # ### ### # ### # ### # # ####### # ####### # ### ####### # # ######### # ##### ### ###
# #   #   # #     # # #   #   #   #   # #   # #   # #   #   #   #   #   #   # #   # #     # # #   #     # #     #   #   #
# # ### # ########### ##### # # ### # ### ##### ##### ##### # # # ##### # # ##### # # ##### ##### # ### # ####### # ### #
# #     #             #     #   # # # #   #     #     #     # # #     # # #     #     #     #     #   # #       # # #   #
# ############### ##### ######### # # # ### ##### # ######### # ### # # # ##### ####### ##### ####### # ####### ### # ###
#   #           #   #   #     #     # #     #     # #   #     #     # #   #   #       # #           # #         #   #   #
### ######### # ### # ### # ### ##### ####### # # ### # # ######### ####### # ####### # ### ####### # ########### ##### #
# #     #     # #   #   # #     #         #   # # #   #   #       # #       # #   #   #   #     #   # #           #   # #
# ##### # ####### ##### ######### ####### ##### # # ######### ### # # ### ### ### # ##### ##### # # # # ##### ####### # #
#     # #     #   #   #   #     # #       #   # # #         #   #   # #   #       #     #   # # # # # # #   # #       # #
# ### # ##### # ### # ### # ### # # ####### # # # ######### ######### # ############### ### # # # ### ### # # # ### ### #
#   #         #     #       #     #         #   #         #           #                     #   #         #   #   #     #
#########################################################################################################################
