###############################
#       #       #     #       #
####### # ####### ### # ### # #
#       #   #       #     # # #
# ######### # ############# # #
# #         #   #       #   # #
# # # ######### # ##### # #####
# # # #         #   # # # #   #
# ### # ########### # # # # # #
#   # # #       #   #     # # #
### # # # ### ### ######### # #
# # # # #   # #   #         # #
# # # # ### ### ### ######### #
#   #     #   #     #         #
# ####### ### ####### ####### #
#       #   #     #   #       #
####### ### # ### # ### #######
#     #   #   #   # #   #     #
# ####### ####### # # ##### # #
#         #     # # #       # #
# ######### ### # # ######### #
# #       # #   # #       # # #
# ### ### # # ##### ##### # # #
#     # #   #     # #     # # #
####### ######### # # ##### # #
#   #     #     # # #   #   # #
### # # ### ### # ##### ### # #
#   # #     # # #   #   #   # #
# ### ####### # ### # ### ### #
#             #       #       #
###############################
