###############################################################################################################
#   #             #             # #       #     #         #     #       # #     #   #                 #   #   #
### ########### # # ##### ##### # # # ##### # # ##### ### ### # ##### # # # ### # # # ########### # ### # # # #
# #     #       # #   #   #     #   #     # # #   #   # #     #   #   # #     #   #   #     #   # #     #   # #
# ##### # ####### ##### ### ######### ### # # ### # ### ######### # ### ##### ######### # ### # ### ######### #
#     # # # #   #     # # # #   #   # # #   #   #   #   #         # #       #         # # #   #   #       #   #
# # ### # # # # ##### # # # # # # # # # ####### ##### # # ######### # ##### ######### # # # ##### ######### ###
# # #   # #   #   #   # # #   #   # #     #     #     #   #   # #   # #   #   #       # # #   # # #   #   #   #
# # # ### ##### # # ### # ######### ##### # ##### ######### # # # # ### # ### # ######### ### # # # # # # ### #
# # #   # #     # #     #     #   # # #   # #   # #       # # #   #   # #   # #   #       # # #     #   #   # #
# # ### # # ##### ####### ### # ### # # ### # ### # ### # # # ####### # ### # ### # ##### # # ############# # #
# #   #   # #   #   #     #   #   # #   #   #     # #   #   #       #     # #   #   #   # # #         #   #   #
# ### ##### # # ### # ##### ##### # ##### ### ##### # ############# ####### ### ##### ### # ######### ### ### #
# # #         #   #   #   #   #   #       # # #     # #           #       #   # #     #   #       #   #   #   #
# # ############# ##### # ### # # ######### # # ##### ####### ########### ### # # # ### ### # # ### ### ### ###
#   #     # #   #   #   #   #   # #           #     #   #   #           #     # # # #   #   # # #   #   #   # #
### ### # # # # ### # ########### # ################### # # # ### ############# # ### ####### ### ### ### ### #
# #     # #   #   # #     #     # #     #               # # #   #             # #           # #   #     #     #
# ####### ##### # # # ### # # ### ##### # ##### ####### # # ##### ####### ### # # ######### # # ####### ##### #
#       # #     # # #   #   #     #   # #   # #   #     # #     #   #   # #   # # #   #   # # #   #         # #
####### # # ##### # ####### ####### # # ### # ### ##### # ##### ### # # # ### # ### # # ### # ### # ####### # #
#       #   #   # #       #   # #   #   #   #   #     # # #   # #     # #   # #   # # #       #   # # #     # #
# ##### ##### ### ####### ### # # ####### ### ####### ### ### # # ######### ##### # # # ####### ### # # ##### #
# #         #   # #     #   # # #   #   #   #       #         # # #     #   #     # # # # #     #   #       # #
# ######### # # # ##### ### # # ### # ##### ####### ########### # # ### # ### ##### # # # # ####### ######### #
#       #   # #           # # #   # #     # #     #   #     #   # #   #   #   #     # #   #   #     #       # #
####### # ### ######### ### # # # # # ### # # ### # ### ### # ##### # ### # ### ##### ### ### # # ### ##### # #
#       # #   #   #   # #   # # # # #   # # # # #   #   # # #     # #   # # # #   #   #   #   # #     #   #   #
# ####### # ### # # # ### ### # ### # ### # # # # ### ### # ##### ##### ### # # # ### # ### ### ####### # #####
# # #     # #   # # #     #     #   # #   #   #   #   #   #       #   #   # #   #   # #   #   #     #   #     #
# # # ##### # ### # ### ####### # ##### ####### ### ### ########### # ### # ### ### # ### ### ##### ### ##### #
# # #   #   #   # # #   #     # # #   #       # # # #           #   #   # #   #   # #   #   #   #   #   #     #
# # ### # ##### # # # ### ### ### # # ### ##### # # # ####### # ### ### # ### ### # ### ####### ### # ### #####
# #     # #     #   # #   # #     # #     #       # #       # # #   #   #   # #   # # #       #   #   #   #   #
# ####### # ######### # ### ####### ####### ####### ##### ### # # ### ### # # ##### # ####### ### ####### # # #
# #       #   #       # #       #       #   #   #   # #   #   #   # # #   # #   #   #       #   #       #   # #
# # ######### ##### ### # ### # ####### # ### ### ### # ### ####### # # ####### # ### ##### ### ####### ##### #
#   #       #     #   # #   # # #     # #     #   # #     #   #     # #       #   #   #   #   #     #   #   # #
# ####### ####### ### # ##### # # ### # # ##### ### # ####### ### # # ##### # ##### ### # # ####### # ### ### #
#     #   #       #   #   #   #   #   #   #   # #     # #   # #   # #     # #     # #   # # #     #   #       #
##### # # # ####### ##### # ####### ### ### # # ### ### # # # # ### ##### ##### # # # ### # # # ####### #######
#   #   # # #   #   #   #   #     # # # #   # #   # #   # #   #   #     #       #   # #   # # # #     # #     #
# # # ##### # # ##### # ##### ### # # # # ### ### # ### # ####### ################# # # ##### # # # ### # # ###
# #   #     # # #     #   #   #   # #   # # # #   # #   #   #   #             #     # #       # # #     # #   #
# ##### ##### # # ####### # ### ### # ### # # # ### # ##### # # ### ### ####### ##### ######### # ####### ### #
#     #       #   #     # # #   #   #   # # #   #     #   #   #   #   #       #   # #     #     #   #   #   # #
##### ############### ### # # ### ####### # ########### # ### ### ### ####### ### # ### ### ### ### # # ### # #
#   # #     #       #   #   #   # #       #   #         #   # #   #   # #     # # # #   #   # # # # # # #   # #
# # # ### # # ### # ### ####### # # # ##### # ### ######### ### ### ### # ### # # # # ### ### # # # # # ##### #
# # #   # #   #   #   #       # # # # #     #     #   #   #   # # #     # #     # # #   # #     # #   #     # #
# # ### ####### ##### # ##### # # ### # # # ##### # # # ##### # # ##### # ####### # ### # # ##### ######### # #
# #   # #       #     # #   # # #     # # # #   # # # #       # #     # #       #   #   # #       #       # # #
# # ### # ####### ####### # # # ######### ### # # # # # ####### # ### # ####### # ### ### ######### ##### # # #
# # #   # #   # # #       #   #         #   # # # # # #         # #   #   #     # #   # # #   #   # # #   #   #
### # ### # # # # ### # ##### ####### # ### # # ### # ##### ####### ##### # # ### # ### # # # # # # # # ##### #
#   #   # # #   #   # # #   #   #   # #     # #     #   #   #     # #     # # #   # #   #   #   #   # # #     #
# ##### # # ####### ### # # ### # ### ####### ######### ##### ### # # ##### ### ### # # ############# # # #####
#     # # #       #     # #   # #   #   #   # #       # #   # # # #     #   #   # #   #     #   #   # # #     #
# # ### # # ### ######### # ### ### ### # # # # ##### # # # # # # ####### ### ### ######### # # # # # # ##### #
# # #   # #   #           #   #   #   #   #   # #     # # # # # #       #   # #   #       # # #   # # #   #   #
# # # ### ####### ##### ##### ### # # ######### # ##### # # # # ####### ### # # # # ### # # # ##### # ### # ###
# #   # #       # #   #   #     #   #         # #   #   # # #   #     #   #   # # # #   # # #   # # #   #   # #
# ##### # ##### # # # ##### ### ####### ##### # ### # # # # ### # # ##### # ##### # # ##### # # # # ### ##### #
# #     # #   # # # #     # #   #   #   #   # # # # # #   #     # # #     #       # #       # # #     #     # #
# # # ### ### # ### ##### # # ### ### ### # ### # # ##### ##### # ### ####### ##### ######### # ##### ### # # #
# # # #   #   #   # #     # #     #   # # # #   # #     # #   #   #   #       #     #     #   #     #     #   #
# # # # ### # ### # # ##### ##### # ### # # # ### ##### # # # ### # ##### ##### ####### # # ####### ######### #
# # # #     #   #   # #   #     # # #   # #   #   # #   # # #   # # #   # #     #       # #     #   #       # #
# # ### ####### ##### # ### ### ### ### # ##### # # # ### # ### # # # # ### ##### # ##### ##### # ### ##### # #
# #     #     #   #   #       # #       # #   # #   #   # # # # # # # #     #     # #   #   #   #   # #     # #
# ####### ### ### # ####### ### # ####### # # # ### ### ### # # ### # ######### # ### # ##### ##### ### ##### #
#   #     # # #   #       # #   # #       # # # #   # #     # #   # #     #     # #   #   #   #   # #   #     #
### # ##### # ########### ### ### # ####### # # # ### ####### ### # ##### # ##### # ##### # ##### # # ### #####
#   # #   #   #     #   #   #     #     #   #   # #         #   # #   #   #   #   # #   #   #   # # #     #   #
# ### ### # ### ### # # ### ########### # ####### # # ##### ### # # # # ### # ##### # ##### # # # # # ####### #
#   #   #       #   # #     #     #     #   #   # # #     #   # # # # # #   # #   #   #   #   #   # # #       #
### ### ######### ### ##### # ### # ####### # # # # ##### ### # # ### # ##### # # # ### # ### ##### # # ##### #
# #   #   #     # #     #   # # #   #       # #   #   #   # #   #     #   #   # # # #   #   # #     #   #   # #
# ### ### # ### # ### # ##### # ##### # ####### ####### ### # ####### ### # ### # # # ##### ### ######### ### #
# #   #   #   # #   # # #     #       # #     #   #     # #   #     # # # #   # #   #   #   #   #       # #   #
# # ### ### # ##### ### # ##### ### ### # ### ### # ##### # ### # ### # # ### # ####### # ### ####### # # # ###
# #   # # # # #     #   #   # # # #   # #   # #     #   #   #   #   # # # #   #   #     #     #       # # #   #
# ### # # # # # ##### ##### # # # ### # ### # ####### # # ### ##### # # # # ### ### ########### ####### # ### #
#   #   # # #   #   #     # #     # # #   # #   #   # #     #     #     # #     #   #   # #     #     #   #   #
# ####### # ##### # ### # # ##### # # ### # ### # # ### ####### ######### ####### ### # # # ### ##### ### # ###
#         #     # #     # #   #   # # #   #   #   #   # #     # #         #       #   #   # # #     #     # # #
# # ##### ##### # ####### ### # ### # ####### ####### ### ### # # ######### ####### ####### # ##### ### ### # #
# #     # #   #   #     #   # #   # #       # #     #     # #   #           #     # #       #     #   # #   # #
# ##### # ### ##### # ##### # ### # ####### # # ### ####### ################# ### # # ####### ### ### ### ### #
#   # # #     #     # #     #   #   #     #     #   #         #     # #       #     # # #     # #   #   #     #
### # # ##### ####### # ####### # ### ### ####### ### ####### # # # # # # ########### # # ##### # # ### ##### #
# #   #   #           #   #     # #   # # #     # #     #   # # # #   # #     #       # #     # # # # #     # #
# ### ### ######### ##### # ####### ### # # ### # ####### # # # # ### # ##### # ####### ##### # # # # # ##### #
#       #     #     #     #       # #   #   # # #     #   # # # #   # # #   # #   #   #         # #   # #     #
############# ####### ########### # # ####### # ##### # ### # # ### ### # # # ### # # # ####### # ### # # #####
#           # #     #   #     #   # # #       #     #   #     #   #     # # #   # # # #   #   # #   # # #   # #
# ######### # # ### ### ### # # ### # # ### ####### ############# ######### # # # # # ##### # ### # # # ### # #
# #     #   #   #     #     # #   # # # # #       # #           #     #     # # #   #     # #   # # # #     # #
# ##### # ####### ########### ### # # # # ### ### # # ######### ##### # ##### # ######### # ### ### ######### #
#     # # #     #     #     # # #   # #   # #   # #   #     # #   #   #     # # #       #   # #   #       #   #
# ### # # # ### ##### # ### # # ##### ### # ### # ####### # # ### # ####### # ### # ### ##### ### # ##### # # #
# # # #     #       # # # #   #             #   #   #     #     #   #       # #   # #   #     #   #     #   # #
# # # ############# # # # ############# ##### ### ### # ####### ##### ##### # # ### ##### # # # ####### ##### #
#   #   #   #     # # #   #     #     # #   #   # #   # #     #     # #     #   #   #     # # #     #   #   # #
### ### # # # ### # # ### ### # # ### ### # ### ### ### ##### ##### # ########### # # ##### # ##### # ### ### #
# # # #   # # # # #     # #   # # # #     #   #       #   #       #   #           # # #   # # #   # #     #   #
# # # ##### # # # ####### # ### # # ######### ##### ##### # ######### # ####### ##### # # # ### # # ####### # #
#   #     # # # #         # #   # #         #     # #     #     #   # # #     # #   # # # #     #   #       # #
# ##### # # # # ########### # ### # ##### ####### ### ##### ### # # # # # ### ### # # ### ########### ####### #
#       # #                 #     #     #             #       #   #   #     #     #                   #       #
###############################################################################################################
