###############################################################################################################
# #       #             #     #         #                 #           #         #                   #     #   #
# # ##### ##### # ##### # # # ### ##### ########### ##### ##### # ### # # ##### # ####### ### ####### # ### # #
#   #   #     # # #   # # # #     #   #   #   #     #   # #   # # #   # # # #   #   #   #   # #       #     # #
##### # ##### ### # # # ### ####### ##### # # # ##### # # # # ### # ##### # # ##### ### ### ### ####### ##### #
#     #     #     # # #   #   #     #   #   # #   # # #   # #   # #   #   #   #   #   #   #       #   #   #   #
# ### ##### ####### # ### ### # ### # # ##### # # # # ##### ### # ### # ### ### # ### # ######### # # ##### ###
# #   #   #     # # #   # #   #   # # #   #   # # # # #       # # # # # #   #   #     #   #     # # #     #   #
# ### # # ##### # # ### # # ### # ### ### # ### # # # # ##### # # # # # # ####### ##### # # ### ### ##### ### #
#   # # #   # # #   #   #   # # #     #   #   # # #   # #   # #   #     # #     #   #   # # #       #       # #
# # ### ### # # # ### # ##### # ####### # ### ### # ### # ### # ######### # # # ### ##### # ############### # #
# # #   #   #   #   # #     #         # #   #     # # #   #   # #       # # # # #     #   #               # # #
### # ### ### ##### # ##### # ##### ### ########### # ### # ##### ##### # ### # ##### # # ############### # # #
#   #   # # #     # # #     # #   # #   #           #   # #       #   # #   # #     # # #         #     # # # #
# ### ### # ##### ### # ####### # ### ### ############# # ######### # # ### # ##### # # ######### # # ### # # #
# #   #   #     #   # #   #     #   #   #       #       #     #   # # #   #   # #   #   #       #   # #   #   #
# # ### ### ### ### # ### ### ##### # # ####### # # ######### ### # # ### ##### # ####### ##### # ##### ##### #
# #   #   # # #   # #   #     #   # # #       # # # #   #   #     # #   # #   #   #     #   #   # #   #   #   #
# ### ### # # ### # ### ####### ### # ### ### # ### # # # # ##### # ### # # ### ##### # ### ### # # # ### # ###
#   #   # #   # # #   # #   #   #   # #   #   #   #   # # # #     #   # # #   # #     #   #   # # # #     # # #
# # ### # ### # # ### # # # ### # ##### ### ##### ##### # # # ####### # # # # # # # ##### ### ### # ####### # #
# # #   # #   # #   #   # #   # # #     # # #   # #     # #   #     # #   # #   # #   # #   # #   # #       # #
# # # ### # ### # ####### ### # # ### ### # # # # # ##### ##### ### # ##### ##### ### # ### # # ### ### ##### #
# # # # # # #   #         #     #     #     # # # #         #   # # #   # # #     # # #   # # # # #   # #     #
# ### # # # # # ##### ######### ####### ####### # ######### # ### # ### # # ##### # # # # # # # # ### # # ### #
# #   # # #   #   # #     #   #   #     #       #         # #   #   #   # #     #   # # #     #   #   #   #   #
# # ### # ####### # ##### # # # ### ##### ### # ######### ##### # ### ### ##### ##### ########### # ###########
# # #   #   #       #   #   # # #   #     #   # #       #       #     #       #     #           # #           #
# # ### ### # ##### ### ##### ### ### ##### ### ##### ################# ##### ##### # ####### ### ##### ##### #
#         # # #   #   #     # #   # # # #   #   #     #     #     #   # #   #   #   #   #   #     #   #   #   #
# ######### # # # ### # ##### # ### # # # ##### # ##### # # # # # # # ### # ### # ##### ### ####### # # ### # #
# #         # # # #   #     #   # #     # #   # # #   # # # # # # # #     #     # #         #     # # # #   # #
### # ##### ### # # ### ### ##### # ##### # # # # # # # # ### # # # ############# ######### # ##### # ### #####
#   # #   # #   # #   #   #     #   #     # # # # # # # #     # #   #     #     # #     #     #     #   #     #
# ##### # # # ### ### ### # ### # ### # ### # # # # # # ####### ### # ### # ### # # ### # ##### ####### # ### #
#       # # # # # #   #   #   # # #   # #   # #   # #     #     #   # # #   # # #   #   #   #   #   #   # #   #
# ####### # # # # ### ####### # ### ### # ### ##### ####### ######### # ##### # ##### ### ### ##### # ##### # #
#     # # # # # #   #   #     #     #   # # #     #   #   #   #       #       #     # #   #   #     # #     # #
##### # # ### # ### ### # ########### ### # ##### # ### # ### # ######### ### ### ### # ### ### ### # # # ### #
# #   # #       #   #   #   #         # #   #   #   #   #     # #       #   # #   #   # #   #   #   # # #   # #
# # ### ######### ### ### # # ####### # ### # # ##### ######### ##### # ##### # ### ##### ### # # ### ##### # #
# # #         #   # # # # # # #     #   # # # # #   #     #     #     #   #   #     #     #   # # # #     # # #
# # ##### ##### ### # # # # ### ### ### # # # # # # ##### # ##### ####### # ######### ######### # # ##### # # #
# #     #     # # #   #   # #   # #   #   #   # # #     #   #     #   #     #       #   #       # #   # # # # #
# ##### ##### # # # ####### # ### ### # ####### ####### ####### ### # ####### ##### # # # # ##### # # # # # # #
#   #   #     # #   #   #   # #     # # #     # #       #     #     #         #   #   # # # #   #   #   #   # #
# # # ### ##### ### # # # # # ### # # ### # # # # ##### # ### ##### ########### # # ### # ### # ############# #
# #   #   #   #   #   #   # #   # # #     # # #   #   # # # # #   #   #   #     # # #   #   # #   #   #     # #
# ##### ### # ### ####### ##### # ##### ### # ##### # # # # # # # ##### # # ##### # # ##### # ### # # # ### # #
#   #   #   #   # #   #   #     # #   # #   # #     # #   # #   #       # # #   # # #   #   # # #   #   # #   #
### # # # ##### # ### # ### ##### # # ### ### ### ### ##### ############# # # # # ### # # ### # ######### #####
#   # #   #   # #   #     # #     # # #   # #   #   #   # #             # # # # #   # # #   # #   #   #       #
# ##### ##### # ### # ##### # ##### # # ### ### ### ### # # ######### ### # # # ### # # ### # ### # # # # #####
#     #       #   # # #   # #     # #   #     #     #   # #     #   #     # # #   # # #   #     #   #   # #   #
##### ######### # # ### # # ### # # ####### # ####### ### ##### # ######### # # ### # ### ##### ######### # # #
#   #   #       # #   # # #   # # #     #   # #   #   #     #   #     #     # #   # # # #     #         #   # #
# # ### # ####### ### # # ### # # ##### # ### ### # ####### # ##### # # ### ##### # # # ##### ######### ##### #
# # # #   #   #   # #   #     # # #   # # #       #   #     #   #   # #   #     # # #       # #   #   #   #   #
# # # ##### ### ### ############# # # # # ### ####### # ####### # ### ### ##### # # ### ##### ### # # ### # # #
# #   #   #   # #         #   #   # #   #   # #       #   #     # #     # #     # #   # #     #   # # #   # # #
# ### # # # # # # ### ### # # # # # ##### # ### ####### # # ##### ##### ### ##### ### ### ##### ### # # ### ###
# # # # #   #   #   # #   # #   # # #   # #   #     #   # #     #     #   # # #     #     # #     # #   #     #
# # # # ############# # ### ##### # # # ### # ##### # ### ##### # ### ### # # # ### ####### # ### # ##### ### #
# # # # #             #   # # #   #   #   # #     # # #   #   # #   # # #   #     #         # # #   # #     # #
# # # # # ##### ######### # # # ##### ### ##### # # ### # # # # ##### # ########### ### # ### # ##### # ##### #
# # # # #   # # #   #   #   #   #   #   # #     # #     # # # # #     #       #   #   # # #   #     #   #     #
# # # # # # # # # # ### ##### ### # ##### # ##### ####### # ### # ##### ##### # # ### # # # ### ### ##### ### #
# #   # # # # # # # #       # # # #     # # #       #   # #   #   #     #       #   # # # #   # #         # # #
# ##### ### # # # # # ### ### # # ##### # # # ####### # # ### ##### # ############# ### ##### # # ######### # #
# #         #   # # #   # #     #   # #   # #   #   # #   #     #   # #       #   #   #     # # # #       #   #
# # ######### ### # ### ### ####### # ##### ##### # # ##### # ### # ### ##### # ##### # ### # # ### ##### ### #
# # #   #     # # #   #     #       #   #   #     # # #     # #   #       #   #     # # #   # #         #   # #
# # # # ##### # # ### # ##### ####### # ### # ##### # ### ### # ####### ### ### ### # ### # # # ########### # #
#   # # #   #   #   # # #   #   #     #     # #   # #   # #   #   #   # #   #   # #   #   # # #   #     #   # #
# ### # # # # ##### # # # ##### # # ####### # ### # ### # ####### # # ### ### ### ##### ### # ##### ### # #####
# #   #   # # #   # # #   #   # # #     #   #     #   # # #   #   # # #   # #   #     #   # #       # # #     #
# # ####### ### # # # ##### # # # ##### # ####### ### # # # # # ### # # ### ### # # # # # ########### # ##### #
# #   #   #     # # #   #   # # # #   # #       # # # #   # # # #   #   #     # # # # # # #             #     #
# ### # # ####### # ### # ### # # ### # ######### # # ### # # # # ####### # ### # # ### # # ############# #####
# #   # #       #   # # #   # # #     #     #   #   #     # #   #   #     #     # #     # # #           #     #
# # ########### ##### # ### # # ##### ##### # # ### ####### ####### # ################### # ### ####### ##### #
# # #   #     #   #         #   #   # #   #   #     #   #   #   #   #                     #   #   #   # #   # #
# # # # # ### # # # ############# # # # # ### ####### # # ### # # ### ################### ### ### # ### # # # #
# # # #   # # # #     #     #   # #   # #   # #   #   #   #   # # #   #       #         #   #     # #   # #   #
### # ##### # # ####### ### # # # ##### ### # # # # ####### ### # # ### ##### # ####### ### ####### # ### ### #
#   #       # # #   #   # # # # #     # #   #   # #     #     # # # #     #   # #   # #             # #   #   #
# ######### # ### # # ### # # # ### ### # ##### ####### # ### # # # # ##### ### # # # ####### ####### # ##### #
#     #     # #   #   #   # # #     #   # #   # #       # #   # # # #   #   # # # #   #     # #       #     # #
# ### # ##### # ####### ### ##### ### ### # # ### ######### ### # ##### # ### # # ### # ### ### ########### # #
# # #   #     # #     #   #     # # #   # # #   # # #       # # #       # #   # # #   #   #     #         # # #
# # ##### ### # # ### ### ##### # # ### # # ### # # # ### ### # ######### ### # # # ##### ########### ### # # #
#     # # #   #   #   #       # #   #   # #   # # #     # #           #   #   #   # #   #           # #     # #
##### # # ######### ### ####### ##### ### ### # # ####### ########### # ### ####### # ############# # ####### #
#   #   #   #     #   # #       #       # #   #   #       #         # # #       #   #     # #     # #       # #
# ##### ### # # ##### # # ##### # ####### # ####### ### ### ####### ### # ##### # ### # # # # # ### ####### # #
# #     #   # #     # # # # #   # #   #   #   #     #   #   #   #       #     #   #   # # #   #   #         # #
# # ##### ### ### ### # # # # ### # # # ##### # ### ##### ### # # ########### ##### ### # ####### ########### #
# #     #   #   #   # # # #   #   # # #       # #   #     #   # # # #     # #   #   #   #       #   #     #   #
# ##### ### ### ### # # # # ### ##### ######### ##### ####### ### # # ### # ### ##### ######### ### # ### # ###
# #   #   #   # # #     # #   #     #   #       #   #     #   #     #   # #     #     #       #     # # # #   #
# # # ### ### # # ####### ######### # ### ##### # # ##### # ### ##### ### # ##### ##### ### ### ##### # # ### #
#   #     # #     #     # #       # # #       #   #     # #       #   #   #   #   #   #   # #   #   #   #   # #
# ######### ##### # ### # # ### ### # # ############### # ######### ### ##### # ### # # ### # ### # ### ### # #
# #     #   #   # #   #   #   # #   #   # #           # #     #     # #     #   #   # # #   # #   #   #   #   #
# ##### # # # # ##### ####### # # ### ### # ######### # ##### # ##### ##### ### # ### # # ### # ### ##### #####
#     #   # # #     #   #     # #   #     #       # # #     #   #   #   # # #   #   # # #     # # #       #   #
##### ##### # ##### ### # ##### ### # ########### # # # ### ##### # # # # # ####### # ######### # ######### # #
#   #       #   #       # #     #   # #     #   # # # #   # #     # # # # #     #   # #         #   #   #   # #
# # ####### ### ######### # ##### ##### ### # # # # # ### # ### ### # # # ##### # ### # ######### # # # ### # #
# #           #           #             #     #   #       #     #     #       #     #             #   #     # #
###############################################################################################################
