###################################################
# #     #             # #     #         #         #
# # ### # ### ####### # # ### # ### ### ### ##### #
# #   # # # #     # # #     #   #   # #   #   # # #
# ### # # # ##### # # ##### ##### ### ### ### # # #
#     # #   #   # #   #   # #     #     #   #   # #
####### ### ### # # ### # ### ####### # ### ##### #
#       #       # #     # #   #       #   #   #   #
# ####### ####### ####### # ### # # ######### # ###
# #   #   #   #   #   #     #   # # #         #   #
# ### # ### # # ### # ########### # # ########### #
#   #     # #   #   #   #       # # # #           #
### # ##### ##### ##### # ##### # # # ######### # #
#   # #   #     # #   # #     # # # #     #   # # #
# ### # # # ### # # # # ##### # # ####### # # # # #
# # # # # #   # #   # #   #   # #       # # # # # #
# # # # # ##### ##### ### # ### ####### # # # # ###
# #   # #     # #       #   #   #       #   # #   #
# ##### ##### # # ########### ### ##### ##### ### #
# #     # #   #     #   #     #     #   #   #   # #
# # ##### # ##### ### # # ######### # ### # ### # #
# # #     #     # #   #   #         #     #   #   #
# # # ######### ### ####### ### ### ####### ##### #
# # # #   #   # #   # #   # # #   # #   #   #     #
# # # # # # # # # ### # # # # ### ### # # ### #####
#   #   # # # #   #   # #   #   #     # #   # #   #
######### # # ##### ### ##### ######### # ### # # #
#       #   # #   #     #             # # #   # # #
# ##### ##### # # # ############### # # # # ##### #
#   #   #     # #   #     #     #   # # # # #     #
# # # ### ##### ##### ### # ### # ### # ### # #####
# # #   #     # #       #   # #   #   # #   #     #
# # ### ### # # ####### ##### ##### ### # ### ### #
# # #     # # #       # #             # # #     # #
# # ##### ### ####### # # ########### # # ### ### #
# #     #         #   # #   #     #   # #   # #   #
##### # ####### ### ### ##### ### ##### ### ### ###
#   # # #     # #   #   #   # # #     #   #   #   #
# # ### # ### # # ##### # # # # ##### ### ### # # #
# #   # #   #   #     # # #     #   #   #   # # # #
# ### # ### ######### # # ##### ### # ##### # ### #
# #   # #       #     #   #   #     #   #   #     #
# ### # ####### # ######### # ##### ### # ####### #
#   #   #   #   #   #       #     #   # # #     # #
# # ### # # # ##### # ########### ##### # # ### # #
# #   # # # #     # # #   #     #     # #   # # # #
##### # # # ####### # # # # ### ##### # ##### # # #
#     # # #         # # #   # #   #   #     # #   #
# ####### ########### # ##### ### # ### ### # #####
#                     #         #       #         #
###################################################
