#################################################################################
# #       #             #     #         #                 #           #         #
# # ##### ##### # ##### # # # ### ##### ########### ##### ##### # ### # # ##### #
#   #   #     # # #   # # # #     #   #   #   #     #   # #   # # #   # # # #   #
##### # ##### ### # ### ### ####### # ### # # # ##### # # # # ### # ##### # # ###
#   # #     #     #   #   #   #     #   #   # #   # # #   # #   # #   #   #   # #
# # # # ### ######### ### ### ####### # ##### # # # # ##### ### # ### # ### ### #
# #   # #   #       #   # #   #   #   #   #   # # # # #       # # # # # #   #   #
####### # ### ### # # # # # ### # # ####### ### # # # # ##### # # # # # # ##### #
#       #   # #   #   # #   #   # #       #   # # #   # #   # #   #     # #     #
# ######### ### ### ######### ### ####### ### ### # ### # ### # ######### # # # #
# #             #   #         #   #         #     # # #   #   # #       # # # # #
# ################### ##### ### ### ############### # ### # ##### ##### # ### # #
#       #                 #   #   # #   #           #   # #       #   # #   # # #
# ##### # ################### ### # # # # ############# # ######### # # ### # # #
#   # #   #   #     #   #   # #   #   # #       #       #     #   # # #   #   # #
### # ##### ### ### # # # # # # ####### ####### # # ######### ### # # ### ##### #
# #   #     #   # #   #   #   # #     #   #   # # # #   #   #     # #   # #   # #
# ### # # ### ### ############# # ### # # # # # ### # # # # ##### # ### # # # # #
#   # # # #   #               #   # #   # # # #   #   # # # #     #   # # # #   #
# ### # # # ######### ### ######### ##### # ##### ##### # # # ####### # # # #####
#     # # #     #     #   #             # #     # #     # #   #     # #   # #   #
# ####### ##### # # ####### ######### # # ### # # # ##### ##### ### # ##### ### #
# #         #   # # #   #   #   #   # #     # # # #         #   # # #   # #     #
# # # ####### ### ### # # ##### # # ####### # # # ######### # ### # ### # ##### #
# # #       # # #     #         # #   #   #   # #         # #   #   #   #   # # #
# # ####### # # # ####### ####### ### # # ############### ##### # ### ### # # # #
# # #     # # #   #     # #       # # # #         #     #       #     #   #   # #
# # # # ### # ##### ### ### ####### # # ####### # ### # ############### ### ### #
# #   # #   #     #   #     #       # #   #   # #   # # #               #   #   #
# ####### # ##### ### ########### # # ### ### # ### ### # ######### ######### ###
#         #     #   #           # # #         #   # #   #     #   #   #     # # #
####### ######### # ########### ### ############# # # # ### ### # ### # ### # # #
#     # #     #   #   #     #       #     #       #   #   # #   #     #   # #   #
# ### # # ### # ####### # ### ##### # ### # ##### ##### ### # ######### ### ### #
# # #   # #   # #       # #   #   # # #     #     #   # #   #     #     #   #   #
# # ##### ### # # ####### # ### # ### ####### ##### # # # ####### # ##### ### ###
# # #   #   #   # #     # #   # #     #   #   #   # # # #       #   #   #   # # #
# # # # ### ##### ### # # ### # ##### # # # ### # # # ######### ##### # ### # # #
# # # #   #           # # #   # #     # # #   # # # #         # #   # #     # # #
# # # # ################# # ### ### ### # ### # # # ##### ##### # # # ##### # # #
# #   #         #         # # #   # #   # #   # #   #   #       # # #   #   #   #
# ############# # ######### # ### # # ### ##### ##### ############# ### ####### #
#     #         #     #   # #   # # # # #     # #   #   #           #   #     # #
##### # ####### ##### # # # # ### ### # ##### # # ### # # ### ##### # ### ### # #
#   #   #   #   #   # # # # #   #   #   #   #   #   # # #   #   # # #     # #   #
# # ####### # ##### # # # # ### ### ### # # ##### # # # ### ### # # ####### #####
# #     #   # #   # #   #   #   #     # # # #   # # # #   # #   #   #       #   #
# ##### # ### # # # ######### # # ##### # # # # # # # ### # # ### ### ##### # # #
# #   # #   #   # # #         # #     #   # # #   #     #   # #   #   #   #   # #
# # # # # # ##### # # ### ##### ##### ##### ############### # ##### ##### ##### #
#   # # # # #     #   #   #   #     #     # #       #     # #             #   # #
# ### # # # # ##### ### ### # ##### ##### # # ##### # ### ##### ########### # # #
#   # # # # # #       # # # #       # #   #   #   # # # # #   #   #   #     # # #
# ### # ### # ######### # # ######### # # ##### # # # # # # # ##### # # ##### # #
# #   #     # #         #   #         # # #     # #   # #   #       # # #   # # #
# # # ##### # # ######### ####### ##### # ### ### ##### ############# # # # # # #
# # # #   # #   # #     # #       #     #   #   #     #             # # # # #   #
### ### # ####### # ### # # ### ### ####### # ##### ### ######### ### # # ##### #
#   #   #           #   #   #   #   #   #   # #   #   #     #   #     # #     # #
# ### ############### ####### ### ### # # ##### # ### ##### # ######### # # ### #
#   #   #   #         #       #   #   #   #     #   #   #   #     #     # #   # #
# # ### # # # ##### ### ####### ######### # # ##### ### # ##### # # ### ##### # #
# #   # # # #   #   #   #     # #       # # #   #   #   #   #   # #   #     # # #
# # ### ### ### ##### ### # ### # ##### # ##### # ### ##### # ### ### ##### # # #
# #     #     # #     #   #   # # #     #     # #     #     # #     # #     #   #
# ####### ##### # ########### # # # ######### # ##### # ##### ##### ### ##### ###
#   #     #   # #   #         # # #     #       #     #     #     #   # #   #   #
### # ##### # # ### # ####### # # ##### ######### ######### # ### ### # ### ### #
# # #       # #     # # #     #   #   #   #     #   #     # #   # # #   #     # #
# # ##### ### ####### # # ######### # ### # ### ### ##### # ##### # ##### ### # #
# #     # #     #   # #         #   #   #   # #   # #   # # #     #   #   #   # #
# ##### # # ### # # # ######### # ### # ##### ### # # # # # # ##### ### # ##### #
#       # # # #   # #   #   #   # #   #   #     # #   #   #   #   #     #     # #
# ######### # ##### ### ### # ##### ##### ### # # ####### ##### ### ######### # #
#           #     #     #   # #     # #   #   # #   #   # # #     #     #   #   #
############# ########### # # # ##### # ### ### ### # ### # # ### ##### # # #####
#   #       #     #       # #   #     #     #   #   #       # # #       # # #   #
# # # ##### # ### # ### ######### # ######### ### ########### # ######### # ### #
# #       #     #     #           #             #                         #     #
#################################################################################
