#####################################################################################################
# #       #             #     #         #                 #           #         #     #         #   #
# # ##### ##### # ##### # # # ### ##### ########### ##### ##### # ### # # ##### # ### ####### ### # #
#   #   #     # # #   # # # #     #   #   #   #     #   # #   # # #   # # # #   # # #         #   # #
####### ##### ### # # # ### ####### # ### # # # ##### # # # # ### # ##### # # ### # # ######### ### #
#     #     #     # # #   #   #     #   #   # #   # # #   # #   # #   #   #   #   #   #     #   # # #
# ### # # ########### ### ### # ####### ##### # # # # ##### ### # ### # ### ### # ##### ### # ### # #
#   # # #     #         # #   # #   #   # #   # # # # #       # # # # # #   #   #     #   #       # #
# # # ##### # # ####### # # ### ### # ### # ### # # # # ##### # # # # # # ####### ### ### ######### #
# # #       #   #   #   #   #   #   # #   #   # # #   # #   # #   #     # #     # # # #   #         #
### ############# # # ######### # ### ### ### ### # ### # ### # ######### # # # # # # # ### #########
#   #         #   # # #         #     #     #     # # #   #   # #       # # # # #   # # # #   #     #
# ### ####### # ### ### # ####### ##### ########### # ### # ##### ##### # ### # ##### # # ### # ### #
# #   #     #     #     # #       #     #           #   # #       #   # #   # #     #       #   #   #
# # ##### ########### ### # ########### # ############# # ######### # # ### # ##### # ####### ### # #
#   #   #       #   # #   # #   #     # #       #       #     #   # # #   #   # #   #   #   # #   # #
# ### # # ##### # # ### ### # # ### # # ####### # # ######### ### # # ### ##### # ### ### # ### ### #
# #   # #   #   # # #   # #   #     # #       # # # #   #   #     # #   # #   #   #   #   #   #   # #
# # ### ### # ### # # ### ########### # ##### # ### # # # # ##### # ### # # ### ### ### ##### ### # #
# #   #   # #   # #   #   #     #   # #   # # #   #   # # # #     #   # # #   # #   # # #     #   # #
# ### ### ##### # ##### # ### # # # # # # # # ### ##### # # # ####### # # # # # # ### # ### ### ### #
# #   # #     # #     # #     # # #   # # #   # # #     # #   #     # #   # #   # #   #   #     #   #
# # ### ##### # ##### # ####### # ##### # # ### # # ##### ##### ### # ##### ##### # # ### ####### ###
# # # #     #   #   # # #   #   # #   # # # #   # #         #   # # #   # # #       # #   #       # #
# # # # # # ### # # # # # # ##### ### # # # # # # ######### # ### # ### # # ####### ### # ##### ### #
# # #   # #   # # #   #   #     #   #   # # # # #         # #   #   #   # #     #   #   # #   #     #
# # ### # ##### # ##### ####### ### # ### # # # ######### ##### # ### ### ##### ##### ### # # #######
# #   # #   #   # #   #     #     # #   # # # #   #     #       #     #       #     #   # # #   #   #
# ### ##### # ### # # ##### # ### # ##### # ### # ### ################# ##### ##### # # ### ### # # #
#   # #   #     #   #   #   # #   #     # #     #     #     #     #   # #   #   #   # #     #   # # #
### # # # ######### ### # ### ######### # ####### ##### # # # # # # # ### # ### # ### ####### ### # #
# # # # #     #   #   # # #   #     #   # #   # # #   # # # # # # # #     #     # #         #     # #
# # # # ##### # # ##### # # # # ### # ### # # # # # # # # ### # # # ############# ######### ####### #
#   #   #   # # #     # # # # #   # # #   # # #   # # # #     # #   #     #     # #     # #   #     #
# ####### # # # ##### # # # ##### # # # ### # # ### # # ####### ### # ### # ### # # ### # # ### ### #
#       # #   #   # #   # #     # #   # #   # #   # #     #     #   # # #   # # #   #   #   #   #   #
####### # ####### # ######### # # ##### # ### ##### ####### ######### # ##### # ##### ### ### ### ###
#     #   #       #         # # # #     # # #     #   #   #   #       #       #     # #   #   # #   #
# ####### # ####### ##### # ### # ### # # # ##### # ### # ### # ######### ### ### ### # ### ### ### #
#   #     #   # #   #   # #   # #     # #   #   #   #   #     # #       #   # #   #   # #   #     # #
# # # ####### # # ### # # ### # ####### ### # # ##### ######### ##### # ##### # ### ##### ##### # # #
# #     #   # # #     # #   #   #     #   # # # #   #     #     #     #   #   #     #     #     # # #
######### # # # ####### ### ##### ### ### # # # # # ##### # ##### ####### # ######### ##### # ### # #
#     #   # # #   #   #   #       #     # #   # # #     #   #     #   #     #       #   # # # #   # #
# ### # ### # # # # # ### ######### ### # ##### ####### ####### ### # ####### ##### # # # # # ##### #
# # # #   # # # # # #   # #       #   # #     # #       #     #     #         #   #   # #   #       #
# # # ### # # # # # ### # # ### # ### # ##### # # ##### # ### ##### ########### # # ### # ###########
# # #     #   # # # #   # # #   # # # # #   # #   #   # # # # #   #   #   #     # # #   #   #     # #
# # ############# # # ### # # ### # # ### # # ####### # # # # # # ##### # # ##### # # ##### # ### # #
# #               # #     # # #   # #     # # #     # #   # #   #       # # #   # # #   # # #   #   #
# # ####### ##### # ######### # ### ####### # # ### # ##### ############# # # # # ### # # # # # ### #
# # # #   #     # # #   #   # # #     # #   # # # #   #   #             # # # # #   # # #   # # # # #
# # # # # ##### ### # # # # # # ### # # # # # # # ### # ### ######### ### # # ##### # # ### ### # # #
# #   # #     #       #   #   #     #   # # #   #   # #   #     #   #     # # #   # # #   #     #   #
# ### # ##### ############# ######### ### # ##### # # # # ##### # ######### # # # # # ### ####### ###
# #   #   #   #   # #       #   #     #   #   #   #   # #   #   #     #     #   # # # # #     # #   #
# ### ### # ### # # # ####### # ####### ### ### ####### # # # ##### # # ### ##### # # # ##### # ### #
#   # #   # #   # #   #       #       # #   #   # #     # # #   #   # #   #     # # #       # # #   #
# # ### ### # ### # ### ############# # ### # ### # ##### ##### # ### ### ##### # # ### ##### # # ###
# # #   #   # #   #   #     #         #   # #   #   #   # #     # #     # #     # #   # #     # # # #
# # # ### ### # ### ####### # ######### # # ### ##### # # # ##### ##### ### ##### ### ### ##### # # #
# #     #   # # #   #       #   #       # #   #       #   #     #     #   # #       #     #   #   # #
# ####### # # # ##### ######### ##### ### ############### ##### # ### ### # # ############### # ### #
#   #   # #   #     #       # # #   #   #         #     #     # #   # # #   # #               # #   #
##### # ########### ####### # # # # ### ####### ### # ####### # ##### # ##### # ####### ##### # # # #
#     #     #   #   #         #   #   #       #     # #       # #     #       # #     #   #   # # # #
# ######### # # # ### ############### ##### ######### # ####### # ##### ##### # ### # ### ##### ### #
#     # #   # # #     #             #   #   #   #   # #   #   #   #         # #   # #   #       #   #
# ### # # ### # ### ### ########### ### # ### # # # # ### # # ############### ### ### ########### # #
# # # #   #   #   #   #         # #   # #   # #   # #     # #                   #   #             # #
# # # # ### ##### ### ######### # ### # ### # ##### # ##### ##### ############# ### ######### # ### #
#   # # #   #   # #     #     # #   #   #   # #   # # #   # #   # #   #         # #         # # # # #
# ### # # ### ### # ##### ### # # ####### ### # ### ### # # # # # # # # ######### ######### ### # # #
# #   #   #   #   # #     # # # # #     # #   # #   #   # # # # # # #   #         #       #     # # #
### ####### # # ##### ##### # # # # ### # # ### # ### ### # # # # ##### ##### ##### # ### ####### # #
#   #     # # # #     #     #   #     #   # #   #     #   #   # #     #       #     #   #     #     #
# ### ### # # # ### ### ##### ####### ##### # ######### # ##### ##### ######### ####### ##### # #####
# #   # # # # #     #       # #     #   #   # #   #     #     #   #   #   #   #       #     # #     #
# # ### # # ######### ##### # # ### ##### ### # # # ######### ### # ### # # # ##### ##### # # ##### #
#   #   # #         # #   #   # # # #     #   # # #   #     #   # #   # #   #   #   #   # # # #   # #
# ### # # ####### # # # # ##### # # # ####### # # ### # ### ##### ### # ####### # ### # ### # # # # #
#   # # #     #   # #   # # #   # #   #     # # #     #   # #       # #   #   #     # #     # # # # #
### # # ##### # ######### # # ### ##### # # # # ######### # # ####### ### ### ####### ####### ### # #
#   # #     # # #   #       #         # # #   # #       # #   # #     # #       #     #     # #   # #
# ### ####### # # # # ##### ######### ### ### # # ### # # ##### # ### # ####### # ##### # # # # ### #
#   # #       #   #   #   #     #   #   # #   #   # # # #       # #   #     #   #     # # # # #   # #
### # # ####### ####### # ##### ### ### # # ####### # ##### ##### # ####### # ####### ### ### ### # #
# # # # #   #   #       #     #   # #   # #         #       #     #         #     #   #   #   #   # #
# # # # # # # ### ########### ### # # ### # ############# ### ########### ####### # ### ### ### # # #
# #   # # #     # #     # #   #     #     # #       #   #   #     #       #     # # #     #     # # #
# ### # ######### # ### # # # ##### ####### # ##### # # ### ##### ##### ### ### # # # ### # ##### # #
#     #         #   # #   # # #   # #       #   # #   #   #   #   #   # #     #   # # # #   #   # # #
# ########### # ##### ### # ### # ### ######### # ####### ##### # # # ### ######### # # ##### # ### #
#     # #   # #     #     #   # #   # #   #   # #       #       # # # #   # #       #   #   # #   # #
##### # # # ##### ### ####### # ### # # # # # # # ##### ### ####### # # ### # ######### # # # ### # #
# #   # # #     #   #   #     #   # # # #   # # #     #     #       # #     # #         # #   # #   #
# # ### # ##### ### ### # ####### # # # ##### # ##### ####### ####### ##### # ########### ##### #####
# #   # #   #         # #     #   #   # #     #     #     #   #     # #     #       #     #       # #
# ### # ### ########### ##### # ######### ### ##### ####### ### ### # # ########### # ####### ### # #
#         #                 #             #       #             #   #             #           #     #
#####################################################################################################
