###################################################################################################################################
# #     #             #     #           #             #                   #             #           #         #           # #     #
# # ### # ### ####### # ### # ##### ### ### ##### # ### ############# # ### # ########### ### ##### ##### ### ####### ### # # # # #
# #   # # # #     # # #   #     #   # #   #   #   # #   #         #   # #   #               # #   # #     # # #       #   #   # # #
# ### # # # ##### # # ##### ##### ### ### ### # ##### ### ##### # # ### # ################### # ### # ##### # # ####### ####### # #
#     # #   #   # #   #   # #     #   # #   # #     #   # #     # #   # # #   # #       #     #   # #   #   #   #     #   #     # #
####### ### ### # # ### # ### ##### # # ### ### ### ### ### ##### ### ### # # # # ##### # ####### # ### ### ##### # ##### # ##### #
#       #       # #     # #   #     #     #   #   #   # #   # #   #   #   # # #   #   # # #     #       #   #     #     #   #   # #
# ####### ####### ####### # ### ### ######### ### ### # # ### # ### ### ### # ##### # # # # ### ######### ### ####### ####### ### #
# #   #   #   #   #   #     #     # #         # # #   #   #   # # #     #   #       # # # #   #     # #     #     # #     #   #   #
# ### # ### # # ### # ########### # # ######### # # ####### # # # ####### ########### # # ### ##### # # ### ##### # ##### # # # ###
#   #     # #   #   #   #       # # # #           #   #   # #   #     #   #   #       # #   # #   # #     #   # #     # # # # #   #
### # ##### ##### ##### # ##### # # # ######### ##### # # # ####### # # ### ### ##### # # # # # ### ### ### # # ##### # # # # ### #
#   # #   #     # #   # #     # # # #     #   #     #   # # #       # # #       #   #   # # # #   #   # #   #       #   #   #     #
# ### # # # ### # # # # ##### # # # ##### # # ##### ##### # # ####### # # ####### # ### # # # ### ### # # ##### ####### ###########
# # # # # #   # #   # #   #   # # #   # # # # #     # #   # #   # #   # #   #     #   # # # #   #   # # # #     #   #   #         #
# # # # # ##### ##### ### # ### # ### # # # # # ##### # ### # # # # ### ##### ####### ### ##### # ### # # ####### # # ### ##### # #
# #   # #     # #       #   #   #   #   #   # #   #   # #   # # #     #     # #     #   #     #   #   # #     #   #   #   #   # # #
# ##### ##### # # ########### ### # ### ##### ### # ### # ##### ##### ##### # ### ##### # # ##### # ### ##### # ####### ### ### # #
# #     # #   #     #   #     #   # # #   # #   #   #   #     #     # #     #   #       # # #     # #     #   #     #     # #   # #
# # ##### # ##### ### # # ######### # ### # ### ### # # ##### # ### # # ### ### ####### ### # ##### ##### # ####### ##### # # ### #
# # #     #     # #   #   #         # #   #   #   # # # #   # # # # #   #     #       #   # #     #     # #           #   # # #   #
# # # ######### ### ########### ##### # ### ##### # # # # # # # # # ######### ####### ### # ### ####### ############# ### # # #####
# # # #       # #   #           #     # #   #     # # #   # # #   #       # # #     # #   #   # #   #   #   #     # #   #   #     #
# # # # # ##### # ##### ########### # # ### # ####### ##### # ########### # # # ### # # ### ### # # # # # # # ### # ### ### ##### #
#   #   #     #   #   #   #     #   # # #   # #       #   # # #       #   # # #   #   # #   #   # #   # # # # # # #   # #   # #   #
##### ####### ##### # ### # # # # ### # # ### # ####### # # # # ##### # ### # ### ##### # # # ### ##### # # # # # ### # # ### # ###
#   #   #   #       #     # # #   #   # # #   #   #     # # # #     # # #     #   #   # # # #   #     # # #     #   #   #     #   #
# ##### # # # ############# # ######### # # ### # # ##### ### ##### # # # ##### ##### # # # ### ##### # # ######### # ########### #
#     # # # # #   #         #             # # # # #     #     #     # # # #     #     # # # #   # #   # #   #     # # #         # #
##### # ### # # # ################### ##### # # # ##### ####### ##### # ### ####### ### # # # ### # ####### # ### # # # ####### # #
#   # # #   #   #   #     #         # # #   #   #       #       #       #   #       #   # #     # #       # # #   # # #   #   #   #
# # # # # # ####### # ### # ####### # # # ### ######### ### # ######### # ### # ### # ######### # ####### # # ### # # ### # ##### #
# #   #   #   #   #   # #   # #     #   # #       #   #     # #     #   # # # # #   #   #     #         #   #   # # # #   #   #   #
# # ######### # ####### ##### # ### ##### ### ##### # ##### ### ### # ### # # # ####### # ### # ############### # # # # ##### # ###
# # #         #     #         #   # #   #   # #     #     # #   # # # #   # # # #     #   #   # #   #     #   # #   #   #     #   #
# ### ######### # # # ##### ##### ### # ### ### ######### ### ### # ### ### # # # ### ##### ### # # # ### # # # ########### ##### #
#   # #       # # # #   # #     #     #   #   #   #   #   #   #   #     #   # #   #       #   # # # #   #   #   #           #     #
# # # # ####### # ##### # ##### ####### # ### # # # ### ### ### # ####### # # ##### ##### ### ### # ### ######### ####### ### #####
# #   # #     # #   #   # #   #       # #   # # # #     # #   # #       # # # #   #   #   #   #   # #   #               # #   #   #
# ##### # ### # ### # ### # # # ##### # ### # ### # ##### # # ### # ### # # # # # ### ##### ### ### # ################# # # ### # #
#     # # # #   # #   #   # #   #     # #   #     #     # # #   # # #   # #   # #   # #   # #     # #             #   # # # # # # #
##### # # # ##### ##### # # ##### ##### # ############# # # ### ### # ### ####### # # # # # ##### # ### ######### # # ### # # # # #
# #   #   #         #   # #   #   # #   # #   #       # # # # #   # # #   #     # # #   # # #     #   #     # #   # #   #   #   # #
# # ##### # # ##### # ##### # # ### # ##### # # ##### # # # # ### # # # ### ### ### ##### # # ####### ##### # # # # ### # ####### #
# #     # # #   # #   #   # # #     # #     #   #   #   #     # # # # # #   #   #   #   # #   #     # #   # # # # #   # #     #   #
# ##### # ##### # # ### # # # ##### # # ######### ########### # # # ### # ### ### # ### # ##### # ### # ### # # # ### # ##### # # #
#     # #       #   #   # # # #     #   #   #     #       # # # # #     #   #     #     #       #   # # #   # # # #   #     # # # #
##### # ######### ### ### ### # ######### # # ### # ### # # # # # ### ### # # ######### ########### # # # ### # ### ####### # # ###
#     #       # #   #   #   # #     #   # #   # #     # # # #   #   # #   # # #       # #         #   #   #   # #   #     # # #   #
# ### ####### # ### ### ### # ##### # # # ##### ####### # # ### ### # ##### ### ##### ### ##### # ##### ### ### # ### ##### # ### #
#   #     #   #     # # # #   #   # # #   #       # #   # #     #   #     #   # #   # #   #   # #     # #     # #     #     #   # #
# # ### ### ### ##### # # ##### # # # ##### # ### # # ### # ##### ####### ### # # # # # ### # # ####### # ### # ### ### ####### # #
# #   # #   #   #   # # #     # #   # #   # # # #   # # # # # #   #   # #   #     # #   #   # # #   #   # #   #   # #   #   #     #
##### ### ##### # # # # # ### # ##### # # ### # ### # # # # # # ### # # ### ########### ##### # # # # ### # ### ### # ### # #######
#   #   #     #   #   # # #   #   #     #   # #     # #   #   #   # #     #           #     # #   #   #   #   #     # #   #       #
# # ### ##### ####### # ### # ### ######### # ##### # ### # ##### # ################# ##### # ############### ####### # ######### #
# #   # #     #   #   #   # #   #     #   # #     # #   # # #     #   #       #     #     #   #                     # # #     #   #
# ### # # ##### ### ##### # # ####### # # # # ### ##### # ### ##### # # ##### # # ####### ### # ############### ##### # ### # # # #
#   #   #   #   #   #   # # # #       # #   #   # #   # # #   #   # #   #     # #       #   #   #   #           #   #       # # # #
# # ### ### # # # ### ### # # # ####### ####### # # # # # # ### # # ##### ##### ####### ### ##### # # ########### # ########### # #
# # #     # # #       #   # # # #     # #   #   #   # # #   #   # # #   #     #       # #   #     # #   # #   #   #       #   # # #
# # ####### # ######### ### # # # ### # ### # ##### # # ##### # ### # ####### ####### # # ####### ##### # # # # ######### # # # # #
# #         # #         #   # #   # # #   #   #   # # # #     # #   #     # #   #     #   #       #   # #   # #   #         # # # #
# ########### # ########### # ##### # ### ##### # ### # ##### # # ##### # # # ### ######### # ### # # # # ### ### ### ####### # ###
# #       #   #         #   # #       # #       #     #     # # #       #   # #   #     # # # #   # # # # #     #   # #   #   #   #
# # ##### # ########### # # ### ####### ##### ######### ### # ########### ### # ##### # # # # # ### # # ### ### ### # # # # ### # #
# #   # # # #           # # #   #     # #     #       # # # #       #   # #   #       # #   # # #   # # #   # #   # # # # #   # # #
# ### # # ### ########### ### ### # # # # ##### ##### # # # ### # ### # # # ########### ##### # # ### # # ### ### # # # # ### # # #
#     #   #   #     #     #   # # # # # #     #   #   #   #   # # #   #   #       #     #   # # #   # # # #     # # # # # # # # # #
####### ### ### ### # # # # ### # # # # ##### ### # ##### ### # ### ############# # ##### # # ##### # # # ##### # # ### # # # ### #
#     # # #   #   #   # # #   # # # #   #   # # # # #   #   # #   #   #     #   # # #   # #   #     # # # #   #   #     # # #     #
# # # # # # # ######### # ### # # # ### # # # # # # # # ##### # # ### # # # ### # # # # # ##### ##### # # # # ####### ### # ##### #
# # # # # # #     #   # # #   #   #   #   # # # # #   #   #   # #     # # #     # # # # # #     #   #   # # #       #   # # #     #
# # ### # # ##### # # # # # ####### # ##### # # # ####### # ### ######### ####### # # # # # ##### # ##### # ####### ##### # # #####
# # #   #   #   # # # # # # #     # #   #   #   # # #       # #     #   #       #   # #   #   #   # #     # #     #     # #       #
# # # ### ### # # # # # ### # ### ### # ### # ### # # ####### ##### # # # ##### ##### ####### # ### # ##### # # ####### # #########
# # # # # #   # # # # #   # #   #   # #   # # #   #   #   #     # #   # #   # # #   #         #   # # #     # # #         #       #
# # # # # ### # # # # # # # # # ### ##### # # # ####### # ### # # ##### ### # # # # # ######### # # # # ##### # # ######### ##### #
# #   #       # #   # # #   # #   # #     # # #         #   # #     #   # #   #   #   #     #   # #   #     # #   #         #   # #
# ####### ######### # # ######### # # ####### ############# # ####### ### ### ######### ### ##### ### ##### # ##### ######### ### #
# #     # #       # # #   #       #   #             # #     #   #     #     #   #     #   #     # #       # #   # # #     #   #   #
# # ### # # ##### ### ### # ########### ########### # # ##### # # ##### ####### # # ### # ##### # # ####### ### # # ### # # # # # #
#   #   # # #   #   # #   #       #     # #       #   # #   # # # #   #       # # #     #   # #   #   #     # #   #     #   # # # #
##### ### # # ##### # # ### ##### # ##### # ##### ##### ### # # # # # ##### ### ########### # ####### # ##### # ####### ####### # #
#   #   # # #       # # # #   # # # #     #   #         #   # # #   # #   #   #   #     #   # #       #     #   #       #     # # #
# ##### ### ##### ### # # ### # # # ### ##### ########### ### # ##### # # ### ### # ### # ### # ########### ### # ####### ### # # #
#       #   #   #     # #       # #   #     #   #       #     #     #   #   #       #   #   # #   #       #   # # #       #   # # #
# ####### ### # ####### ##### ### ### ##### ### # ####### ##### # ######### ########### ### # # ### ##### ### ### # ####### ### ###
#       #     # #     #     # #     #       # # #     #   # #   # #   #     #   #     #     # # #   #   #   #     # #     #   #   #
####### # ##### ### # ##### ### # ######### # # # ### # ### # ##### # # ##### # # ### ####### # # ### # ### ####### ### # ### ### #
#   #   #     #   # #     #   # # #     #   # # #   #       #     # #   #     #   # #   #       #   # #   #   #   #   # #   #   # #
# # # ########### # ##### ### # ### ### # ### # ### ############# # ##### ######### ### # ######### ### ##### # # ### ### # ### # #
# # #   #   #   # #     # # # #       # #     # # # #   #         # #     # #           #   #     #   #     #   #     #   #   #   #
### ### # # # # # ##### # # # # ####### # ##### # # # ### ####### # # ##### # ############# # ### ### # # ############# ######### #
#   #   # #   #   #     #   # #     #   # #     #     #   # #   # # #   #   # # #       #   # #   # # # #       #             #   #
# ### ### ######### ######### ##### # ### # ########### ### # # # # ### ### # # # # ### ### ### # # # ### ##### # ##### ##### # ###
#     #       #     #         #   # #     # #           #     #   #     #   # #   #   #   #   # #   #   #     #   #   # #   #     #
# ##### ##### ##### # ########### # ####### # ########### ############### # # ####### ### ### # ### ### ########### # ### # ##### #
#     #     #   #   # #           #       # #       #       #             # #   #   #   #   # # # #   #             # #   #     # #
##### ##### ### # ### # # ######### ####### # ##### ####### ############# # ### # # ### ### # # # ### ############### # ####### # #
#   #   #     # #     # #           #       # #   #     # #     #         #   #   #     # # # # #   # #   #       #   #     #   # #
### ### ##### # ### ##### ######### # ######### # ### # # ##### # ########### ########### # # # ### # # # # # ### # ####### # #####
#     #     # #   #     #     #   # # # #       #   # # # #     # #   #   #   #         #   #   #   # # #   #   # #     #   #     #
# ######### # ### ##### ####### # ### # # ### ##### ### # # ##### # # # # # ### ### ### # ####### ### ######### ####### # ####### #
# #     #   # # #     #         #   # #   # #     #     # #   #   # #   # #   #   #   # #     #         #     # #     # # #   #   #
# # ### # ### # ##### ############# # # ### ##### ####### ### # # # ##### ### ### ### ####### ######### # ### # # # ### # # # # ###
# #   #   #   #     # #   #       # # #   #     # # #       # # # #   # #     # # # #     # #         #   #   #   #   # #   # #   #
# ### ##### ### ### # # # # ### ### # ### # ### # # # # ### # ### ### # ####### # # ### # # ######### ##### ######### # ##### ### #
#   #     #   # #   #   # # # # #   # # # # #   # #   # #   #     # #   #     #   # #   #   #       #   # #           # #     # # #
# ####### ### # # ####### # # # # ### # # # ### # # ### ########### ### ### # ### # # ##### ##### ##### # ######### ### # ##### # #
#     #   # #   # #     # # # #   #   #   #   # # # # #     #       #   #   #   #   # # #   #   # #     #         # #   #     # # #
# ### # ### ##### ### ### # # ##### # # ##### ### # # ##### # ##### # ### ##### ##### # # ### # # # ##### ######### # ####### # # #
#   #   #         #   #   # #       # #     # #   # #     #   #   # # #   #           #   #   #   #   # #   #       #       #   # #
### ##### ######### # # ### ######### ##### # # ### ### # ##### # # # ### ############# ##### # ##### # # # # ######### ##### ### #
#   #       #   #   # #   #           #       # #       #   #   # #   #   #           #       # #     #   #   #   #   #       #   #
# ### ##### # # ### ##### ############# ####### # ######### # ### ##### ### ######### ######### # ##### ####### # # # # ####### # #
# #   #   #   #   #     #   #         #   #   # #   #     #   # # #       #   #   #   #       # #     # #     # #   # #   # #   # #
# ##### # ####### ##### ### # ####### ##### # # ### # ### ##### # ####### ### ### # ### ##### # ##### ### ### # ##### ### # # ### #
#       #     #       #   #   #     # #     #   #   # # #   #   # #     #   #     #   # #   # # #   #     #   # #     #   # #   # #
############# ####### ### ####### # # # ############# # ### # # # # ### # # ##### ### # ### # # # # ####### ### # ##### ### ### ###
# #       # #     # #   #         # # #         #   #   #   # #     #     #     #   # #     # # # #         #   #   #   #     #   #
# # # ### # ##### # ### ### ####### # ####### # # # ### # ######################### # ##### # ### ########### ##### ### # ### ### #
#   # # #     #   #       # # #     #       # #   #   # #       #         #         #     # #     #         # #   #   #   #     # #
# ### # ##### # ######### # # # ########### # ####### # ####### # ####### # ######### ##### ############# # # # # ### ######### # #
# # # #       # #     #     # # # #     #   # # #   #   #     # # #   # # #     # #   #     #             #   # #   #   #     # # #
# # # ##### ### ### # ####### # # # ### # ### # # # ####### # # # # # # # ##### # # ### ####### # ############# ### ### # ### ### #
#   # #   #   #     # #   #       # # #   # # #   #       # # # #   # # #   #   # #   #   #   # # #   #       # # #   # #   #     #
### # # # ########### # # ######### # ##### # ####### ### # # # ##### # ### # ### ### ### # # ### # # # ### ### # # ### ### ##### #
#   #   #               #           #                 #     # #           #         #       #     # #     #       #         #     #
###################################################################################################################################
