#######################################################################################################################################################
#       #   #           #   #                 #     #       #             #       #       #   #   #   #         #         #         #       #     #   #
####### ### # # ####### # ### ########### ### # # # # ##### ########### # ### ##### ### # # # # # ### # ####### # ### ### # ####### ##### # ### # # # #
#       #   # #   #       #   #     #   #   # # # #   #               # #     #     #   #   #   #     # # #     # # #   #   #     #       #   # # # # #
# ####### ### ### ### ##### ### ##### # ### # ### ##### ############# # ####### ##### # ############# # # # ### # # ### ##### ### ########### # # # # #
# #       #   # #   # #   #   #     # #     # #   #       #   # #     #     #   # #   # #     # #     # # # #   # # #   #       # #       #   # #   # #
# # ##### # ### ### # # # ### # ### # ####### # # ######### # # # ######### # ### # ##### ### # # ##### # # ##### # # ### ##### ### ##### # ######### #
# # #     #     #   # # # #   #   # #       #   # #   #     # #     #       # #   #     #   # #     # #   #         # # # #   #   # #   #         #   #
# ### ### # ##### ##### # # ##### # ####### ####### # # ##### ##### # ##### # # # ##### ### # ##### # ### ########### # # # # ### # # # ######### # # #
#   # #   # #     #   # # # #   # #       #         #   #   #     #   # #   # # #     #     #     #   #   #     #   # #   # #   # # # #     #   # # # #
### # # ### # ##### # # # # # # # ##### ################# # ##### ##### # ### # ### # ########### ### # ####### # # # # ### ### # # # ##### # ### # # #
# # # # #   # #     # # #   # #       #             #   # #     # #   # # #   # #   #     #     #   # #   #     # #   # # # # # #   #   # # #     # # #
# # # ### ### # ##### # ############# ### ######### # # # ##### # # # # # # ##### ####### ### ##### ##### # ##### ##### # # # # ####### # # ### ### ###
#   #       #   #   # #         #   # # #   #     #   # # #   # #   # # # #       #     #     #     #   #   #     #       #   #   #       #   #   #   #
# ######### ####### # ######### # ### # ### ##### ##### ### # # ##### # # ############# ##### # ### # # ### # ### ########### ### # ######### ### ### #
#       #     #     #   #     # #       #   #         #     #   #   # # #   #   #       #   # # #   # #   # # # # #   #     # # # #     #     # #     #
####### ##### # # ##### # ### # ####### # ### ############### ### # # # ### ### # # ##### # # # ##### # ### # # # # # # ### # # # ##### # ##### ##### #
#     #   #     # #     #   #   #   #   # #           #       #   #   #     #   # #     # # # # #     # #   # #   # #   # # # # #     # # #   #       #
# ####### ####### # ### ### ##### # ##### # ######### # ####### ####### ##### # # ##### # # # # # ##### # ### # ### ##### # # # ##### # # # # ### #####
#         #     # #   #   # #     #       #   #     # #   #   #     #   #     # #     #   #   #       # # # # # #   #     # #   #   #   # # #   # #   #
# ######### ### # ### ### # ### ############# ##### # ### # ####### # ### ##### ##### ################# # # # # # ### ##### ### # ####### # ### # ### #
# #       # #   #   #   # #     #   #       #   #   #   # #       # #   # # #   #   # #           #     #   # # # # #     #     #       #   #   # #   #
# ### ### # # ######### # ####### # # ##### ### # # ### # # ### # # ### # # # ### ### # ##### ### # ####### # ### # # ### ######### ### ##### ### # # #
#     # #   #     #     # #     # # # # #     # # # # #   # #   # # #   # #   #     # # #   #   # #       # #     #     #         # #   #   #   #   # #
####### ######### # ##### # ### ### # # # ##### # # # ####### # ### # ### # ### ### # # ### ### # ####### # ########### # ####### ### ### # ### ##### #
#   #     #     # #   #     #       # # #       # #         # # #   #     #   # #   # #   # #   # #     # #     #   #   # #     #     #   #     #   # #
# # # # ### ### # ### ############### # ######### ######### # ### ########### ### # # ### # # ##### ### # ##### # # # ### # ######### # ######### # # #
# # # #     # # #   # #     #       #     #       #   #   #   #   #   #           # # #     # #     #   # #     # # # #   # #       # #     #     #   #
# ### ####### # ### # # ### # ##### ##### ### ##### # # # ##### # # # ### ######### # ####### # ##### # # # ##### # ### ### # ### ### ##### # #########
# #   #       #     #     #   # #   #   #   # #     #   # #     # # #   # #     #   #   #   #     #   # #   #     #   # #       #     #     #       # #
# # ### ##### ####### ##### ### # # # ##### # # ######### # ####### ### ### ### ####### # # ##### # ######### # ##### # # ####### ##### ########### # #
# #   # #   #     # # #   #   # # #   #     # #       #   #     #   # #   # # #       #   #     # #           #   # # # # #     # #     #     #   # # #
# ### # # # ##### # # # # ### # # ### # ##### ####### # ####### # ### ### # # ####### ######### ### ######### ### # # # ### ### ### ##### # ### # # # #
#   # # # #       #   # #   # # # #   # #   #     #   # #       #   #   #           #   #     #   # #       #   # #   #   # # #   #   #   # #   #   # #
### # # ##### ######### ### # # # # ### # # ##### # ### ### ### ### ### ############# # ##### ### ### ##### ##### # ##### # # ### # # # # ### ####### #
#   # #     #           #   #   # #   # # #       # #       #     #   #   #           #   #     #   # #   #       # #     # #     # # # # #   #       #
# ### ##### ############# ##### # ##### # ####### # ####### ######### ### # ############# # ### ### # ### ######### # ### # # ####### # # # ####### # #
# #   #     #   #       #     # #     #   # #     #     #   #       # #   # #     #       #   #   # #   #     #   # #   # # #   #     # # # #     # # #
# # ### ##### ### # ######### # ##### ##### # ######### ##### ### ### # ### # ### ### ####### ### # # # ### # # # # ### # # ### # # ##### # # ### ### #
# # #     #   #   #         # # #   #       #   #     #         #     #   # #   #   #     #   #   # # # #   # # #     # # # # # # #     # # #   #     #
# # ##### # ### ####### ##### ### # # ##### ### # ##### ####### ######### # # ##### ##### # ##### # ### # ##### ##### # ### # # # ##### # # ### ##### #
# #   #   #   #     #   #   # #   # #     #   # # #   #   #   # #         #   #   # #     # #   # #     # #     #   #   #   #   # #     #   #   #   # #
# ### # ### # ### ### ### # # # ### ##### ### # # # # ##### # # ### # ### ##### # # # ##### # # ######### # ##### # ### # ### ##### ##### ### ### # # #
#   #   #   #     #   #   #   #   #     #   # #   # # #     # #   # # #   #   # #   #       # # #         # # #   # #   # #       # #   #     #   # # #
# # ##### ######### # # ######### ##### ### ### ### # # ##### ### ### # ##### # ##### ####### # # ####### # # # ### ##### ####### # # # ######### ### #
# #     #     #     # #     #     #   #   #     #   #   #   # # #   # #       #   #   #       #   #     #   # # #       #   #   # # # #   #       #   #
# ##### ##### # ########### # ####### ### # ##### ####### # # # ### # ####### ### ##### ########### ### ##### # ####### ### # # # # # ### # ### # # ###
#   # # # #   # #         #   #         # #     #   #   # #   #     # #       # # #   #     #   #   #   #     #   #         # # #   #   #   # # # # # #
### # # # # ### # ##### # ##### # ##### # # ##### # # ### ##### ##### # ####### # # # ##### ### # ### ### ### ### ########### # ####### ##### # # # # #
#   # #   # # #   #     # #     # #     # # #   # # #     #     #     # #       #   #     #   # # # #   #   #   #       #   # #   #     #     # # #   #
# ### ### # # ##### ### ### ##### ##### # # # # ### # ##### ####### ### # ### ####### # ##### # # # ### ### ### ####### # # # ### # ##### ### # ##### #
#   #     #   #   #   # #   #   #     # # # # #     #   #         #   # #   #       # # #     # #   # #     #         #   # # #   #   #   #   #     # #
# # # ####### # # ### ### ##### ##### # # ### ######### ######### # # # ### ##### ### ### ##### ### # ####### ##### ####### # # ##### ##### # ##### # #
# # #   #       #   # #   #         # # #     #       #   #   #   # # #   #     #   #     #       #   #     # #     #       # #       #     #     #   #
### # ### ########### # ### # ####### ######### ### # ### ### # ##### ### ##### ### ####### ##### ### ##### # # ##### ####### ####### # ##### #########
#   # #       #       # #   # #     #         #   # # #   #   #   #   # #   # #   #       #   # #   # #   # # # #     #   #   #     #   #     #   #   #
# ##### ####### ####### ##### # ### ######### ### # ### ### # ### # ### ### # ### # ##### ### # # ### # # # # ### ####### # ### ### ##### ##### # # # #
#       #     # #     # #   # #   #   #         # #   # #   # #   # #       #     # #   #   #   #     # #   # #   #     # #   # # #   #   #     #   # #
# ####### ### # # ### # # # # # ### # # ######### ### # ### # # ### # ####### ##### # # ### ##### ##### ### # # ### ### # ### # # ### ##### ######### #
#     # # #     # #   #   # # # #   # #     #       # #   # # #     # #   #   #   # # #   #     #       #   # #     #   # #   #   # #     # # #       #
##### # # # ##### # ####### # # # ### ##### # ####### ### # ######### # ### ##### # # ### ##### ######### ### ####### ### # ##### # ##### # # # ##### #
#   #   # # #     # #   #   #   # #     #   # # #     #   #     #     #   #       #   # # #   #     #   #   #   # #   #   # # #   #     #     #   #   #
# # # ### # # ##### # # # ### ### # ##### # # # # ### # ##### # # ##### # ####### ##### # # # ##### # # ### # # # # ##### # # # ### ### ######### # ###
# #   #   # #     # # #   #   #   #   #   # #   # #   # #   # #   #   # #       # #     #   #   #   # # #   # #   # #     # # #   # # #   #       # # #
# ##### ##### ##### # ##### ### ##### # ####### # ##### # # # ####### # ##### ### # ### ####### # ##### # ### # ### # # ### # ### # # # ### ####### # #
#   # #       #     # #   # #   #   # # #       #     #   # #   #     #     # #   # # #     #   #     #   #   # #   # #     #   # # #   #   # #   # # #
### # ######### ##### # ### # ### # # # # ########### ##### ### # ##### ##### # ### # ##### # ####### ##### ### # ### ####### # # # # ### ### # # # # #
#   #         #     # # #   # # # #   #   #   #       # #   #   #       #   #       #       #   #   # #     # # # # # #       # # # # #   #   # # #   #
# ########### ##### # # # ### # # ######### ### ##### # # ### ####### ### # ######### ######### # # # # ##### # # # # ### ##### # # ### ### # # # ### #
#                 #   #   # # # #   #     #   #   #   # # # #       # #   #       #     #       # # # # #     # # #     # #     # # #   #   # # #   # #
################# ##### ### # # ### # # ### # ### # ### # # ####### ### ######### ####### ######### # # # # ### # ##### ### ### # # # ### ### # # ### #
#     #         #   # # #   # #   # # # #   # #   #     # #       #     # #   #   #   #   #     #   #   # #     # #   #     #   # # # #     # # #     #
# ##### # # ####### # # # ### # ### # ### ### # ####### # # ##### ####### # # # ### # # ### ### # # ##### ####### # # ##### ##### # # ####### # #######
#     # # # #       #     #   #     #     #   # #   #   # #   # # # #       # #     # # #   # #   #   #   #     #   #   #   #       # #     # # #     #
##### # # ### ############# ### ##### ##### ### # # ##### ### # # # # ####### ####### # # # # # ####### ### ### ####### # ### ####### # ### # # # ### #
#     # # #   #         #   # # #         #   #   #       #   #   # #       #   #     # # # #   #     # #   #     #     # #   #   #   # #   # # #   # #
# ##### # # ### ####### # ### # ####### ##### ############# ### ### ####### # # # ##### # # ##### ### # ##### ##### ####### ### # # ### ### # # ##### #
#       # #   #   #     #   # #     # # #   #         #   #   #     #   #   # # # #   # # #     # # # # #     #     #           # # # #   #   #       #
######### ### ### ##### ### # ##### # # # # ####### # # # # # ##### # # # ### # # # # # # ##### # # # # # ### # ### # ############# # # # ### ####### #
#       #   #   #     #   # # #     #   # #         # # # # #     #   # #   # # #   #   # #     #   #   # #   #   # #   #   #       #   #   #     #   #
# ##### ### ### ### # ### # # # ##### ### ########### ### # ##### ##### ### # ############# ### ### ##### ### ### ##### # # # ####### ##### ### ### ###
#     # #     #   # # # # # # #     #   #       #     #   # #     #   # #   #     #         #     # #       #   #     # # # #     #     #   #   #   # #
# ### # # ####### ### # # # # ##### # ######### # ##### # # # ### # # # # ##### # # # # ##### ##### ##### # ######### # ### ##### ####### ####### ### #
#   # #   #     #     #   # # #     # #   #     # #   # # # # #   # # # #   # # # # # # #   # #     #   # #         #       #   # #     # #       #   #
### # ##### # ######### ### # # ##### # # # ##### # # # ### # ##### # ##### # # ### # ### # ### ##### # # ######### ####### # ### # ### # # ####### ###
#   #       # #     #   #   #     #   # #   #       #   #   #       #       # #     #   # # #   #     # #   #   #   #   #     #   # # # # #   #       #
# ########### # # # # ### # ##### ### # ##### ########### ################### ######### # # # ##### ### ### # # # ### # ####### ### # # # ### ####### #
# #   #     #   # # # #   #     #   # #   #     #     #   #   #               #       #   #   #     #     #   # # #   #         #     # # #   #     # #
# # # ##### ##### # # ### ##### ### ##### ####### ### # ##### # ####### ##### ### ### ######### ######### ### ### # ########### # ##### # # ### ### # #
#   #   #   #     # #   # #     #   #   # #       # #   #   #         # #   #     # #   #       #       # #   #   # #     #     # # #   #       # #   #
####### # ### # ####### ### ##### ### # # # ####### ##### # ########### ### ####### ### ##### ### ##### # # ### # # # ### # ##### # # ########### ### #
#   #   # #   # #     #   #   # #     # # #     #         #             #   #         #     #     #   # # #   # # # # # # #     #   #       # #     # #
### # ### # ### # ### ### ### # ####### # ##### ### ##################### # ######### ##### # ##### # # # ### # ### # # # ### ### ######### # # # ### #
#   #     #   # # #     #     # #       #     #   #       #       #       #               # # #     # # #   # #   #   # #   # #   #         # # #     #
# ####### ### ### # # ######### # ########### ### ####### ### ##### ##### ########### ##### # ####### # ### ##### ##### ### # # ### ######### # #######
#         # # #   # # #       #   #         #           #   #       #   #     # #     #   # #   #   # # # #       #     # # # # #   #   #     # #     #
# ######### # # ### ### ##### # ####### ### ########### ### # ######### ##### # # ##### # # ### # # # # # ####### # # # # # ### # ### # # # # # # # ###
# #       # #     #   #   #   #         # # #     #     #   # #   #       # # #   #     #   # # # #   # #         # # #   #     # #   # # # # # # #   #
# # ##### # ######### ### # ############# # # ### # ##### ### # # # ##### # # # ### ######### # # ##### # ######### # ########### # ### # # ### # ### #
#   #   #   #       #   # #       #       #   # # # #     # # # # # #     # # #   # #   #         #   # # #   #   # #         # #   #   # #   # #   # #
##### # ### # ##### # # # ##### ### ##### ##### # # # ##### # # # # # ##### # ##### # # # ######### # # ### # # # # ####### # # ##### ### ### # ##### #
# #   # #   #     #   # #   # # #   #   #       # # #     # #   #   #     # #     # # #   #   #     # #     #   #   #   #   #   #     # # #   #       #
# # ### # ####### ######### # # # ### ######### # # ##### # ############# # ##### # ### ### # # ##### ### ########### ### ##### # ##### # # # ####### #
#   #   # #     #     #     # #   #       #   #   #       #   #         #   # #   #   # #   #   #   #   #   # #       #   #   # #     # # # #   #   # #
# ### # # ### # ##### # ##### ######### # ### ############# # ### # ####### # # ##### ### ####### # ### ### # # # ### # ### ### ##### # # # ### # # # #
# #   # #     # #   #   #             # #   #   #   #       #     # #         #     # #   #       # #   #   #   #   # #   #     # #   #   # #     # # #
### ### ####### # ####### ### ####### # ### # # # ### ##### ##### ### ########### # # # ##### ##### # ### ####### # # ### # ##### # ####### ######### #
#   #         # #     #   # # #     #   # #   # # #   #   #   # # #   # #         # # # #   #     # #   #   #   # # #   # #   #   # #     #     #     #
# ### ####### # # ### # ### # # # # ##### ##### # # ### # ### # # # ### # # ######### # # # ##### # ### ### # # ### # ### ### ### # # ### ### # # #####
#   #   #   # # # # # #     # # # #     #     # #     # # #   # # # #   # # #         # # #       #   # # #   #     # #   # #   # # # # #   # # #   # #
### ##### # ### # # # ### ### # # ### ### # # # ##### ### # ### # # ### # ### ######### # ########### # # ####### ##### ### ### # # # # ### # # ### # #
#   #   # # #   #   #   # #   # #   # #   # # #   # #   # #   #   #   # #     #   #     #   #       # # #         #     # #   #   #   #   # # #     # #
# # # # # # # ##### # ### # ####### # # ### ##### # ### # ### ####### # ####### ### ### ### # ##### ### ##### ##### ##### # # ### ####### # ### ##### #
# # # #   #   #     #     # #     # # # #   #   # #   #     #       #   #       #   #   #   #   # #     #   #   #   #       # #           #   #     # #
# ### ################# ### # ### # ### # # # # # # ### ########### ### # # ##### ### ### ##### # ####### # ##### ########### # ############# ##### # #
#   # #     #   #     # # #   #   # #   # # # #   #   # #           #   # #       #   #         #       # #     # #   #     #     #           #     # #
# # # # ### # # # ### # # ##### ### # ### ### ##### # # # ######### # ######### ### ##### ####### ##### # ##### # # # # ### ####### ########### ##### #
# #   #   #   #   #   # #     #   # #   #   # #     #   # #     #   # #   #   #   #     # #       #     #     #   # #   # # #     #   #       #       #
# ####### ######### ### # # ##### # ### ### # # ######### # ### ##### # # # # ######### # # ### ####### ##### ### # ##### # # ### ### # ##### ####### #
# # #     # #     #   #   # #     #   # # #   #         #     # #     # #   # #         #   #   #     #   #   #   # #     #   # #     # #   #       # #
# # # # ### # # # ### ### ### ##### ### # ##################### # ##### ##### # ######### ####### ### ### # # ##### # ### ##### ####### ### ##### # # #
# #   # #   # # #   # #   #   #       #   # #         #   #     #     #   # # # #         #       # #   #   # #     # #     #   #     #     #     # # #
# ##### # # # # ##### # ### ######### ### # # # ##### # # # ######### # # # # # ##### ##### ####### ### ####### ##### # ### # # # ### ##### # ####### #
#       # #   #       # #   #     #   #   #   #   # #   #   #         # # # # # #   # #   # #   # #   #   #     # #   #   #   #   # #   #   # #       #
######### ############### ### ### # ### ####### # # ####### # ########### # # # # # # ### # # # # # # ### # ##### # ##### ######### ### # ### # #######
#   # #   #       #       #   #   #   #       # # #     #   #   #   #     # # # # # #     #   # #   #   #   #     # # #   #   #       # #   # # #     #
# # # # ######### # ### ### ### ### # ####### ### # # ### ##### # # # ##### # # # # ####### ### ####### ##### ### # # # ### # ### # # # ### # # # ### #
# #   #   #     #   #   #   #   #   #   #   # #   # #         #   # #     #   # # #   #   # # #   #     #     # # #   #     #   # # # # #   # #   # # #
# ### ### # ### ##### ### ### ### ### # # # # # ########### ####### # ### # ### # ### # # # # ### # ##### # ### # ### ######### # # ### ##### ##### # #
# #   # # #   #     #     #   # #   # # # #   #   #       # #   #   #   # #   #   # # # # # #   # #       # #   #   #     #   # # #           #     # #
# # ### # # # ##### # ##### ### ### # # # ##### # # ##### ### # # ####### ### # ### # # # # ### # ######### # # ### ##### # # # ##### ######### ### # #
# # #   # # # #   # #     # #       # # # #   # #   #     #   # #       # #   # #   # # # #     #   #       # #   #     # # # # #   # #   #     # #   #
# # # # # ### # ### ####### # ####### ### # # ### ### ##### ### ####### # # ### ### # # # ######### # ######### ##### ### # ### # # ### # # ##### #####
# # # # #   # #     #     # # #     #   #   #   #   # #     # #         # # #       # # #         # #     #     #     #   #   #   #     # #           #
# # ### ### # # ##### ### # # # # ##### ####### ### # # ##### ########### # ####### # # ######### # # ### # # ### ##### ##### ######### # ########### #
# #       # # #   #     #   # # #     #       # #   # # #       #         #       # # # # #     # # # #   # #     # #   #       #     # #   #       # #
# ######### # ### ### # ##### ### # # ####### # ##### # # ##### ### ### # ####### ### # # # ### # # ### ### ####### # ### ### ### ### ### # ##### ### #
#   #     # #   #   # #     #   # # #   #     #     # #   #   #   # #   # #     #     # # #   # # #   #   #     #   # #   #   #   #       #       #   #
# # # ### # ### ### ##### # ### # # ### # # ####### # ####### ### ### ##### ### ####### # ### # # ### # # ##### ### # # ### ### ############### ### ###
# # #   #   #   #       # # # # # #   # # # #   #   #       #   # #   #     # # #     # #   # # #   # # #     #     # #   # # #       #     #   #   # #
# # ### ##### ######### # # # # ##### ### # # # # ##### ### ### # # ### ##### # # ### # # ### # ### # # ##### ### ### ### # # ####### # ### # ### ### #
# #   # #   #         # # # #   #   #   # # # #   #     #       #   #   # #     # #     # #   #   # # #   #   # # #   #   # #     #   # #   #   # #   #
# # # # # # ######### # ### # ### # ### # ### ##### ############### # ### # ##### ####### # ### ### # ##### ### # # ### ### # ### # # # # ####### ### #
# # # # # #       #   # #   #     # #   # #   #           #         #   #   #     #   #       #   # # #   # #   # #     # # # #   # # # #   #     #   #
### # # # ####### # ### # ######### # # # # ############# # ##### ##### # ### ##### # ####### ### # # # # # ### # ####### # ### # # # # ### # ##### ###
#   # #   #       # #   # #       #   # # # #           #   #   # #     #   #       # #   #   # #   #   # #   #           #   # # # # #   #   #       #
# ######### ####### # ### # ####### ##### # # ######### # ### # ### ####### ######### # # # ### ######### ### ############### # # # ##### ##### ##### #
#         # #       # #   #   #     #     #   #       # # #   # #   #     # #   #   #   # # #       #   #   # #             #   # # #   #     # #   # #
# ### ##### # ####### # ### # # ##### ######### ##### # ### ### # ### ##### # # # # ##### # ##### # # # ### # # ######### ####### # # # ##### ### # # #
#   #         #         #   #       #               #       #     #           #   #       #       #   #     #           #         #   #           #   #
#######################################################################################################################################################
