###################################################
#     #   #           #       #     #   #     #   #
##### # # ### ####### ##### # # ### # ### # ### # #
#   # # #   #     #   #     # # # # #     #     # #
# # # # ### ##### # ### ##### # # # ############# #
# # # #   #     # #   # #   # # #                 #
# ### # # ##### # ### # ### # # ################# #
# #   # # #       #   #   #   #           #       #
# # ### # # ######### ### # ######### ### #########
#   #   # # #       #   # #         # # #         #
# ### ### ### ##### ### # ######### # # ######### #
# #     #         #   #   #   #     # #         # #
# # ################# ##### # # ##### ### ##### # #
# # #         #     #   #   # # #   #     #     # #
# ### ####### # ### ### # # # # # # # ########### #
# #   #   # # #   #     # # # #   # # #         # #
# # ### # # # ### ####### # # ##### ### ####### # #
# #   # # # #   #   #   # # #   # # #   # #   #   #
# ### # # # ### ### # # ### ### # # # ### # # ### #
#     # #     #     # #   # #     #   #     #   # #
####### # ########### ### # ################# # # #
#       # #     #     # # #                   # # #
# # ####### # # # # ### # # ####### ####### ##### #
# # #       # # # # #   # #   #   #   #   # #     #
# ### ####### ### # ### # ### ### ### # # # # #####
# #   # #   #     # #   #   #     #   # #   #   # #
# # ### # # ### ### # ##### ##### # ##### ##### # #
#       # #   #   # #     #     # #     # #   # # #
######### ### ##### # ### ##### # ##### # ### # # #
#   #   #   # #     #   #   #   #     # #     # # #
# # # # ### # # ####### ### # ####### # ####### # #
# #   # #   #   #   #   # #   #     # #   #   #   #
# ##### # ####### ### ### ##### ##### ### # # ### #
#     #   #       #   #                 # # #     #
# ### ########### # ####### ############# # #######
#   #     #     #         #     #         # #     #
# ##### # # ### ######### ####### ##### ### # ### #
# #   # #   # #   #     #         #     #   #   # #
### # ### ### ### # ### ########### ##### ### # ###
#   #   #     #   #   # #           #   # #   #   #
# ##### # ##### ### ### # ########### # # ####### #
#     # # #     #   #   #       #     #   #     # #
# ### # ### ######### ######### # ######### ### # #
#   # # #   #   #   #         # #         #   #   #
##### # # # # # # # ####### ### ######### # # #####
#     #   # # #   #   #   #   # #     # # # #     #
# ########### ####### # # ### # # ### # # ####### #
# #   #     #   #     # #   #     #     #       # #
# # # # ### ### # ##### ### ################### # #
#   #     #     #         #                       #
###################################################
