#######################################################################
#   #                     #       #   #                 #           # #
### ##### ####### ####### # ### # # ### # ########### ### ##### ### # #
# #     # #     # #       #   # # #   # #     #       #   # #   #     #
# ##### # # ### # ##### ####### # ### # ##### ##### ### ### # #########
#     # # # # # # #   # #       # #   #   # # #   #   # #   #   #     #
# ### # ### # # # # # # # ####### # ##### # # # # ##### ### ### # ### #
#   # #     #   # # # #   #         #   # # #   #   #   #   #   #   # #
### # ####### ### # # ########### ### # # # ####### # ### # # ##### # #
# # #       # #     #           # #   # # # #   #   #     # #       # #
# # ####### # # ########### ### ### ### # # # # # # ####### ######### #
#     #     # # #   #     #   #       #   # # #   #       # #       # #
# ##### ##### # ### # ### ########### ##### # ############# # ### ### #
#   #   #     #     #   #           #     # #           #     #   #   #
##### ### ############# ########### ##### # ########### # ######### # #
#   #   # #   #         #         # #   #       #     #   #         # #
# # ### # # # # ######### ######### # # ####### # ### ##### ######### #
# #   # # # #   # #                 # #   #   # #   #     # #     #   #
# ### # # # ##### # ################# ##### # # ####### ### ### # # ###
#   # # #   #     # #       # #     #       #     #   #   #   # # # # #
### # # ##### ##### # ##### # # ### # ########### # # ### ### ### # # #
#   #   #   #       # # #   #   #   #     #     #   #       #   # # # #
# ####### # # ####### # # ### ### # ##### # ### ####### ####### # # # #
# #   #   # # #   #   # #   # # # # # #   # #     #     #       #   # #
# # # # ### # # # # ### ### # # # # # # ### ##### # ##### ####### ### #
# # #   # # #   #   #     # # # # #   # # #     # #     # #     # #   #
# # ##### # ######### ##### # # # ##### # ##### # ##### # ### ### ### #
#   #     #     #   #       #   #         #   # #     # #   # #   #   #
# ### ######### # # # ################### ### # ##### ##### # # ### # #
# #           # # #   #   #       #   #       # #   # #     # # #   # #
# ####### ### # # ##### # ### ### # # ######### # # # # ##### # ### ###
#   #   #   # #   #     #   #   #   #     #     # #   #     # #   #   #
### # # ### # ##### ####### # # ######### # ##### ######### # ### # # #
# #   #   # #       #   #   # # #       # #     # #         #     # # #
# ####### ##### # ### # # ### # # # ##### ##### # # ######### ####### #
#     # #     # # #   #   #   # # #     #       #   #     # # #       #
# # # # ##### ### # ########### # ##### ############# ### # # ##### # #
# # #   #   #   # # #           # #   #       #       # # # #   #   # #
### ### ### ### # # ### ######### ### ##### # # ### ### # # ### # #####
#   #         # # # #   #   #           #   # # #   #   # #   # #     #
# ### ######### # # # ### # ######### ### ### ### ### # # ### # # ### #
#   #   #   #   # #   #   #     #   # #   #     #   # #   #   # #   # #
# # ### # # # ### ##### # ##### # # ### ####### ### # ##### # # ##### #
# # #   # #   #   #     #   # # # #   #       #   # # #   # # # #   # #
# # ##### ##### # ##### ### # # # ### ### ### ### # # # # # # # # # # #
# # #   # #     # #   #   # #     #     # #   # # # #   #   # #   #   #
# # # # # ####### # # ### # ########### ### ### # # ######### ####### #
# #   #   #       # # #   # #   #     # #   #   # #   #         #     #
# ######### # ##### # ##### # # # ### # # ### # # # # ########### #####
# #         # #     #     #   #     # #   # # #   # #   #       #     #
# # ### ####### ######### ########### ##### # ####### # # ##### ##### #
# #   #     #   #       #           #     # # #     # #       #   #   #
# ######### # ### ### # ########### # ### # # ### # ### ####### ### ###
#     #   #   #     # #       #     # # # #       #   # #     #   #   #
##### # # ### ####### ### ##### ##### # # ########### # # ### ### ### #
#   # # #   #   #     #   #     #       #     # #     # # #     #   # #
# ### # ### ### # ######### ##### ####### ### # # ##### # ##### # # # #
#     #   #   #   #     #   #   # # #   #   # # # #     #   # #   # # #
# ##### # ### ##### ### # ##### # # # # ##### # # # ####### # ##### # #
#     # # # # #     # #   #     # # # #       #   # #     # #   #   # #
##### ### # # # ##### ##### # ### # # ######### ##### ### # # # # ### #
#   #   # # #   #         # # #     #   #     #       #   # # # # #   #
# ##### # # ##### ##### # # # # ####### # ############# ### # ### # ###
#     # # # #   #   # # # # #   #       #                   #     # # #
# ### # # # # # ### # # # ####### ####### ################### ##### # #
#   #   # #   #   #   # #         #         #         #       #   # # #
### ##### ##### ##### # ##### ############### ####### ######### # # # #
#   #   #     # #     #     # #               #   # # #         #   # #
# ### # ##### # # ######### ### ############### # # # # ############# #
#     #       #           #                     #   #                 #
#######################################################################
