###############################
# #     #     #   #         # #
# # ### # ### # # # ##### # # #
# #   # #   #   #   #     # # #
# ### # ############# ##### # #
#     # #       #   # #   #   #
####### # ##### # # # # ##### #
#       # #     # #   #       #
# ####### ### ### ### #########
# #         #   # # # #       #
# ### ##### ### # # # # ##### #
#   #     # #     #   #     # #
### # ##### ##### ######### # #
#   # #   #     # #   #   # # #
# ### # # # ### ### # # # # # #
# #   # # #   # #   #   # # # #
# # ### # ##### # ####### # # #
# #   # #     # # #     #   # #
# ##### ##### # # # ######### #
# #     # #   #     #   #     #
# # ##### # ##### ### # # ### #
# # #     #     # #   #   # # #
# # # ### ##### ### ####### # #
# # #   # #   # #   #         #
# # ### # # # # # ### #########
#   #   # # # #   #   #       #
##### ### # # ##### ### ##### #
#     #   # #     #   # #   # #
# ### ##### ### ##### # # ### #
#   #         #         #     #
###############################
