#####################
#   #             # #
### # ### ####### # #
# # # # # #     # # #
# # # # # # ### # # #
#   # # # # # # # # #
# ### # # # # # # # #
#   #   #     # # # #
### ########### # # #
# #             #   #
# ################# #
#   #           #   #
# ### # ####### # ###
#     #     # # # # #
########### # # # # #
#           #   #   #
# ### ############# #
#   # #   #       # #
# # ### # # ##### # #
# #     #       #   #
#####################
