#########################################
# #       #             #     #         #
# # ##### ##### # ##### # # # ### ##### #
#   #   #     # # #   # # # #     #   # #
##### ####### ### # # # ### ######### # #
# #         #     # # #   #   #       # #
# # ##### ########### ### ### ### ### # #
#   #   #           #   # #   #   #   # #
# ### ##### ####### # # # # ### # ##### #
#   #     #       # # # #   #   # #     #
### ##### ####### # # # ##### ##### #####
# #       #   #   #   # #   #     # #   #
# ####### # # # ######### # # ### # # # #
#     #   # # # #         # #   #   # # #
# ### # ### ### # ######### ### ##### # #
# # #   #   #   # #     #     # # #   # #
# # ##### ### ### # ### # # ### # # # ###
# #         # #     #   # # #   #   #   #
# ### ##### # # ######### # # ######### #
#   # #   # # #   #       # # #       # #
### # # # # # # ### ####### # # ##### # #
#   # # #   # # #   #     # # #   # # # #
# ### # ### # # # ### ### # # ### # # # #
#   # #   # #   #   #   # # # #   # # # #
### # ### ######### # # ### # # ### # # #
#   # #   #   #     # # #   #   #     # #
# ### # ### # # ##### # # ####### ##### #
# # # #     # #   # # #   #     #   #   #
# # # ####### ### # # ##### ### ### # # #
# # #     # #   # #   #   #   #     # # #
# # ##### # # ### # ### ##### ####### ###
# #     #   #   # #   # #     #     #   #
# ##### ### ### # ### # # ##### # # ### #
#     # #   #   # #     #   #   # #     #
##### # # ### # # ######### # ### ##### #
# #   #     # # #         # # #   #   # #
# # ### ##### ########### # # # ### # ###
#   #   #   #       # #   # # #     #   #
# ####### # ### ### # # ### ########### #
#         #     #     #                 #
#########################################
