#####################
# #       #         #
# # ##### ##### # # #
#   #   #     # # # #
##### ####### ### # #
#   #       #     # #
# # # ##### ####### #
# #   #           # #
# ##### ####### ### #
# # #   #       #   #
# # # ######### # ###
#   #         # # # #
### ######### # # # #
# # #   #     # #   #
# # # # # ### ##### #
# # # # # #   #     #
# # # ### ##### #####
# # # #   #   # #   #
# # # # ### # # ### #
#     #     #       #
#####################
