###########################################################################################
#   #                   #   #   #           #       #         #       #     #       #     #
### ##### ####### ####### # # # # # ####### ### # # # ####### ### ### # # # ##### # # # ###
# #     # #     # #       #   # # #       #   # # # # # #   #   #   #   # #     # #   #   #
# ##### # # ### # # ########### # ####### ### ### # # # # # ### ######### ##### # ####### #
#     # # # # # # # #         #   #     #   #     #   #   #   #           #     # #     # #
# ### # ### # # # # ######### ######### ### ########### ##### ############# ##### ### # # #
#   # #     #   # #           #         # #   #       # #   #             #   # #   # # # #
### # ####### ### ########### ### ##### # ### # ##### # # ### ########### ### # ### ### # #
#   #       # #   #         #   #   # # #   #     #   #   #   #   #     # # # # #   #   # #
# ### ##### # # ### ####### ### ### # # # # ####### ##### # ##### # ### # # # # # ### ### #
#   # #     # # #   #     #         #   # # #     #   # # #     # # # #     # #   #   #   #
# ### # ##### # # ### ### ########### ##### # ### ### # # ##### # # # ####### # ### # # # #
# #   # #     #     #   #           # #     # #     # #   #   # #       # #   # #   # # # #
# # ### # ############# ########### # ### # # ##### # # ##### # ####### # # ### ### # # ###
# #   # # #   #         #         # #     # #   # #   #       #   #   #   #   #   # # #   #
##### ### # # # ######### ######### ### ####### # ########### ### # # ### ### ### # ##### #
#   #   # # #   # #                 #   #     # #   #   #     #   # # #   #   #     #   # #
# # ### # # ##### # ##################### ### # # # ### # ##### ##### # ### ######### # # #
# # #   #   #     # #       #             #   # # #     # #   #     #   #   #         # # #
# # # # ##### ##### # ##### # # ########### ### # ####### # ####### ##### ### # ####### # #
# #   # #   #       # # #   # #   #   #   #     # #       # #     #     #   # #     #     #
# ####### # # ####### # # ### ### # ### # ####### # ####### # # ####### ### # ##### ##### #
# #   #   # # #   #   # #   #   # # #   #         # #     #   #       #     #     # #   # #
# # # # ### # # # # ### ### ### # # # ####### ##### ##### # ######### ############# # # # #
# # #   # # #   #   #     # # # # #   #     #   #   #     #   #     #         #     # # # #
# # ##### # ######### ##### # # # ##### ### # # # ### ### ### # ### ##### ### # ### # # ###
#   # #   #     #   #       # # #   #   # # # # # # #   #   # #   #   #   # # #   # # #   #
# ### # # ##### # # # ####### # ### # ### # ### # # # # ##### ### ### # ### # # # ### ### #
# #     # #   # # #   #       # # #       #   #   #   #       #   #   # #   # # #       # #
# ####### # # # # ##### # ### # # ########### # ########### ### ### ### # ### # ######### #
#   #   #   # #   # #   #   # #   #           #     #     # # # #   #   # #   #     #   # #
### # # ### # ##### # ##### ##### # ####### ####### # ### # # # # # # ### # ######### # # #
# #   #   # #     #   # #   #     #   #     #     # #   # # #   # # # #               #   #
# ####### ##### # # ### # ### ####### # ##### ### # ### # # ##### # # ################### #
#       #     # # # #   #       #   # # #   # # # #     # #       # #   #   #   # #       #
####### ##### ### # # ######### # # # # # # # # # ####### ######### ### # # # # # # #######
#     #   # #   #     #     #   # # # # # #     #     #   #   #   # # #   # # #   # #     #
# ### # # # ### ####### ### ### # # # ### ####### ### # ### # ### # # ##### # ### # # ### #
# #     #     # #       # #   # # # #       #   #   # # #   #   #   #   #   #   # # #   # #
# ##### ####### # ####### ### # # ########### # ##### # # ##### ### # ### ### # ### ##### #
#   # # #   #   # #   #       # #   #       # #       #   #   #   #   #   #   #   #   #   #
# # # # # # # ### # # # ####### ### # ##### # ####### ##### # ### ### # ### ##### ### # # #
# # #   # #   #   # #   #         # #   # # #   # #   #     #   #   # # # # # #   # #   # #
# # ##### ####### # ############# # ### # # ### # # ### ####### ### ### # # # # # # ##### #
# # #   # #       # #         # # # #   # #     #   # #     #   #   #   #     # #   #   # #
# # # # # # ####### ##### ### # # # # ### ####### ### ##### # ### ### ####### # ### # # # #
# #   #   #   #     #     #   #     # #           #     #   # #       #     # #   # # #   #
# ########### # ##### ##### ######### ########### # ### # ### ### ##### # # ##### ### #####
# #           #       # #   #         #         #   #   #   #   # #   # # #       #   #   #
# # ### ############### # ### ######### ####### ########### ### # # # ### # ####### ### # #
# #   #   #   #           #               #   # #         #   # # # # #   # #     # #   # #
# ##### # # # ##### ####### ############# # # # # ##### ##### # ### # # ##### ### # # ### #
#     # #   #     #     #     #         #   # #       # #     #   # # #         #   #   # #
##### # ####### # ##### ####### ####### ### ########### # ####### # # ######### ######### #
#   # #   #   # # #   #         # #     #   #   #     # #   #     # #       # #     #     #
# ### ### # # ### # # ########### # ##### ### # # ### # # ### # ### ####### # ##### # ### #
#     # # # #   # # # #       #   #   #   #   #   # # #   #   # #   #     # # #     # #   #
# ##### # # ### # # # # ### # ### ### ##### ####### # ### # ##### ### ### # # # ##### #####
#     #   # #   #   # # #   #       #       #   #   #   # # #   #   #   # # #     #       #
##### ### # # ####### ### ######### ######### # # # ### # # # # ### ### # # ##### ####### #
#   #   # # # #       #   #   #   # #     #   # # # #   # #   #   # #   # #   #           #
# ##### ### # ### ##### ### ### # # # ### # ### # ### ######### ### # ### ### # ######### #
#     # #   # #   #   #   #     #   #   # #   #   #   #   #     #   # #     # # #   #   # #
# ### # # ### # ### # ### # ########### # # # ##### ### # # ##### ### ####### ### # # ### #
#   #   #   # #   # #   # #     #     # # # #   #   #   # #     # #   #     #     # #   # #
### ##### # # ### # ### # ##### ### # # # ##### # ##### # # ### # # ### ### ####### # # # #
#   #     # # #   #   #   #     #   # # #       # #     # #   # # #   #   #       # # #   #
# ##### ### # # ### # ##### ##### ### # ######### ### ### ### # # ### ### ####### # # #####
# #   # # # # # # # # #           #   #       #   #   #   # # # #       #     # #   #   # #
# # # # # # # # # # # ######### ##### ##### # # ### ### ### # # ### ######### # ####### # #
#   # #   # #   # # # #   #   # #   #     # # #     # # # #   #     #       # #         # #
##### ### # ##### # # # # # # # # # ##### ### ####### # # # ######### ##### # # ######### #
#     #   # #       #   # # # # # #   #     # #         #       #   # # #   # #         # #
# ######### ####### ##### # # ### ### ##### # # ######### ####### # # # # ### ######### # #
# #       #   #   # #   #   #     # # #   # # # #         #   #   #   # #   #         #   #
# ##### # ### # # # ### ########### # # # # # # ######### # # # ####### ### ##### ### ### #
#   #   #     # # #     #           #   # #   #   #     # # #   #   # #   #     # #   #   #
### # ### ##### # ##### ### ##### ####### # ##### # ### ### ##### # # # # ##### ### ### ###
# # #   # #     #     #     #     #       # #   #   # #   #       # # # #       #   # #   #
# # ### ### ######### ############# # ##### # # ##### ### ### ##### # # ######### ### ### #
# # #   #   #       #           #   # #   # # #         #   #   #   #   #     #     #   # #
# # # ### ### ##### ########### # ##### # ### ##### # ##### ### # ### ### # # ### # # ### #
#   #     #       #       #     # #     #         # # #   #   # # #   #   # #   # # #     #
# ####### ####### ### ##### ##### # ############### # # # ### # # ### ### # ### ### #######
# #     #         #   #     #     #   #     #       # # #     # #   #   # # #     #       #
# ### # ##### ######### ##### ####### ##### # ####### # ########### ### # # ##### ####### #
#     #   #   #     #   # #     #     #   # #     #   #   #       # # # # #     #       # #
######### ##### ### # ### # ### # ##### # # ##### ####### # ##### # # # ####### ####### # #
#               #     #       #         #       #           #       #           #         #
###########################################################################################
