#########################################################################################################################
# #           # #               #       #       #   #             #           #   #         #       #             #     #
# ##### ##### # # ############# # ### # ##### # # ### ### # ####### ##### ### # # # ####### # # ### # ### ##### ### # ###
#       #   # # # #           #     # # #     #   #   #   # #           #   # # #   #     # # # #   # #   #     #   #   #
######### ### # # # ######### ####### # # ######### ### ### # ########### # ### ####### # # # # # ### # ######### ##### #
#   #       # #   # #       #       # #   #         # #   # # #     #   # #   #       # # #   # # #   # #       # #   # #
# ### ##### # ##### ##### # ####### # # ### ##### ### ### ### # # ### # ##### ####### ### ##### # ### # # ##### # # # # #
#   # # #   # #     #     # #   #   # # #   #   #       #       # #   #       #     #     #     #   # #     # #   # # # #
# # # # # # # # ##### ##### # # # ### ### ### # ######### ####### # ######### ##### ##### # ####### ####### # ####### # #
# #     # # #   #     #   # # #   #         # #     #   # #   # # # #   #   # #     # #   # #   # #     #     #       # #
# ####### # ##### ### # # ### ##### ######### ##### # # ### # # # # # # ### # # ### # # ### # # # ##### ##### ##### ### #
#   #     #   # #   # # # #   #     #         #       #     # #   #   #   #     #     # # #   # #   #   #   #       #   #
### # ####### # ### # # # # ##### ### ##### ################# ######### # ########### # # ##### ### # ### # ####### # ###
#   # #     #   # # #   #   #   # #   #   # #   #   #         #       # # #   #     # # # #     #   #     # #   #   #   #
# ### # ### ### # # ######### # ### ##### # # # # # # ####### # ##### ### # # # ### ### # # ##### # ####### # ### ##### #
# # # # # #       #     #   # #   #     #   # #   # #   #   #   #   #   # # #   # #   #   #   #   #   #     #     #   # #
# # # # # ############# # # # ### # ### # ### ##### ##### # ##### ##### # # ##### ### ### ### # # ### # ##### ##### ### #
# # # # # #           #   # #   # # #   # # # #   #       #     # #     #   #       #       # # #   # #     # #     #   #
# # # # # # ##### ### ##### # # # ### ### # # ### ############# # # ##### ### ##### ######### # ### ####### # ### ### ###
# # # #   # #   # #     #   # # # #   #     #       #           #   #       #   #   #   #     # #   #     # #   #   #   #
# # # # ### # ### ####### ##### # # ######### ##### # ############# ####### # ### # # ### ####### # # ### # ### ### ### #
#   # # #   #   #         #     # #           #   # # #           #       # # #   # # #   #       # #   #   #         # #
# ### # # ##### ########### ##### # ########### # ### # ######### ####### # ### ### # # ##### ##### ### ############# # #
# #   # # #   #     #       # #   #   #   # #   #   #       #   #   #   # #   # # #   # #     #     #   #         #   # #
### # ### # # # ### ####### # # ##### # # # # ##### ######### # ### # ### ### # # ### # # # ### ##### ### ####### ##### #
#   # #   # # #   #         # # #   #   #   #   # #       #   #   # #     #     #     # # #   #     # #   #         #   #
# ### # ### # ### ########### # # # ##### ##### # ####### # ##### # # ########### ##### # ### ##### # ### # ####### # # #
# #   #     #     #     #       # # #     #     #           #   #   #     #   #   #     #   # #     # #   #   #   #   # #
# ################# # ### ####### # # ##### ### ############# # ######### # # ##### ####### # ##### # # ##### # # ##### #
#           #       #     #       #   #   #   # #         #   #       #   # #     #     #   #     # # # #     # #     # #
# ######### # ################### ##### # ### ### ####### # ######### # ### ##### ##### # ####### ### # ####### ##### # #
# #   #     # #                 # #     #   #   #       # # #     #   #   # #   # #     # #   #   #   #         #     # #
# # # # ##### # ############### # ####### # ### ### ##### # # # ### # ### # ### # # ##### # # # ### ####### ##### ##### #
# # # #     #   #   #         # #   #   # #   #   # #     # # # #   #   #   #   # # #   #   # #   # #     #     # # #   #
# # # ##### ##### # # # ##### # ### # # # ####### # # ##### # ### ### ####### ### # # ####### ### # # ### ####### # # ###
# # #     #     # #   # #   # # # #   # # #     #   #   #     #   #   #   #     #   #         #   #   # #         # #   #
# ####### ##### # ##### # # # # # ##### # # ### ####### ####### ####### # # ### ##### ######### ####### ########### ### #
#   #   #     # # #   # # #   # #     # #   # #       #     #   #       # # # #     #   # #   #       #               # #
### # # # # ### # ### # ####### # ### # # ### # ##### ##### # ### ####### # # # ### ### # # # ##### # # ######### # ### #
# #   # # #   # # #   #         #   #   # #   # #   #   # # #   # #   # #   # # # # # # #   #     # # #   #   #   # #   #
# ##### ##### # # # # ############# ##### ### # ### ### # # ### # # # # ##### # # # # # ####### # # ### ### # # ##### ###
# #   #       # # # # #         #   #   #     # #   #   # #   #   # #     #   # #     #         # #     #   #   #   # # #
# # # ##### ### # # # ### ####### ### ##### ### # ### ### ### # ### ##### # # # ################# ####### ####### # # # #
#   #       #   # # #     #       #       # #   #     #     # #   #   # #   # #                   #     #   #     # #   #
# ########### # # # ####### ####### ### ### # ### ##### ### # ### # # # ##### ##################### # ##### # ##### ### #
#   #       # # # # #     # #     #   #     # #         #   #   # # # #   # # #           #     #   # #     # #   #     #
### # ####### # # # # ### # ##### ### ####### ################# # # # # # # # ### ### ### # ### # ### # ##### # # #######
#   # #       # # # #   #       #       #   #       #     #     # # # # #   #   # # # #     # #   #   #     #   #     # #
# ### # ####### # # ### ####### # ##### ### ####### # ### # ##### # # # ####### # # # ####### ##### ####### ######### # #
#   # #   #   # # #   #   #   # # #   #     #   #   # #     #   # # # # #     # #   #   #         #     #     # #     # #
### # ### ### # # # # ### # # # ### # ##### # # # # # ####### # # ### # # ### # ### ### ##### # ####### # ### # # ##### #
#       #   #   # # #   # # # #     #   #   # # # # #   #   # # #   # #     #   #     #     # #       # # # # # #   #   #
# ######### ##### # # ### # # ######### ### # # # ##### # # # # ### # ####### ####### ##### ### ##### # # # # # ### # # #
#   #       #     # #     # # #       #   # # # #     #   # # #   # #       #     # # #   #   # #   # # # # #   # #   # #
### # ##### # ##### ####### # ##### ##### # # # ##### ##### ### ### ####### ##### # # # # ### # # # # # # # ### # ##### #
#   # #   # # #     #       # #   #     # # # #       # #   #   #   #   #   #     # # # #   # #   # # # # #   # #     # #
# ### # # # # # ##### ####### # # ##### # ### ####### # # ### # # ### # # ### ##### # ### # # ##### # # # # # # ### ### #
# #   # # # # #     #       #   #     #       #   # #   # #   # #   # #   # # #   #       # #   #   #   # # #     # #   #
### # # # ### ############# ######### # ####### # # ### # ### ##### # ##### # # # ######### ### # ####### ####### # # ###
#   # # #   #       #       #   #     # #       # #     #   # #   #   #   #   # # #       #   # # #     # #     #   # # #
# ### # ### ####### # ####### ### ##### # ####### ######### # # # ##### # # ### # # ##### ### # ### ### # # ### ### # # #
#   # #   #   #   #   #       #   #   # #     #           # #   #       # #   # #   #   #   # # #   # # # #   #   # #   #
# # # ### ### # # ##### ####### ### ### ##### ########### # # ### ####### ### # ##### # ### ### # ### # # ### ### ##### #
# # #   #   # # #       #       #     #   # #   #       # # #   #   # #   #   # #     # # #   # # #         # # #   #   #
# # ### # ### # ##### ### ####### ### ### # ### # ####### # ### ### # # ### ### # # ### # ### # # ########### # ### # ###
# # #   # #   # # #   #   #     # # #   #   #   # #     #   #   #   # # # #   # # #   #     # # #   #       # #   # #   #
# # ##### # ### # # # # ### # ### # ### ### # ### # ### ##### ### ### # # ### # # ### ##### # # ### # ##### # # # # ### #
# #       #   # # # # # #   #       # #     # #   # # #       # # #   # #   #   # # #   #   #     #   # #   #   # #   # #
# ########### # # # ### ########### # ####### # # # # ######### # # # # ### ##### # ### ### ##### ##### # ####### ### # #
# # #   #   #   # #   #   #   #   #       #   # #     #   #     # # # #   #     #     #   #     # #     #       # # # # #
# # # # # # ##### ### ### # # # # ######### ######### # # # # # # ### ### ### # ### ##### ##### # # ### ### # ### # # # #
# #   #   #     # #     # # #   #   #     #         # # # # # # # #     #     # #   #   #     # #   #   # # # #   # # # #
# # ####### ### # # # ### # ####### # ### # ####### # ### # # ### # ########### ##### # ##### # ##### ### # # # ### # # #
# #   #   #   #   # # #   # # #     # # # # #     # #   #   # #   #           #     # #       # #     #   # # # #   #   #
# ##### # ### ### # # # ### # # ##### # # ### ### # ### ##### # ########### ####### # ######### # ##### ### ### # # #####
#     # #     #   # # #     # # #     #   #   # #   # #     # #     #       #       # #       # #   # #   #     # # #   #
##### # ##### ##### ######### # # ### ### # ### ##### ##### # ##### # ##### # ####### ##### # # ### # # # ####### ### # #
#     #     # #   # #         # #   #   #   #       #             # # #     # #           # # #   # # # # #           # #
# ##### ### ### # # # ### ##### ### ### ##### ##### # ############# # ##### # ##### ##### ### ### # # # # # ########### #
#     #   #     # # #   #       #     # #   # #     # #             #     # #     # #   #   # #   # #   # #   #   #     #
##### ### ####### # ### ############# # # # # # ##### # ################# ####### # ### ### # # ### # ### ### # # # ### #
#   #   #   #   # #   #   #   #     # #   # # # #     # #   #     #       #   #   #       # #     # #   #     # # # #   #
# # ### ##### # # # ##### # # # ### ####### # ### ##### ### # ### # # ##### # # ######### # ##### # ### ######### # ### #
# #   # #     #   #     #   #   # #     #   # #   #   #   #     # # #       # # #   #     #     # #   # #         #   # #
# # ### # ####### ##### ######### ##### # ### # ### ##### ### ### # ######### # # # ########### ##### # # ####### ### # #
# #     # #     #   #     #   #       #   # #   # #     #   # #   # #     #   #   #       #   # #   # #   #   # # #   # #
# ####### # ### ##### ### # # # ########### # ### # ### ### # # ### ##### # ############# # # # # # # # ### # # # # ### #
#     #   #   #       # #   #   #       #     #       # #   # #           #     #       #   # #   # # # #   # #   # #   #
##### # ##### ######### ####### # ##### # ##### ####### # ##### ######### ##### # ##### ##### ##### # # # ### ##### # ###
#       #     #             #   # #   #   #       #     #     #     #   #     # #   # # #     #     # # # # #       #   #
# ####### ######### ### ### # ### # # ########### # ### ##### ### ### # ### ### ### # # # ##### ### # ### # ########### #
# #   #   #       # #   #   # # #   #       #   # #   # #   #   # #   #   # #     #   # # #     #   #     #     #   #   #
### # # ##### ### ### # ##### # ########### # # ##### # # # ### ### ##### # # ##### ### # # ############### ##### # # ###
#   #   #   # #       # #     #     #     #   #   #   # # #   #     #   # # #       #   # # #             #       #   # #
# ####### # # ######### # ##### # ### # ######### # ### # ### ####### # # ### ####### # # # # ####### ### # ########### #
# #       # # #   #     # #     # #   # #     #   #   # # #         # # #   #   #     # # #   #   # # # # # #         # #
# # ### ### # # # ### ### ####### # ### # ### # ### # # ### ####### # ##### ### # ####### ### # # # # # # # # ####### # #
# #   # #     # #   #   #         # #   # # #   # # # #     # #   # #   #   #   #           #   #   # # # # #     #   # #
# ##### ##### # ### ##### ######### # # # # ##### # # ####### # # # # # # ### ############# ####### # # # # # ### # ### #
#   #   #   # # # #       #     #   # # #   # #     #     #   # # # # # #   # #   #       # #     # # # # # # # # #     #
### # ### # ### # ######### ### # ### ##### # # ######### # ### # # ### ### ### # # ##### # ### # # # # # # # # # ##### #
#   #     #   #     #     #   #   # #       #         #   #     #       #   #   # # #   # #   # #   # # # # #   # #     #
# ########### ##### # ### ### ##### ############# ##### # ############# # ### ### # # # # ### ##### # # # # ### # # #####
#           #       # # #     #     #         # # #     # #       #   # #   #   #   # # # #   #   # # #   #   # # # #   #
# ##### ### ######### # ######### # # ####### # # # ##### # ##### # # # ### ### ##### # # ### # # ### # ##### ### # ### #
# #   #   #         # #           #   #   #   #   # #     # #   #   # # # #   # #     # #   #   #     #     #     #     #
### # ############# # ### ############# ### ####### ####### ### ##### # # # # # ### ####### ### ##### ##### ########### #
#   #               #     #     #       #   #     #       # #   # #   #   # # #   #       #   # #   # #   #   #       # #
# ####### ##### ########### ##### ##### # ##### # ####### # # # # # ####### # ### # ### # ### ### # ### # # ### # ##### #
# #       #   # #       #     #   #   # #   #   # #     #     # # #       # #   # # #   #   # #   #     # # #   #       #
# ### ##### # ### ### ### ### # ### # # ### # ### # ### ####### # ####### # ##### ### # ##### # ######### ### ###########
#   #     # #     # #     #   # #   #     # # # #   # #       # #   #   # #       #   # #   # #   # #   #     #         #
# # ##### # ####### ####### ### # ######### # # ##### ####### # # # ### # ######### # ### # # ### # # # ############### #
# #     # #     #       # #     #       #   # # #           # # # #     #       #   # #   #     # #   #     #         # #
# ##### # ##### # ##### # ############# # ### # # ####### ### # # ######### ### # # ### ######### # ##### # # ####### # #
#   #   #     #   #   #   #       #     #     # #   #   #     #   #       #   #   # #   #         #   #   #   #       # #
##### ##### ######### ### # ##### # ########### ### ### ########### ##### ### ##### # ### ########### # ####### ####### #
#     #     #           # # # #   #               #     #         # # #   #     #   #   # #         # # #   #   #     # #
# ########### ### ####### # # # ############# ######### # ####### # # # ######### # ### # ####### # ### # ### ### ### # #
#               #           #               #             #         #             #   #           #     #         #     #
#########################################################################################################################
