#############################################################
#   #             #             # #       #     #         # #
### ########### # # ##### ##### # # # ##### # # ##### ### # #
# #     #       # #   #   #     #   #     # # #   #   # #   #
# ##### # ####### ##### ### ######### ### # # ### # ### ### #
#     # # #     #     # # # #   #   # # #   #   #   # #     #
# # ### # # ### ##### # # # # # # # # # ####### ##### # #####
# # #   # # #   # #   # # #   #   # #     #     # #   #   # #
# # # ### # # ### # ### # ######### ##### # ##### # # ### # #
# # #   # # # #   #     # #       # # #   # #   #   #     # #
# ##### # # # # # ####### # ##### # # # ### # # # ######### #
#     #   # # # #         #   #   # #   #   # #   #         #
# ### ##### # ### ####### ### # # # ##### ### ##### ##### # #
#   #     # #   #   #     #   # # #       # # # #   #   # # #
### ### # # ### ### # ##### ### ########### # # # ##### # # #
#   # # #   #       #     #   #       #       #         # # #
# ### # ################# ### ####### # ####### ######### # #
# #   # #         #     #   # # #   #   # #     #     #   # #
# # # # # ####### # ####### # # # # ##### # ##### ### # #####
#   # #   #     # #         # # # #     #     #   # # #     #
##### ##### ### # # ######### # # # ##### ##### ### # ##### #
#   #   # #   # # #       #   # # #   #   # #   #   #       #
# ##### # ### # # ####### # ### # ### # ### # ### # ####### #
# #       #   #   #     # # #   #   # #     # #   #       # #
# # ####### ### ### ### ### # # ### # ##### # ########### # #
# # #   #   #   #   # #     # #     #   #   # #   #       # #
# # # # # ####### ### ####### ######### # ### # # # ##### # #
# # # # #       # # #     #       #   #   #   # #   #   # # #
# # # # # ##### # # # # # ####### ### ##### ### ##### # ### #
# # # # #     # # #   # # #     # #     #   #       # #     #
# # # # ### ### # ##### # # ### # # ##### ######### # #######
# # # #   # #   #   #   #   #   #   #   # #     #   #   #   #
# # # ### ### # ### # ####### ### ### # # ### # # ##### # # #
#   # # #     #   #   #     # #   #   # #   # #   #     # # #
# ### # ##### ######### ### # # ### ### ### # # ### ##### # #
#   # #       #     #   #   # # # # # # #   # # #   #     # #
##### # ####### ### # ### ### # # # # # # ### ### ### ##### #
#     # #   #   # #   #   #   #   # # #   #     # # #   #   #
# ##### ### # ### ##### # # ####### # ######### # # # # ### #
#   #   #   # # #   #   # # #       #       #   # #   #   # #
# # # ### ### # # # # ### # # # ######### # # # # ### ### # #
# # #     #   #   # # #   # # # #       # #   # #   # # # # #
# # ##### # ### ### # # ### ### # # ### # # ####### # # # # #
# #     # # #   #   # #   #     # # #     # #     # #   # # #
# ##### ### ##### # # ### ####### # ######### ### # ##### # #
# #   #   # #   # # # # # #   #   #           #   #   #   # #
# # # ### # # # # ### # # ### # ############### ##### # ### #
# # # #   #   # # #   # # #   # #     #       #     #   # # #
# ### # ####### # # ### # # ### # # ### # ### ### # ##### # #
#   # #           # #       #   # #     # #   #   # # #     #
### # ############# ####### # ### ####### ##### ### # # #####
#         #         #   #   # #   #   #   #     #     #   # #
# ####### # # ####### # # ### # ### ### # # ##### ####### # #
#   #   # # # #       # #   # #     #   # #   #   #     #   #
# ### # ### # # ####### ##### ### ### ### ### # ### # ##### #
# #   #     # #   #   #     # #   #   # # #   # # # #       #
# # ############# # # ##### # # ### ### # # ### # # #########
# # #           # # #     # # #   #   #   #   #   # #   #   #
# # # ######### # ##### # # # ####### # ##### ##### # # # # #
# #           #         # #           #     #         #   # #
#############################################################
