#########################################
# #           # #                       #
# ##### ##### # # ############# ##### # #
#       #   # #   #           #     # # #
########### # # ### ######### ####### ###
#           # #   # #   #   #       #   #
# ##### ### # ##### # # ### ####### # # #
# #   # # # # #     # #     #   #   # # #
### # # # # # # ##### ##### # # # ##### #
#   # # # # #   #     #   # # #   #     #
# ### # # # ##### ### # # ### ##### # # #
# #     #   #   #   # # # #   #   # # # #
# # ##### ### # ### # # # # ##### # # ###
# # #   #   # #   # #   #   #   #   #   #
# ### # ### ##### # ######### # ### ### #
#     # #         #     #   # #   # # # #
# ##### ############### # # # ### # # # #
#   # #   #         # #   # #   # #   # #
### # ### # ##### # # ##### # # # # ### #
# #   #   # #   # #     #   # # # # #   #
# ### # ### # ### ####### ##### # ### # #
#     # #   #   #         #     # #   # #
# ##### # ##### ########### ##### # ### #
#   #   # #   #     #       # #   # # # #
### # ### # # # ### ####### # # ### # # #
#   # #   # # #   #         # # #   # # #
# ### # ### # ### ########### # ### # # #
# #   #     #     #     #       #   #   #
# # # ############# # ### ####### ### ###
# # #       #       #     #       # #   #
# # ######### ################### # ### #
# # #   #   # #                 # #     #
# # # # # # # # ############### # #######
# #   #   # #   #   #     #   # #       #
# ######### ##### # # # # # ### # ##### #
# #     #   #   # #   # # #   # # #     #
# # ### # # # # # ##### # ### # ### ### #
# # #     # # # # #   # #     # #   # # #
# # ######### # # # # # ####### # ### # #
# #           #     # #           #     #
#########################################
