#####################
#     #             #
##### ####### ##### #
#   # #     #   # # #
# # # # ### ### # # #
# # # # # #     #   #
# ### # # ####### ###
# #   # #           #
# # ### ########### #
#   # #       #   # #
# ### # ##### # # ###
# #         #   #   #
# # ############### #
# # #         #     #
# ### ####### # ### #
# #   #   # # #   # #
# # ### # # # ### ###
# #   # #   #   #   #
# ### # ####### ### #
#     #             #
#####################
