#################################################################################
#   #                 #                   #     #         #           #         #
### ##### ####### # ### ############# # # # # # # ### ### ####### ### # ####### #
# #     # #     # #   # #           # # # # # # #   # #           #     #     # #
# ##### # # ### # ### # # ######### ### ### # ##### # ################# # ### # #
#     # # # # # # # #   #   #           #   #     # #       #       #   # # # # #
##### # ### # # # # ####### ########### # ####### # ####### # ##### ##### # # # #
#   # #     #   # #     # #       #   # # #       #       #   #   #   #   # # # #
# # # ####### ### # ### # ####### # # ### # ##### ####### ##### # ### # ### # # #
# #       # # #   # #         # #   #   # #   #       #         # #   # #   # # #
# ####### # # # ### ######### # ####### # ### ##### ### ########### ### # # # # #
# #         # # #   #     #         #   #   #     # #   #   #     # #   # # # # #
# ### ####### # # # # ### ########### ##### ##### ### ### # # ### # # ##### # # #
#   #   #     #   # #   #           #   #       #     #   #   # # # # #     # # #
### ##### ############# ########### ### # ##### ####### ####### # # # # ### # ###
#   #   # #   #         #         # #   # #   #   #   # #       # #     #   #   #
# ### # # # # # ######### ######### # ### # # ##### # # # ##### # ####### ##### #
#     # # # #   # #                 #     # #   #   #   #     # # #   #   #     #
# ##### # # ##### # ################# ##### ### # ####### ### # # # # ### # #####
#     # #   #     # #       #       #     #   #   #   #     # # #   #   # #     #
####### ##### ##### # ##### # ### ##### ##### ##### # ##### # ######### ####### #
#       #   #       # # #   #   #       #   #     # #     # #     #     #       #
# ####### # # ####### # # ##### ######### # ##### # ##### ##### # # ##### ##### #
# #   #   # # #   #   # #   # # #   #   # #       #     #       # #       #   # #
# # # # ### # # # # ### ### # # ### # # # # ########### ######### ########### # #
# # #   # # #   #   #     # #   #   # #   # #         #   #     #     #   #   # #
# # ##### # ######### ##### # ### # # # ##### ####### # # ### ####### # # # ### #
#   #     #     #   #       # #   # # # #           # # #   #       # # #   #   #
# ### # ####### # # # ####### ### ### # # ########### # ### ##### ### # ### # ###
# #   #       # # #   # #     #   #   # # #       #   #   #     #   # # #   # # #
# ####### # ### # ##### # ##### # # ##### # ##### # ### ####### # # # # ##### # #
#   #   # #   #   #     # #     # #       # #   # #   # #       # #     #   # # #
### # # ### # ##### ##### # ##### ######### # # # ### ### ##### ######### # # # #
# #   #   # #           # #     #   #     # # # #     #   #   # #         #   # #
# ####### ##### ####### # # ### ##### ### # # # ####### ### # # # ############# #
#     # #     #   #   # # #   #         # # # # #       # # #   # #     #       #
# ### # ##### ### ### # # ##### ######### # # # # ####### # ##### # ### # ##### #
# # # #   # #   # #   # # #   #   #       #   # #     #   # #   # #   #     #   #
# # # # # # ### # # # # # # # ##### ########### ### # ### # # # # ### ####### ###
# #     #     # #   # #     #       #   #     #   # #   # #   # #   # #     #   #
# ##### ####### ################# ### # # ### # # ##### # # ####### # # ### ### #
#   #   #   #   #       #     #   #   #   # # # # #     #   #       # # #     # #
# # # ### # # ### ##### # ### ##### ####### # ### # ######### ####### # ##### # #
# # #   # #   #   #   #   # #       #       #   # #           #   #   #   # #   #
# # ##### ##### # # # ##### ######### # ### ### # ### ######### ### ##### # ### #
# # #   # #   # #   #     #         # #   # #   #   #   #           #   # #     #
# # # # # ### # ####### # ##### ##### ### ### ##### ### ########### # # # #######
# #   #   #   #   #   # # #   #       #   #   #   # #             #   # #   #   #
# ######### ##### # # ### # # ##### ### ### ### # # ############# ##### ### # # #
# #   #     #     # #   # # # #   # #   #   #   # # #   #     #   # #   # #   # #
# # ### # # # ##### ### # # # # # ### # # ##### # # # # # ##### ### # ### ##### #
# #     # # # #   # #   #   # # #     # # #     # #   # #     # #           #   #
# ##### # ### # # # # ####### # ######### ### ### ##### # ### # ############# # #
#     # #     # # # # #       #       #   #   #   #   # #   # #         #     # #
##### # ####### ### # ### ##### ##### # ### ### ### # # ### # ######### # ##### #
#   # # #       #   # #   #   # #     #     # # #   #   # # #         # #   #   #
# ### # ####### # ### # ### # # # ########### # ### ##### # ##### ### # # # ### #
#     #     #   #   # #   # #   # #   #         #   #       #   # #   # # #   # #
# ######### # # ### # ### # ##### # # # ######### ######### # # # ##### ##### # #
#     #   # # #   # # #   # #   #   # # #                 #   # #     # #     # #
##### ### # # ### # # # ### # # ##### # ######### ####### # ######### # # #######
#   #   #   #   # # # # #     # #     #   #     #     #   # #       #   #       #
# ##### # ##### # # # # # ####### ####### # ### ### ### ### # ##### # ######### #
#     # # #     # # #   #   #     #     #   # #   # #   #   #   # # # #   #   # #
# ### # # # ##### # ####### # ##### # ####### ### ### ### ##### # # # # # # # # #
#   #   #   #     # #   # # # #   # #           #   #   #   #   # # #   # # # # #
### ##### ######### # # # # # # # # ### ##### ##### ### ##### ### # ##### # # # #
#   #     #   #     # # #   #   # #   #     # #   #   #     # #   #     # # #   #
# ######### # # ##### # ##### ### ### ##### # # # ### ##### # ### ##### # # ### #
# #   #     #   #     #     #   #       # # # # #     #   # #   #     # #   #   #
# # # # ##### ### ######### ########### # # # # ####### # # ### # ### # ##### ###
#   # # #     #   #       #           #   # # #   #     # #     # #   # # #   # #
##### # ####### ### ################# ##### ##### ##### # # ##### # ### # # ### #
#     #         #               #     #     #   # #     # #       #   # # #   # #
# ####### ##### ########### ##### ##### # ### # # # ##### ### ####### # # ### # #
# #     # #   #   #         #     #     # #   # # #   # #   # #   #   # #   # # #
# ### # ### # ### # ######### ##### ####### ### # # # # ### ### # ##### ### # # #
#   # #     #   #   #     #   #   #       # # #   # # #   #   # #     # #   #   #
### # ######### ##### ### # ### ### ##### # # ####### # ##### # ##### # # ##### #
#     #               #     #           #             #         #       #       #
#################################################################################
