###########################################################################################
#     #   #           #       #       #   #         # #             #     #     #     #   #
##### # # ### ####### ##### # # ##### ### # ##### # # # ##### ####### # ### # # ### # # ###
#   # # #   #     #   #     # #     #     # # #   #   # #   #         #     # # #   # #   #
### # # ### ##### # ### ##### # ### ### ### # # ### ### # ################### # # ### # # #
#   # #   #     # #   # #   # # # # #   #   # #   # #   #         #   # #     # #   # # # #
# ### # # ##### # ### # ### # # # # ##### ### ### # # ##### ### # # # # # ##### ### # ### #
# #   # # #       #   #   #   #   #       #   #   # #     # #   #   # # #     #     #   # #
# # ### # # ######### ### # ######### ####### # ### ##### # # ####### # ##### ######### # #
#   #   # # #       #   # #         # #       # #     #   # #       #   #     #       # # #
# ### ### ### ##### ### # ######### # ##### # # ####### ##### ##### # ### ####### ##### # #
# #     #         #   #   #   #     # #   # # # #           # #     # #   #       #   # # #
# # ################# ##### # # ##### # # # # # # ######### ### ##### # ##### ##### # # # #
# # #         #     #   #   # # #   #   #   # #   #       # #   #   # #   #   #     #   # #
# ### ####### # ### ### # # ### # # # ############# ##### # # ### # # ### # ### ##### ### #
# #   #     # #   #     # #   #   # # #         #   #     # # #   # # # # # #   #   # #   #
# # ### ### # ### ########### ##### ### ####### # ### ##### # ### ### # # # # ### # # # # #
# #   #   # #   #   #             # #   #     #   #   #     #   #     # # #     # # #   # #
# ### ### ##### ### # ### ####### # # ### # # ##### ### ####### # ##### # ####### # ##### #
#     #   #   #     #   # #     # #   #   # # # #   # #     #   #     # # #       # #     #
####### ### # ######### # ##### # ##### ### # # # ### ##### # ####### # # # ####### # #####
#       #   #     #   # #     #       # #   #   # #     #   #     # #   #   #   # # # #   #
# ##### # ### ### # # # ##### ######### # ####### # # ### ### ### # ### ##### # # # ### # #
#   # #   #   #   # #   #   #   #     # #       # # #     #   #   #           #   #     # #
### # ##### ### ### ##### # ### # ### # ####### # ####### # ### ################# ####### #
# #   #   # #   #       # # #   # #   #       #   #     # #   #           #     #   #   # #
# ### ### # ##### ####### # # ### # # ####### ##### ### # ### ########### # ### ##### # # #
#     #   # #       #     # #     # # #     #       #   # # #         #   #   # #     #   #
# ##### # # # ####### ##### ####### # # # ########### ### # ######### # ### ### # ####### #
#       # #   #     # # #         # #   # #         # #   #           # #   #   #   #     #
# ############# ### # # # ####### # ####### ### ##### # ### ########### # ### # ### # #####
# #       #     # # # #   #   # #   #   #   #   #   # #   #     #     # #   # # # # # #   #
### ##### # ##### # # # ### # # # ### # # ### ### # # ### ####### ### # ### # # # # # # # #
#   #     # #   #   # # # # # #   #   #   #   #   # # #           #   #     # #   # #   # #
# ### ##### ### # ### # # # # # ### ####### ### ### # ############# ######### ### # ##### #
#   #       #   #   # #   # # # # # #     #   #   # #   # #     # #     #     #   # #   # #
# # ######### # ### # # ### # # # # # ### ### ### # ### # # # # # ##### # ### ##### # ### #
# #   #       # #   # # #   # #   #   #   # # #   #   # # # # #   #   #   # # #     # #   #
##### # ##### ### ### # # ### ### ##### ### # # ### ### # # # ##### # ##### # # ##### # ###
#     # #   #     #   # # #   #     #   #   # # #   #   # # #   #   #     # # # #     #   #
# ##### ### ######### ### # # ####### ### # # # # # # ### # ### # ### ### # # # ##### ### #
#   # #         #   # #   # # #       #   # # # # # #   # #   #   #   #     # # #   #   # #
### # ######### # # # # ### ### ####### ### # # # ##### # ### ##### ######### # # # # # # #
#   #         # # #   # # # #   #     # #   #   #   #   # #   #   #           # # #   # # #
# ####### # # # # ### # # # # ### ### # # ######### # ### # ##### ############# # ####### #
#       # # # # #   # #   # # #   #   # #     # #   # #   #         #     #     # #     # #
# ##### ### ### ### ##### # # # ### ### ##### # # ### ### ####### ### ### # ##### # ### # #
# #   # #   #       #   # # #   #       #   # # #   #   #     #   #   # #   #     #   #   #
# ### # # ### ####### # # # ### ######### # # # ### ### ### ### ### ### ##### # ##### #####
#     # #     # #     #   # #   #   #     # #     #   # #   #   #   #       # #   #   #   #
##### # ##### # # ######### # ### # # ##### ### ##### # # ### ### ### ##### # ### # ### # #
#     #     #   # #       # #   # # #   # #   # #     # #   #   # #       # # # #   #   # #
########### ### # ### ### # # ### # ### # ### ### ### # ### # ### # ##### ### # ######### #
#     #     #   # #   # # #   #   #     #     #   #   #   # # #   # #   #     #     #     #
# ### # ######### # ### # ##### ### ##### ##### ### ##### # # # ### ### ##### # ### # ### #
# # # #   #       #   # # #   # # # #   #     #   #     # #   # #   #   #   # #   #   # # #
# # # # # # ######### # # # ### # # # # ##### ### ##### # ##### # ### ### # # # # ##### # #
# #   # # #       #   #   #   # #   # # #   #     #   # #   #   #     #   # # # # # #     #
# # ##### ####### # ### ### # # ##### # # # ######### # ### # ##### ### ### # ### # # #####
# #     #         # #   #   # #   #   # # #   #       # # # #     # #   #   #     #   #   #
# ##### ### ####### # ####### ### # ### # ### # ### ### # # # ### ### ### ######### ### # #
#     #   #   #     #       #   # # # # # #   # # # #     # # #   #   # #     #     #   # #
##### ### ### # ########### ### # # # # # # ### # # # ##### ### ### ### ##### # ##### ### #
#   #   # #     #     #   #     #   # # # #       #   #   #   #     #       # #   # #   # #
# # ### # ####### # # ### ##### ##### # ######### ##### # ### ##### # ##### # ### # # # ###
# #     #     #   # # #   #           #         #     # #     #   #   #   # # #   #   #   #
# ########### ### # # # # # ######### ######### ##### # ####### # ##### # # # # ####### # #
#   #   #   #   # # #   # # #       #     #   # # #   # #       #     # #   # #       # # #
### # ### # ### ### ####### # ##### ##### # # # # # ### # ##### ##### # ##### ####### # # #
#   #     #   #   #         # #   #   #   # #   #   #   # #   # #     #     # # #     # # #
# ### ####### ### # ##### ### # ##### # ### ### ##### ### # # # # ########### # # ####### #
# # # #   # # #   # #   # # # #       #   # #   #   # #   # # # #   #         # # #     # #
# # # # # # # # ##### # # # # ### ######### ##### # # # ### ### ### ### ####### # # ### # #
# #     # # # # #     # # # #   # #         #     #   #   #   #   #     #   #     # #   # #
# ####### # # # # ##### # # ### # ##### ### # ########### ### ### ####### # # ##### # ### #
#       # # # #   #   # #   #   #       # # #         # #       #   #   # # # #     #   # #
# ##### # # # ##### ### ### # ########### # ######### # ####### ### # # # # # # ### ### # #
#     # #   #           #   #   #     #   #       # # #       #   #   # # #   #   # #     #
# ##### ### ################### # ##### # ####### # # ####### ### ##### ##### ### # ##### #
# #     #   #                 # #       #     #   # #       #   #     # #   #   # #     # #
### ##### ########### ####### # # ####### ##### ### ####### ### ##### # # # ### # ##### ###
#   #                 #     # # # #   #   #     #         #   #     # #   # # # #   # #   #
# ### ################# ##### # # ### # ### ####### ######### # # ### ##### # # ### # ### #
# # # # #   #   #               #     #   #         #     #   # #   #   #   # # #     #   #
# # # # # # # # ####### ############# ### ######### # ### # ####### ### # ### # ####### # #
# #     # #   #   #   #   #       #     #         # # # #   #     #     # #     #     # # #
# ####### ####### # # ### # ##### ############# # # # # ####### # ####### # ##### ### # ###
# #     #   #     # #   # # #   #     #       # #   # #       # #     #   #       #   #   #
# # ### ### # ##### ### ### ### ##### # ##### ####### ##### # # ##### # ########### ##### #
#     #     #         #             #       #               #   #       #                 #
###########################################################################################
